NIVEL_ADMINISTRATIVO;GEO_COD;GEO_COD_DSG;POP_RESIDENTE_M;POP_RESIDENTE_F;POP_PRESENTE_M;POP_PRESENTE_F;POP_ATIVA_M;POP_ATIVA_F;POP_EMPREGADA_M;POP_EMPREGADA_F;POP_DESEMPREGADA_M;POP_DESEMPREGADA_F;TAXA_DESEMPREGO_M;TAXA_DESEMPREGO_F;POP_EMPREGADA_SET_PRIMARIO;POP_EMPREGADA_SET_SECUNDARIO;POP_EMPREGADA_SET_TERCIARIO;POP_DESEMPREGADA_PROC_1_EMP_M;POP_DESEMPREGADA_PROC_1_EMP_F;POP_DESEMPREGADA_PROC_NOVO_EMP_M;POP_DESEMPREGADA_PROC_NOVO_EMP_F;DENSIDADE_TOTAL;DENSIDADE_TOTAL_M;DENSIDADE_TOTAL_F;IDADE_MEDIA;M_0_14;M_15_24;M_25_64;M_65_74;M_75;F_0_14;F_15_24;F_25_64;F_65_74;F_75;COD_DISTRITO_INE;COD_CONCELHO_INE;COD_FREGUESIA_INE
6;131301;A Ver-o-Mar;4111;4564;3890;4472;2198;2108;1904;1796;294;312;13.375999999999999;14.801;167;1110;2423;47;44;247;268;1686;799;887;38.310000000000002;773;513;2363;315;147;733;477;2702;371;281;15;219;2953
6;30864;Abação (São Tomé);1143;1109;1129;1094;653;542;563;433;90;109;13.782999999999999;20.111000000000001;5;618;373;13;10;77;99;432.30000000000001;219.40000000000001;212.90000000000001;35.549999999999997;214;160;670;61;38;214;149;631;67;48;4;55;578
6;171401;Abaças;465;500;433;465;190;149;173;125;17;24;8.9469999999999992;16.106999999999999;87;60;151;3;5;14;19;51.100000000000001;24.600000000000001;26.5;45.57;71;52;247;53;42;55;41;245;75;84;19;282;3859
6;30201;Abade de Neiva;971;1053;898;1009;536;503;469;446;67;57;12.5;11.332000000000001;18;531;366;13;14;54;43;269.69999999999999;129.40000000000001;140.30000000000001;37.729999999999997;177;139;547;76;32;165;143;608;72;65;4;54;489
6;40701;Abambres;179;168;174;169;79;43;77;39;2;4;2.532;9.3019999999999996;32;30;54;0;2;2;2;18.399999999999999;9.5;8.9000000000000004;50.409999999999997;20;21;85;29;24;12;9;83;37;27;5;72;1129
6;150901;Abela;442;448;445;453;206;137;195;122;11;15;5.3399999999999999;10.949;67;70;180;1;4;10;11;6.5;3.2000000000000002;3.2999999999999998;49.729999999999997;46;37;225;70;64;51;35;191;85;86;17;254;3301
6;141601;Abitureiras;455;517;435;497;212;208;192;186;20;22;9.4339999999999993;10.577;39;57;282;3;6;17;16;41;19.199999999999999;21.800000000000001;47.5;60;36;246;57;56;54;39;256;73;95;16;241;3179
6;130102;Aboim;284;312;272;303;141;116;123;91;18;25;12.766;21.552;14;86;114;4;10;14;15;113.7;54.200000000000003;59.5;41.729999999999997;46;37;153;20;28;47;32;171;30;32;15;207;2674
6;160101;Aboim das Choças;150;183;143;185;62;64;59;60;3;4;4.8390000000000004;6.25;21;30;68;1;1;2;3;182.19999999999999;82.099999999999994;100.09999999999999;49.960000000000001;25;6;73;18;28;22;10;88;27;36;18;259;3331
6;131101;Abragão;1178;1163;1099;1147;591;365;506;297;85;68;14.382;18.629999999999999;16;521;266;10;20;75;48;245.59999999999999;123.59999999999999;122;36.659999999999997;242;155;626;95;60;235;143;609;101;75;15;217;2900
6;61001;Abrunheira;291;346;281;358;138;137;120;118;18;19;13.042999999999999;13.869;4;66;168;2;4;16;15;53.5;24.399999999999999;29;50.090000000000003;26;27;162;24;52;28;25;179;38;76;7;98;1555
6;141603;Achete;938;980;905;970;449;377;401;327;48;50;10.69;13.263;74;169;485;6;7;42;43;60.5;29.600000000000001;30.899999999999999;45.979999999999997;139;79;492;105;123;128;72;495;141;144;16;241;3181
6;40901;Açoreira;285;239;284;238;131;58;121;41;10;17;7.6340000000000003;29.309999999999999;60;37;65;8;15;2;2;21.899999999999999;11.9;10;47.700000000000003;22;34;165;36;28;11;23;137;37;31;5;74;1194
6;30203;Adães;389;401;358;368;216;185;194;164;22;21;10.185;11.350999999999999;21;181;156;2;5;20;16;293.60000000000002;144.59999999999999;149.09999999999999;39.07;63;53;223;32;18;53;52;235;31;30;4;54;491
6;160901;Afife;750;882;690;853;369;362;336;310;33;52;8.9429999999999996;14.365;12;165;469;7;10;26;42;125.3;57.600000000000001;67.700000000000003;47.460000000000001;84;67;436;85;78;93;69;457;121;142;18;267;3566
6;131401;Agrela;754;830;735;831;419;389;350;328;69;61;16.468;15.681000000000001;3;308;367;10;17;59;44;226.69999999999999;107.90000000000001;118.8;41.07;124;81;448;58;43;117;84;502;64;63;15;220;2965
6;40101;Agrobom;51;58;45;56;20;12;18;8;2;4;10;33.332999999999998;14;4;8;0;0;2;4;7.2999999999999998;3.3999999999999999;3.8999999999999999;53.57;2;3;26;13;7;4;6;26;12;10;5;66;980
6;171201;Água Revés e Crasto;165;177;164;177;57;25;52;15;5;10;8.7720000000000002;40;34;14;19;0;3;5;7;18;8.6999999999999993;9.3000000000000007;52.119999999999997;15;16;77;31;26;14;14;76;36;37;19;280;3810
6;10103;Aguada de Cima;1943;2070;1820;1986;1106;992;1031;876;75;116;6.7809999999999997;11.693999999999999;27;1082;798;10;15;65;101;141.30000000000001;68.400000000000006;72.900000000000006;41.240000000000002;323;201;1129;163;127;291;220;1164;192;203;1;1;3
6;160501;Agualonga;129;166;133;164;61;58;49;46;12;12;19.672000000000001;20.690000000000001;5;50;40;0;5;12;7;55.399999999999999;24.199999999999999;31.199999999999999;47.700000000000003;12;13;71;19;14;14;17;83;17;35;18;263;3453
6;50701;Águas;148;152;145;145;51;28;45;24;6;4;11.765000000000001;14.286;9;26;34;0;1;6;3;19.800000000000001;9.8000000000000007;10;57.210000000000001;13;11;64;24;36;5;10;50;32;55;6;84;1400
6;131302;Aguçadoura;2067;2190;2033;2179;1131;1028;1037;951;94;77;8.3109999999999999;7.4900000000000002;568;513;907;21;24;73;53;1174.2;570.10000000000002;604.10000000000002;38.859999999999999;382;267;1143;158;117;330;287;1230;181;162;15;219;2954
6;100801;Aguda;517;589;499;568;242;206;213;156;29;50;11.983000000000001;24.271999999999998;11;136;222;5;11;24;39;27.899999999999999;13;14.9;48.799999999999997;54;58;275;64;66;62;48;283;94;102;11;156;2218
6;10104;Águeda;5393;5953;5217;5889;2873;2812;2600;2468;273;344;9.5020000000000007;12.233000000000001;38;2249;2781;44;56;229;288;415.19999999999999;197.40000000000001;217.90000000000001;41.880000000000003;817;621;3025;529;401;814;603;3337;606;593;1;1;4
6;160102;Aguiã;354;351;337;342;154;93;147;82;7;11;4.5449999999999999;11.827999999999999;4;112;113;2;5;5;6;185.30000000000001;93;92.200000000000003;44.789999999999999;52;41;196;27;38;39;30;192;43;47;18;259;3332
6;131001;Aguiar de Sousa;799;832;783;826;393;296;370;258;23;38;5.8520000000000003;12.837999999999999;12;253;363;2;14;21;24;72.900000000000006;35.700000000000003;37.200000000000003;39.82;132;95;477;54;41;136;90;461;65;80;15;216;2876
6;10315;Aguim;554;617;524;591;291;270;266;243;25;27;8.5909999999999993;10;11;168;330;8;5;17;22;182;86.099999999999994;95.900000000000006;45.659999999999997;60;58;325;56;55;79;58;310;74;96;1;3;29
6;130301;Aião;415;441;407;440;211;154;182;134;29;20;13.744;12.987;11;200;105;1;6;28;14;308.10000000000002;149.40000000000001;158.69999999999999;37.369999999999997;87;48;231;25;24;63;65;255;32;26;15;209;2733
6;30853;Airão (São João Baptista);400;427;388;417;199;175;177;149;22;26;11.055;14.856999999999999;2;219;105;7;5;15;21;297.39999999999998;143.80000000000001;153.5;41.280000000000001;72;51;215;27;35;61;56;225;34;51;4;55;581
6;110601;Ajuda;7120;8464;6787;8129;3196;3333;2629;2883;567;450;17.741;13.500999999999999;13;631;4868;95;91;472;359;5456.8999999999996;2493.1999999999998;2963.8000000000002;46.939999999999998;983;670;3676;939;852;857;724;4073;1350;1460;12;171;2362
6;40501;Ala;198;219;190;208;83;39;81;36;2;3;2.4100000000000001;7.6920000000000002;44;25;48;0;1;2;2;12.4;5.9000000000000004;6.5;51.149999999999999;21;22;92;30;33;14;17;101;39;48;5;70;1074
6;121401;Alagoa;317;352;297;347;160;131;140;104;20;27;12.5;20.611000000000001;25;65;154;4;6;16;21;36.899999999999999;17.5;19.399999999999999;47.899999999999999;32;29;172;41;43;44;27;169;48;64;14;205;2659
6;70101;Alandroal (Nossa Senhora da Conceição);897;976;867;962;464;413;414;354;50;59;10.776;14.286;80;208;480;6;10;44;49;11.4;5.5;6;44.890000000000001;129;89;485;102;92;127;82;485;100;182;8;106;1648
6;101502;Albergaria dos Doze;846;919;815;902;362;310;335;282;27;28;7.4589999999999996;9.032;12;221;384;5;8;22;20;76.900000000000006;36.899999999999999;40;47.210000000000001;119;93;411;107;116;105;80;408;143;183;11;163;2277
6;110501;Alcabideche;20428;21734;19636;21119;10542;10525;9109;9285;1433;1240;13.593;11.781000000000001;69;2595;15730;307;259;1126;981;1060.2;513.70000000000005;546.5;39.799999999999997;3607;2581;11408;1759;1073;3417;2333;12173;2011;1800;12;170;2356
6;71301;Alcáçovas;1040;1071;1003;1055;487;419;453;379;34;40;6.9820000000000002;9.5470000000000006;156;150;526;7;7;27;33;7.9000000000000004;3.8999999999999999;4;46.369999999999997;153;109;512;116;150;136;91;494;146;204;8;118;1732
6;110602;Alcântara;6254;7689;6460;7892;3021;3290;2637;2955;384;335;12.711;10.182;21;575;4996;62;59;322;276;3142;1409.3;1732.7;46.759999999999998;835;582;3337;736;764;795;552;3842;1063;1437;12;171;2363
6;50402;Alcaria;575;605;556;590;297;249;266;214;31;35;10.438000000000001;14.055999999999999;19;172;289;4;8;27;27;54.899999999999999;26.800000000000001;28.199999999999999;45.219999999999999;81;62;317;59;56;69;55;306;76;99;6;81;1341
6;110301;Alcoentre;2172;1276;2105;1242;993;478;900;421;93;57;9.3659999999999997;11.925000000000001;64;319;938;29;8;64;49;73.299999999999997;46.200000000000003;27.100000000000001;43.729999999999997;160;157;1555;169;131;166;105;653;186;166;12;168;2337
6;120301;Alcôrrego;205;196;194;194;113;86;94;59;19;27;16.814;31.395;25;34;94;0;1;19;26;6.9000000000000004;3.5;3.3999999999999999;46.520000000000003;20;16;114;35;20;20;18;103;29;26;14;194;2594
6;80201;Alcoutim;448;473;462;478;178;153;160;140;18;13;10.112;8.4969999999999999;8;17;275;1;3;17;10;7;3.3999999999999999;3.6000000000000001;54.409999999999997;39;35;203;78;93;36;32;191;75;139;9;121;1744
6;91103;Aldeia da Ponte;152;165;143;159;42;27;41;26;1;1;2.3810000000000002;3.7039999999999997;13;14;40;1;0;0;1;8.5999999999999996;4.0999999999999996;4.5;61.700000000000003;9;9;57;34;43;8;3;45;47;62;10;145;2044
6;90703;Aldeia do Bispo;104;116;102;105;53;60;48;56;5;4;9.4339999999999993;6.6669999999999998;1;17;86;1;1;4;3;16.699999999999999;7.9000000000000004;8.8000000000000007;44.049999999999997;8;12;63;7;14;15;14;66;7;14;10;141;1943
6;50702;Aldeia do Bispo;333;343;291;292;120;96;112;80;8;16;6.6669999999999998;16.667000000000002;25;62;105;1;2;7;14;104.40000000000001;51.399999999999999;53;52.109999999999999;32;24;171;41;65;25;26;153;56;83;6;84;1402
6;20208;Aldeia dos Fernandes;257;279;250;275;136;97;121;69;15;28;11.029;28.866;16;74;100;1;1;14;27;25.199999999999999;12.1;13.1;47.259999999999998;21;19;142;39;36;48;12;143;39;37;3;40;370
6;91301;Aldeia Nova;153;179;149;176;68;53;62;50;6;3;8.8239999999999998;5.6600000000000001;36;22;54;1;3;5;0;12.4;5.7000000000000002;6.7000000000000002;56.649999999999999;8;11;84;23;27;6;12;79;23;59;10;147;2112
6;50405;Aldeia Nova do Cabo;296;304;288;290;126;111;114;92;12;19;9.5240000000000009;17.117000000000001;14;49;143;2;5;10;14;62.5;30.800000000000001;31.699999999999999;47.409999999999997;39;41;146;43;27;24;32;144;50;54;6;81;1344
6;91106;Aldeia Velha;205;226;192;225;66;48;64;46;2;2;3.0299999999999998;4.1669999999999998;19;37;54;1;0;1;2;20.600000000000001;9.8000000000000007;10.800000000000001;60.270000000000003;11;12;90;41;51;7;12;67;49;91;10;145;2048
6;120302;Aldeia Velha;134;146;128;144;57;50;55;41;2;9;3.5089999999999999;18;47;4;45;0;2;2;7;2.2000000000000002;1.1000000000000001;1.2;54.490000000000002;12;11;59;26;26;12;8;64;27;35;14;194;2595
6;131201;Aldoar;6044;6799;5891;6908;2974;2814;2445;2364;529;450;17.786999999999999;15.991;21;780;4008;108;95;421;355;5333.1999999999998;2509.8000000000002;2823.3000000000002;43.229999999999997;937;746;3364;534;463;858;749;3695;707;790;15;218;2938
6;141816;Além da Ribeira;362;402;346;390;173;121;157;108;16;13;9.2490000000000006;10.744;3;98;164;1;3;15;10;61.5;29.100000000000001;32.299999999999997;48.810000000000002;37;41;194;41;49;38;37;184;51;92;16;243;3211
6;90401;Algodres;132;162;123;153;41;30;39;29;2;1;4.8780000000000001;3.3330000000000002;14;19;35;0;0;2;1;9.5;4.2999999999999998;5.2000000000000002;58.07;10;7;53;24;38;11;9;58;41;43;10;138;1886
6;41101;Algoso;135;146;131;142;38;29;34;22;4;7;10.526;24.138000000000002;14;19;23;2;1;2;6;7.5999999999999996;3.6000000000000001;3.8999999999999999;58.649999999999999;11;11;40;32;41;11;5;51;37;42;5;76;1230
6;110401;Alguber;460;497;436;496;214;168;204;149;10;19;4.673;11.31;29;85;239;2;5;8;14;49.700000000000003;23.899999999999999;25.800000000000001;46.590000000000003;67;38;230;63;62;66;40;233;81;77;12;169;2346
6;60501;Alhadas;1942;2140;1842;2078;977;828;846;682;131;146;13.407999999999999;17.632999999999999;22;594;912;24;44;107;102;141.40000000000001;67.299999999999997;74.200000000000003;44.840000000000003;270;197;1102;197;176;231;196;1175;263;275;7;93;1517
6;111401;Alhandra;2802;3245;2735;3200;1419;1334;1203;1144;216;190;15.222;14.243;30;591;1726;25;35;191;155;2580.5999999999999;1195.8;1384.9000000000001;45.579999999999998;390;290;1499;352;271;394;286;1630;459;476;12;180;2520
6;180401;Alhões;104;92;110;100;34;22;25;19;9;3;26.471;13.635999999999999;4;17;23;1;0;8;3;17.100000000000001;9.0999999999999996;8;51.210000000000001;9;15;48;16;16;5;7;51;6;23;20;286;3937
6;60301;Almalaguês;1452;1659;1385;1619;684;718;630;668;54;50;7.8949999999999996;6.9640000000000004;17;230;1051;14;13;40;37;134.30000000000001;62.700000000000003;71.599999999999994;45.450000000000003;184;145;800;198;125;197;138;887;240;197;7;91;1476
6;140301;Almeirim;6022;6790;5625;6466;3109;3061;2660;2656;449;405;14.442;13.231;364;1024;3928;75;58;374;347;185.30000000000001;87.099999999999994;98.200000000000003;41.829999999999998;1068;600;3309;561;484;988;625;3655;687;835;16;227;3085
6;180301;Almofala;111;117;100;110;34;25;30;22;4;3;11.765000000000001;12;14;16;22;0;1;4;2;12.300000000000001;6;6.2999999999999998;51.049999999999997;8;6;60;20;17;10;12;55;23;17;20;285;3915
6;130701;Alpendurada e Matos;2789;2791;2475;2697;1538;1030;1370;873;168;157;10.923;15.243;15;1385;843;27;36;141;121;529.5;264.60000000000002;264.80000000000001;35.100000000000001;601;387;1572;142;87;525;395;1570;163;138;15;213;2819
6;101602;Alqueidão da Serra;873;882;827;849;438;357;407;321;31;36;7.0780000000000003;10.084;8;338;382;7;8;24;28;79.400000000000006;39.5;39.899999999999999;44.990000000000002;124;115;458;85;91;89;80;456;110;147;11;164;2294
6;70901;Alqueva;161;168;499;195;83;51;62;22;21;29;25.300999999999998;56.863;17;30;37;1;3;20;26;4.2000000000000002;2;2.1000000000000001;52.869999999999997;9;16;93;16;27;13;15;65;26;49;8;114;1714
6;80802;Alte;988;1009;996;1012;414;314;342;264;72;50;17.390999999999998;15.923999999999999;52;138;416;7;5;65;45;21.199999999999999;10.5;10.699999999999999;52.630000000000003;85;72;480;179;172;99;57;434;190;229;9;127;1785
6;150406;Alto do Seixalinho;9334;10661;9072;10552;4381;4534;3628;3781;753;753;17.187999999999999;16.608000000000001;8;1381;6020;125;147;628;606;11386;5315.1999999999998;6070.8000000000002;44.670000000000002;1370;895;5036;1280;753;1308;914;5685;1517;1237;17;249;3269
6;170201;Alturas do Barroso;190;209;193;202;73;40;73;38;0;2;0;5;54;19;38;0;0;0;2;12.199999999999999;5.7999999999999998;6.4000000000000004;50.359999999999999;24;13;99;28;26;20;18;96;33;42;19;270;3640
6;180302;Alva;231;248;219;244;90;57;84;46;6;11;6.6669999999999998;19.297999999999998;23;37;70;1;2;5;9;42.700000000000003;20.600000000000001;22.100000000000001;47.640000000000001;28;33;117;28;25;32;13;123;29;51;20;285;3916
6;170901;Alvadia;97;99;96;94;51;37;50;36;1;1;1.9609999999999999;2.7029999999999998;66;4;16;0;0;1;1;5.7999999999999998;2.8999999999999999;2.8999999999999999;52.299999999999997;8;4;51;14;20;9;7;41;25;17;19;277;3778
6;110604;Alvalade;3764;5105;3850;5279;1828;2103;1675;1915;153;188;8.3699999999999992;8.9399999999999995;18;310;3262;31;49;122;139;14898.5;6322.8999999999996;8575.6000000000004;48.810000000000002;527;368;1919;364;586;496;385;2380;595;1249;12;171;2365
6;150902;Alvalade;1024;1074;987;1034;546;438;483;377;63;61;11.538;13.927;198;171;491;3;6;60;55;13;6.2999999999999998;6.5999999999999996;47.200000000000003;129;92;554;121;128;118;98;524;171;163;17;254;3302
6;160301;Alvaredo;229;299;225;293;95;76;91;70;4;6;4.2110000000000003;7.8949999999999996;17;33;111;2;3;2;3;121;52.5;68.5;52.369999999999997;16;23;123;25;42;24;15;147;41;72;18;261;3402
6;131801;Alvarelhos;1553;1598;1491;1558;914;720;794;578;120;142;13.129;19.722000000000001;28;750;594;16;16;104;126;429.30000000000001;211.59999999999999;217.69999999999999;40.240000000000002;231;196;940;117;69;220;198;930;136;114;15;221;2989
6;130501;Alvarenga;218;245;205;236;127;113;114;97;13;16;10.236000000000001;14.159000000000001;3;134;74;1;4;12;12;228.30000000000001;107.5;120.8;35.030000000000001;42;32;121;13;10;50;41;133;12;9;15;211;2777
6;60601;Alvares;364;448;344;425;125;102;113;88;12;14;9.5999999999999996;13.725;13;62;126;5;4;7;10;8.0999999999999996;3.6000000000000001;4.5;56.460000000000001;38;35;150;56;85;32;24;152;73;167;7;94;1535
6;90705;Alvendre;102;108;100;106;40;41;36;34;4;7;10;17.073;5;17;48;2;2;2;5;16.199999999999999;7.9000000000000004;8.4000000000000004;47.460000000000001;10;15;50;11;16;8;14;51;18;17;10;141;1945
6;111402;Alverca do Ribatejo;14918;16152;14205;15721;8427;8374;7504;7379;923;995;10.952999999999999;11.882;43;3158;11682;126;174;797;821;1605.3;770.79999999999995;834.5;39.909999999999997;2467;1521;8876;1290;764;2387;1545;9573;1470;1177;12;180;2521
6;141801;Alviobeira;297;326;284;312;137;105;126;92;11;13;8.0289999999999999;12.381;12;61;145;0;2;11;11;72.400000000000006;34.5;37.899999999999999;45.659999999999997;45;22;156;42;32;40;43;137;53;53;16;243;3212
6;30402;Alvite;467;496;411;473;249;190;224;159;25;31;10.039999999999999;16.315999999999999;25;168;190;8;13;17;18;126.7;61.399999999999999;65.200000000000003;38.289999999999999;83;71;241;35;37;84;69;259;54;30;4;56;710
6;180702;Alvite;539;556;497;506;241;173;222;166;19;7;7.8840000000000003;4.0460000000000003;30;168;190;2;1;17;6;56.799999999999997;28;28.800000000000001;44.530000000000001;72;65;282;65;55;80;53;287;59;77;20;289;3997
6;160103;Alvora;104;157;106;152;29;30;28;27;1;3;3.448;10;5;18;32;0;0;1;3;48.799999999999997;19.399999999999999;29.300000000000001;54.18;12;4;51;13;24;12;6;71;33;35;18;259;3333
6;100301;Alvorge;566;661;530;634;239;187;216;169;23;18;9.6229999999999993;9.6259999999999994;14;123;248;1;2;22;16;31.399999999999999;14.5;16.899999999999999;50.390000000000001;55;51;292;81;87;70;57;295;84;155;11;151;2183
6;100602;Alvorninha;1451;1536;1398;1495;694;569;615;492;79;77;11.382999999999999;13.532999999999999;114;373;620;13;17;66;60;79.400000000000006;38.600000000000001;40.899999999999999;44.950000000000003;216;157;757;176;145;212;142;747;203;232;11;154;2201
6;130133;Amarante (São Gonçalo);3018;3522;2801;3365;1567;1554;1382;1306;185;248;11.806000000000001;15.959;16;729;1943;61;74;124;174;1629.2;751.79999999999995;877.39999999999998;40.310000000000002;514;367;1704;245;188;539;356;1982;334;311;15;207;2675
6;30101;Amares;775;775;739;746;392;366;356;297;36;69;9.1839999999999993;18.852;20;167;466;7;20;29;49;1130.8;565.39999999999998;565.39999999999998;37.469999999999999;142;118;420;54;41;134;118;427;49;47;4;53;465
6;80803;Ameixial;228;211;221;207;93;40;86;36;7;4;7.5270000000000001;10;27;26;69;0;1;7;3;3.5;1.8;1.7;59.009999999999998;11;10;101;38;68;8;15;74;48;66;9;127;1786
6;160903;Amonde;122;171;110;164;59;59;50;52;9;7;15.254;11.864000000000001;6;34;62;1;2;8;5;46.899999999999999;19.5;27.399999999999999;49.100000000000001;13;15;67;15;12;11;17;81;21;41;18;267;3568
6;100901;Amor;2384;2363;2261;2284;1211;1029;1119;933;92;96;7.5969999999999995;9.3290000000000006;48;921;1083;13;25;79;71;202.09999999999999;101.5;100.59999999999999;41.829999999999998;407;266;1330;230;151;332;232;1292;259;248;11;157;2223
6;151002;Amora;23185;25444;21685;24407;11892;12225;9959;10346;1933;1879;16.254999999999999;15.369999999999999;36;3887;16382;351;434;1582;1445;1996.3;951.79999999999995;1044.5;40.670000000000002;3862;2876;12894;2401;1152;3597;2764;14729;2553;1801;17;255;3313
6;60201;Ançã;1278;1347;1231;1319;570;580;524;538;46;42;8.0700000000000003;7.2409999999999997;16;240;806;6;9;40;33;145.09999999999999;70.599999999999994;74.400000000000006;44.420000000000002;197;142;667;156;116;172;124;686;179;186;7;90;1457
6;160402;Anhões;57;83;56;82;13;10;13;8;0;2;0;20;8;4;9;0;1;0;1;19.899999999999999;8.0999999999999996;11.800000000000001;59.909999999999997;2;4;19;16;16;6;3;33;21;20;18;262;3421
6;31102;Anjos;142;191;138;180;44;48;34;35;10;13;22.727;27.082999999999998;13;19;37;3;3;7;10;19.5;8.3000000000000007;11.199999999999999;48.140000000000001;13;15;75;21;18;20;21;94;27;29;4;62;846
6;110606;Anjos;4392;4969;4431;5011;2398;2233;2017;1984;381;249;15.888;11.151;7;415;3579;65;48;316;201;19180.799999999999;8999.2000000000007;10181.5;45.600000000000001;515;430;2572;427;448;483;430;2534;603;919;12;171;2367
6;100302;Ansião;1296;1432;1199;1355;641;586;590;523;51;63;7.9559999999999995;10.750999999999999;18;324;771;8;10;43;53;139.30000000000001;66.200000000000003;73.099999999999994;42.200000000000003;240;130;700;129;97;211;126;762;169;164;11;151;2184
6;31202;Antas;3287;3638;3154;3553;1822;1824;1574;1553;248;271;13.611000000000001;14.856999999999999;8;1082;2037;44;44;204;227;1535;728.60000000000002;806.39999999999998;37.82;604;369;1975;211;128;588;367;2182;282;219;4;63;867
6;30703;Antime;689;787;652;759;360;350;300;294;60;56;16.667000000000002;16;8;287;299;6;7;54;49;472.80000000000001;220.69999999999999;252.09999999999999;42.780000000000001;91;77;414;57;50;104;92;442;85;64;4;59;765
6;110701;Apelação;2785;2862;2680;2787;1340;1249;953;1019;387;230;28.881;18.414999999999999;4;422;1546;58;51;329;179;3962;1954;2008;37.75;523;439;1473;201;149;526;413;1487;238;198;12;172;2415
6;11501;Arada;1601;1717;1522;1656;891;739;759;566;132;173;14.815;23.41;15;631;679;17;17;115;156;221.30000000000001;106.8;114.5;40.18;261;193;922;125;100;258;215;946;159;139;1;14;140
6;160801;Arão;366;392;357;387;171;145;142;124;29;21;16.959;14.483000000000001;6;65;195;4;5;25;16;292.30000000000001;141.19999999999999;151.19999999999999;44.640000000000001;50;41;201;47;27;46;36;214;50;46;18;266;3550
6;61002;Arazede;2680;2828;2466;2704;1319;1127;1191;985;128;142;9.7040000000000006;12.6;285;745;1146;24;35;104;107;103.09999999999999;50.100000000000001;52.899999999999999;44.93;341;309;1451;299;280;300;309;1490;363;366;7;98;1556
6;10303;Arcos;2609;2902;2529;2832;1408;1420;1282;1273;126;147;8.9489999999999998;10.352;31;888;1636;36;30;90;117;449.30000000000001;212.69999999999999;236.59999999999999;42.32;427;296;1460;240;186;399;270;1614;287;332;1;3;32
6;170303;Arcossó;156;167;150;164;66;50;61;37;5;13;7.5759999999999996;26;18;27;53;1;3;4;10;40.700000000000003;19.600000000000001;21;46.200000000000003;21;14;80;18;23;24;13;81;22;27;19;271;3658
6;30209;Arcozelo;6101;6739;5701;6511;3371;3413;2879;2842;492;571;14.595000000000001;16.73;27;2605;3089;68;91;424;480;3736.0999999999999;1775.2;1960.9000000000001;36.789999999999999;1169;871;3569;325;167;1058;858;4023;425;375;4;54;499
6;170202;Ardãos;136;113;134;111;31;15;27;15;4;0;12.903;0;5;19;18;0;0;4;0;11.1;6.0999999999999996;5;54.310000000000002;13;10;56;26;31;6;11;36;33;27;19;270;3641
6;100802;Arega;408;462;393;457;185;112;163;87;22;25;11.891999999999999;22.321000000000002;29;98;123;7;4;15;21;30.399999999999999;14.300000000000001;16.100000000000001;49.619999999999997;41;50;209;45;63;44;47;204;60;107;11;156;2219
6;131404;Areias;1168;1286;1118;1253;622;593;533;495;89;98;14.308999999999999;16.526;10;436;582;8;13;81;85;914.79999999999995;435.39999999999998;479.39999999999998;43.479999999999997;139;130;699;125;75;147;156;750;142;91;15;220;2967
6;30211;Areias de Vilar;774;591;733;574;301;279;263;239;38;40;12.625;14.337;13;257;232;13;8;25;32;236.80000000000001;134.30000000000001;102.5;42.619999999999997;90;98;448;67;71;88;77;324;50;52;4;54;500
6;160203;Arga de Cima;33;40;33;40;9;6;7;5;2;1;22.222000000000001;16.667000000000002;5;3;4;0;0;2;1;8.6999999999999993;3.8999999999999999;4.7999999999999998;57.079999999999998;2;;12;12;7;5;2;16;10;7;18;260;3384
6;180102;Aricera;79;78;64;74;31;24;25;17;6;7;19.355;29.167000000000002;11;7;24;4;3;2;4;39;19.600000000000001;19.399999999999999;46.140000000000001;10;9;43;10;7;6;10;39;12;11;20;283;3890
6;130702;Ariz;889;954;759;919;489;318;399;236;90;82;18.405000000000001;25.786000000000001;13;354;268;9;24;81;58;455.39999999999998;219.69999999999999;235.69999999999999;37.340000000000003;164;144;483;46;52;166;136;511;61;80;15;213;2820
6;180103;Armamar;609;659;599;643;312;251;284;213;28;38;8.9740000000000002;15.138999999999999;63;86;348;7;12;21;26;136.5;65.599999999999994;71;39.960000000000001;110;74;340;43;42;114;72;335;61;77;20;283;3891
6;30705;Armil;361;374;359;371;174;163;154;143;20;20;11.494;12.27;6;191;100;4;6;16;14;158.09999999999999;77.700000000000003;80.5;42;60;43;193;37;28;48;46;201;46;33;4;59;767
6;31237;Arnoso (Santa Eulália);538;573;532;576;293;254;265;207;28;47;9.5560000000000009;18.504000000000001;5;225;242;3;8;25;39;410.30000000000001;198.69999999999999;211.59999999999999;39.409999999999997;87;64;323;32;32;89;79;314;39;52;4;63;868
6;11901;Arões;680;779;632;748;264;164;247;146;17;18;6.4390000000000001;10.975999999999999;45;184;164;2;3;15;15;36.200000000000003;16.899999999999999;19.300000000000001;49.93;66;71;344;90;109;61;77;393;104;144;1;19;200
6;30802;Arosa;227;272;221;267;99;91;78;73;21;18;21.212;19.780000000000001;3;64;84;3;4;18;14;257.5;117.09999999999999;140.30000000000001;44.25;29;34;117;24;23;32;29;139;38;34;4;55;585
6;10403;Arouca;1445;1740;1383;1667;783;705;731;629;52;76;6.641;10.779999999999999;33;407;920;8;26;44;50;375.30000000000001;170.30000000000001;205;40.390000000000001;237;172;835;94;107;276;222;906;140;196;1;4;46
6;70201;Arraiolos;1632;1754;1557;1711;890;836;823;744;67;92;7.5280000000000005;11.005000000000001;85;420;1062;12;19;55;73;23.199999999999999;11.199999999999999;12;43.57;226;173;925;155;153;227;170;935;194;228;8;107;1654
6;151003;Arrentela;13782;15104;12810;14457;7252;7436;6164;6293;1088;1143;15.003;15.371;20;2376;10061;217;201;871;942;2841;1355.5;1485.5;39.32;2425;1669;7743;1218;727;2412;1642;8695;1328;1027;17;255;3314
6;61701;Arrifana;683;757;633;715;336;272;314;255;22;17;6.548;6.25;19;179;371;3;3;19;14;60.399999999999999;28.699999999999999;31.800000000000001;45.450000000000003;85;78;375;87;58;95;63;392;92;115;7;105;1644
6;141414;Assentiz;205;223;195;208;99;88;83;82;16;6;16.161999999999999;6.8179999999999996;20;43;102;1;0;15;6;80.799999999999997;38.700000000000003;42.100000000000001;45.259999999999998;28;24;111;25;17;29;19;109;36;30;16;239;3163
6;120901;Atalaia;61;77;57;71;21;22;18;18;3;4;14.286;18.181999999999999;4;9;23;0;0;3;4;7.0999999999999996;3.1000000000000001;4;57.030000000000001;6;1;25;13;16;4;4;26;21;22;14;200;2629
6;170501;Atei;672;680;652;656;326;217;287;153;39;64;11.962999999999999;29.492999999999999;77;160;203;11;21;28;43;54.799999999999997;27.199999999999999;27.600000000000001;40.149999999999999;111;90;358;56;57;103;104;335;65;73;19;273;3714
6;101402;Atouguia da Baleia;4386;4568;4143;4404;2229;1843;1993;1605;236;238;10.587999999999999;12.914;422;819;2357;25;29;211;209;190.40000000000001;93.299999999999997;97.099999999999994;41.859999999999999;746;448;2355;472;365;690;459;2445;491;483;11;162;2270
6;110303;Aveiras de Cima;2282;2480;2190;2422;1153;1087;983;960;170;127;14.744;11.683999999999999;64;545;1334;18;13;152;114;182.09999999999999;87.299999999999997;94.799999999999997;41.729999999999997;383;237;1229;273;160;395;243;1311;284;247;12;168;2339
6;90707;Avelãs de Ambom;24;45;24;48;9;14;9;12;0;2;0;14.286;1;2;18;0;1;0;1;9.1999999999999993;3.2000000000000002;6;54;4;1;10;2;7;5;4;12;5;19;10;141;1948
6;131405;Aves;4075;4383;3912;4314;2125;2111;1773;1623;352;488;16.565000000000001;23.117000000000001;9;1557;1830;49;52;303;436;1373.2;661.60000000000002;711.60000000000002;42.590000000000003;594;500;2289;408;284;521;441;2533;466;422;15;220;2968
6;130703;Avessadas;593;654;552;634;301;243;255;191;46;52;15.282;21.399000000000001;18;199;229;12;17;34;35;204.19999999999999;97.099999999999994;107.09999999999999;38.32;112;86;327;33;35;96;89;374;38;57;15;213;2821
6;130612;Avioso (São Pedro);1862;1964;1922;2015;1090;1060;987;920;103;140;9.4499999999999993;13.208;22;569;1316;12;21;91;119;781.89999999999998;380.5;401.39999999999998;37.350000000000001;349;160;1155;124;74;323;170;1222;133;116;15;212;2804
6;61601;Ázere;320;366;303;359;150;99;132;83;18;16;12;16.161999999999999;39;68;108;1;5;17;11;56.899999999999999;26.600000000000001;30.399999999999999;47.079999999999998;36;48;163;34;39;44;44;147;47;84;7;104;1629
6;160601;Azias;173;204;169;198;52;35;45;31;7;4;13.462;11.429;8;37;31;1;1;6;3;44.700000000000003;20.5;24.199999999999999;50.090000000000003;22;16;80;24;31;20;18;90;25;51;18;264;3474
6;90205;Azinhal;31;32;31;32;9;6;8;6;1;0;11.111000000000001;0;6;3;5;0;0;1;0;5.7999999999999998;2.8999999999999999;3;53.490000000000002;5;1;13;5;7;1;3;12;7;9;10;136;1839
6;150501;Azinheira dos Barros e São Mamede do Sádão;364;340;350;335;165;115;149;94;16;21;9.6969999999999992;18.260999999999999;44;81;118;0;7;16;14;4.0999999999999996;2.1000000000000001;2;48.869999999999997;32;35;213;39;45;33;30;167;49;61;17;250;3277
6;141609;Azoia de Baixo;124;173;120;175;49;45;45;44;4;1;8.1630000000000003;2.222;4;18;67;0;1;4;0;66.700000000000003;27.899999999999999;38.899999999999999;51.020000000000003;28;2;60;9;25;25;11;61;11;65;16;241;3187
6;91108;Badamalos;53;43;48;42;25;11;24;10;1;1;4;9.0909999999999993;6;9;19;1;0;0;1;6.4000000000000004;3.5;2.8999999999999999;49.659999999999997;8;4;27;6;8;4;2;16;10;11;10;145;2050
6;131605;Bagunte;730;759;674;722;384;330;358;290;26;40;6.7709999999999999;12.121;77;285;286;4;9;22;31;161.69999999999999;79.299999999999997;82.400000000000006;40.579999999999998;107;88;428;65;42;106;86;426;71;70;15;223;3006
6;150602;Baixa da Banheira;9985;11100;9352;10728;4835;4823;3864;4029;971;794;20.082999999999998;16.463000000000001;15;1804;6074;173;134;798;660;5265.1999999999998;2493.4000000000001;2771.8000000000002;42.590000000000003;1567;1142;5540;1087;649;1488;1146;6079;1288;1099;17;251;3283
6;100925;Bajouca;1021;983;952;946;542;414;514;368;28;46;5.1660000000000004;11.111000000000001;41;406;435;5;14;23;32;163.30000000000001;83.200000000000003;80.099999999999994;40.289999999999999;167;143;543;118;50;151;122;508;112;90;11;157;2226
6;31001;Balança;158;183;157;181;76;51;72;44;4;7;5.2629999999999999;13.725;13;24;79;0;4;4;3;90.599999999999994;42;48.600000000000001;46.5;18;16;93;14;17;17;22;92;23;29;4;61;828
6;20502;Baleizão;432;470;430;466;231;186;214;163;17;23;7.359;12.366;113;45;219;2;3;15;20;6.5;3.1000000000000001;3.3999999999999999;45.890000000000001;55;40;258;40;39;50;41;233;72;74;3;43;382
6;90302;Baraçal;110;117;111;118;50;30;29;21;21;9;42;30;0;22;28;3;3;18;6;18.600000000000001;9;9.5999999999999996;46.210000000000001;16;14;49;16;15;18;12;51;14;22;10;137;1865
6;30213;Barcelinhos;835;946;777;922;455;433;408;385;47;48;10.33;11.085000000000001;8;347;438;8;8;39;40;646;302.89999999999998;343.10000000000002;42.359999999999999;122;103;474;92;44;121;90;526;108;101;4;54;503
6;30214;Barcelos;2116;2544;2092;2545;1094;1108;927;957;167;151;15.265000000000001;13.628;5;566;1313;35;30;132;121;3581.3000000000002;1626.2;1955.0999999999999;43.780000000000001;284;305;1183;183;161;278;303;1350;271;342;4;54;504
6;30806;Barco;735;775;716;760;392;358;336;301;56;57;14.286;15.922000000000001;19;337;281;8;15;48;42;500.69999999999999;243.69999999999999;257;36.520000000000003;151;105;398;51;30;129;127;414;65;40;4;55;590
6;50304;Barco;211;262;207;261;89;74;80;66;9;8;10.112;10.811;4;54;88;2;2;7;6;33.600000000000001;15;18.600000000000001;51.719999999999999;20;18;100;36;37;28;24;108;37;65;6;80;1311
6;170401;Barqueiros;330;371;308;359;166;119;140;77;26;42;15.663;35.293999999999997;34;66;117;8;25;18;17;150.59999999999999;70.900000000000006;79.700000000000003;42.509999999999998;49;39;186;26;30;48;49;201;28;45;19;272;3707
6;182101;Barreiro de Besteiros;460;515;439;498;218;153;197;138;21;15;9.6329999999999991;9.8040000000000003;61;148;126;2;6;19;9;26.399999999999999;12.4;13.9;49.719999999999999;34;43;249;71;63;47;51;252;78;87;20;303;4182
6;171204;Barreiros;89;88;90;85;37;14;33;12;4;2;10.811;14.286;19;9;17;0;2;4;0;25.100000000000001;12.6;12.5;53.289999999999999;8;5;43;12;21;6;11;37;17;17;19;280;3813
6;182302;Barreiros;142;158;138;156;69;50;60;42;9;8;13.042999999999999;16;5;26;71;2;2;7;6;49.899999999999999;23.600000000000001;26.300000000000001;46.579999999999998;22;11;81;16;12;15;17;77;29;20;20;305;4216
6;50408;Barroca;244;252;224;246;80;50;74;36;6;14;7.5;28;1;61;48;0;4;6;10;21.5;10.6;10.9;53.439999999999998;20;23;113;53;35;15;17;105;65;50;6;81;1347
6;180201;Beijós;477;498;434;469;218;148;201;134;17;14;7.798;9.4589999999999996;50;126;159;1;5;16;9;77.799999999999997;38.100000000000001;39.799999999999997;46.479999999999997;55;67;245;57;53;53;52;233;70;90;20;284;3908
6;40302;Beira Grande;72;72;71;72;36;34;34;32;2;2;5.556;5.8819999999999997;29;4;33;0;0;2;2;9.8000000000000007;4.9000000000000004;4.9000000000000004;54.82;2;3;39;17;11;4;4;40;14;10;5;68;1050
6;160707;Beiral do Lima;260;298;256;296;124;79;100;72;24;7;19.355;8.8610000000000007;16;81;75;3;2;21;5;76.299999999999997;35.5;40.700000000000003;47.920000000000002;25;30;149;31;25;19;33;158;45;43;18;265;3505
6;111104;Belas;12691;13396;12089;12968;6797;6885;5978;6047;819;838;12.048999999999999;12.170999999999999;22;2095;9908;159;149;660;689;1142.2;555.70000000000005;586.60000000000002;35.960000000000001;2761;1453;7447;664;366;2495;1422;7917;863;699;12;177;2480
6;60402;Belide;116;129;111;126;58;48;52;45;6;3;10.345000000000001;6.25;1;25;71;2;2;4;1;313.39999999999998;148.40000000000001;165;48.549999999999997;12;12;66;12;14;13;11;60;17;28;7;92;1508
6;50101;Belmonte;1497;1686;1436;1631;740;706;612;591;128;115;17.297000000000001;16.289000000000001;31;367;805;33;25;95;90;103;48.399999999999999;54.600000000000001;44.289999999999999;215;173;817;141;151;214;159;889;150;274;6;78;1279
6;120902;Belver;302;382;288;369;64;58;58;51;6;7;9.375;12.069000000000001;9;14;86;0;3;6;4;9.8000000000000007;4.2999999999999998;5.5;62.100000000000001;18;8;111;75;90;19;14;112;89;148;14;200;2630
6;40802;Bemposta;295;307;288;293;141;65;131;57;10;8;7.0919999999999996;12.308;15;89;84;2;4;8;4;15.9;7.7999999999999998;8.0999999999999996;49.609999999999999;20;31;169;39;36;25;30;140;63;49;5;73;1167
6;140501;Benavente;4443;4731;4218;4602;2339;2199;2023;1878;316;321;13.51;14.598000000000001;252;998;2651;42;47;274;274;70.400000000000006;34.100000000000001;36.299999999999997;40.719999999999999;799;520;2397;429;298;729;460;2556;519;467;16;229;3091
6;120304;Benavila;396;465;380;452;128;132;108;103;20;29;15.625;21.969999999999999;37;17;157;1;9;19;20;13;6;7;48.43;45;61;162;48;80;50;73;174;66;102;14;194;2597
6;141803;Beselga;365;386;348;381;154;124;136;114;18;10;11.688000000000001;8.0649999999999995;8;67;175;4;2;14;8;54.399999999999999;26.399999999999999;28;48.340000000000003;40;46;191;45;43;36;28;184;71;67;16;243;3214
6;131005;Besteiros;707;741;686;731;404;305;366;268;38;37;9.4060000000000006;12.131;14;295;325;2;4;36;33;680.79999999999995;332.39999999999998;348.39999999999998;37.159999999999997;129;112;393;48;25;132;99;413;52;45;15;216;2880
6;160502;Bico;220;246;204;236;103;70;86;61;17;9;16.504999999999999;12.856999999999999;22;52;73;0;3;17;6;53.700000000000003;25.300000000000001;28.300000000000001;50.380000000000003;27;23;116;26;28;21;12;107;40;66;18;263;3454
6;160709;Boalhosa;71;92;71;95;27;22;25;20;2;2;7.407;9.0909999999999993;20;13;12;0;0;2;2;74.5;32.5;42.100000000000001;48.439999999999998;9;7;35;11;9;10;7;32;29;14;18;265;3507
6;170304;Bobadela;52;53;47;49;17;4;12;4;5;0;29.411999999999999;0;6;2;8;1;0;4;0;20.100000000000001;9.9000000000000004;10.1;60.729999999999997;1;3;24;10;14;2;3;20;11;17;19;271;3659
6;131102;Boelhe;796;850;760;849;419;281;377;217;42;64;10.023999999999999;22.776;16;373;205;4;27;38;37;321.5;155.5;166;35.689999999999998;159;110;442;57;28;170;123;452;64;41;15;217;2901
6;50305;Boidobra;1606;1640;1570;1613;874;829;767;727;107;102;12.243;12.304;32;388;1074;16;11;91;91;199.59999999999999;98.799999999999997;100.90000000000001;39.210000000000001;290;185;951;111;69;246;184;975;118;117;6;80;1312
6;60515;Bom Sucesso;999;1134;925;1107;466;391;436;339;30;52;6.4379999999999997;13.298999999999999;61;293;421;7;6;23;46;35.299999999999997;16.600000000000001;18.800000000000001;46.240000000000002;111;113;545;130;100;130;95;562;182;165;7;93;1519
6;131202;Bonfim;10674;13591;10541;13605;5155;5467;4190;4609;965;858;18.719999999999999;15.693999999999999;14;1124;7661;176;171;789;687;7836.8000000000002;3447.4000000000001;4389.5;47.18;1283;1219;5811;1249;1112;1195;1182;6991;1858;2365;15;218;2939
6;70301;Borba (Matriz);1878;1901;1782;1823;919;781;805;671;114;110;12.404999999999999;14.085000000000001;123;374;979;20;13;94;97;91.5;45.5;46;44.82;244;197;1031;201;205;242;173;993;214;279;8;108;1661
6;30503;Borba de Montanha;595;699;552;682;293;203;256;166;37;37;12.628;18.227;38;183;201;6;13;31;24;118.8;54.600000000000001;64.200000000000003;40.899999999999999;110;75;308;48;54;110;97;330;70;92;4;57;730
6;60517;Borda do Campo;406;441;384;431;180;171;170;160;10;11;5.556;6.4329999999999998;18;131;181;2;4;8;7;85.400000000000006;41;44.5;48.789999999999999;49;38;209;56;54;38;33;228;67;75;7;93;1520
6;60308;Botão;750;838;719;830;359;341;331;320;28;21;7.7990000000000004;6.1580000000000004;3;225;423;4;4;24;17;92;43.399999999999999;48.5;43.909999999999997;95;69;436;97;53;108;78;464;95;93;7;91;1482
6;131803;Bougado (São Martinho);7205;7985;6867;7760;4131;3853;3578;3062;553;791;13.387;20.529;44;3064;3532;60;120;493;671;1051.7;498.89999999999998;552.89999999999998;38.740000000000002;1112;1050;4249;501;293;1241;972;4628;617;527;15;221;2991
6;30120;Bouro (Santa Marta);238;252;231;251;113;67;92;56;21;11;18.584;16.417999999999999;15;41;92;0;2;21;9;51.600000000000001;25.100000000000001;26.5;44.170000000000002;32;30;121;32;23;33;32;126;33;28;4;53;470
6;30351;Braga (São Vítor);13930;15712;14056;16521;7671;8059;6632;6855;1039;1204;13.545;14.94;29;2719;10739;248;279;791;925;7258.5;3411.0999999999999;3847.4000000000001;37.799999999999997;2543;1713;8187;878;609;2398;1754;9414;1071;1075;4;55;596
6;140905;Branca;729;745;687;715;368;298;326;257;42;41;11.413;13.757999999999999;156;131;296;2;5;40;36;12.6;6.2000000000000002;6.4000000000000004;47.359999999999999;95;53;390;91;100;83;54;383;113;112;16;233;3113
6;111502;Brandoa;8535;9270;8129;9017;4195;4265;3282;3585;913;680;21.763999999999999;15.943999999999999;10;1327;5530;150;125;763;555;8014.6999999999998;3841.9000000000001;4172.8000000000002;39.170000000000002;1604;1083;4511;962;375;1585;1084;4897;1048;656;12;166;2324
6;160603;Bravães;283;346;268;335;143;113;129;95;14;18;9.7899999999999991;15.929;16;100;108;3;11;11;7;150.80000000000001;67.799999999999997;82.900000000000006;43.149999999999999;40;41;145;32;25;49;37;169;45;46;18;264;3476
6;30841;Briteiros (Salvador);471;509;453;498;242;231;202;207;40;24;16.529;10.390000000000001;11;250;148;6;5;34;19;226;108.59999999999999;117.40000000000001;39.020000000000003;89;60;271;29;22;81;66;279;39;44;4;55;598
6;180504;Britiande;433;501;408;469;219;178;193;148;26;30;11.872;16.853999999999999;39;69;233;2;8;24;22;194.69999999999999;90.299999999999997;104.5;45.810000000000002;52;45;246;48;42;55;56;265;60;65;20;287;3956
6;40803;Bruçó;102;109;97;106;22;18;22;17;0;1;0;5.556;12;6;21;0;0;0;1;6.5;3.2000000000000002;3.3999999999999999;62.060000000000002;6;2;37;22;35;5;7;31;20;46;5;73;1168
6;31206;Brufe;1072;1159;1039;1133;556;525;483;436;73;89;13.129;16.951999999999998;10;369;540;10;15;63;74;896.29999999999995;430.69999999999999;465.60000000000002;42.020000000000003;168;127;607;102;68;141;122;657;120;119;4;63;873
6;81502;Budens;763;757;800;788;354;294;297;243;57;51;16.102;17.347000000000001;19;83;438;10;5;47;46;33.299999999999997;16.699999999999999;16.600000000000001;47.399999999999999;86;78;399;118;82;78;64;417;100;98;9;133;1815
6;131406;Burgães;1013;1084;985;1067;565;510;479;407;86;103;15.221;20.196000000000002;6;379;501;9;8;77;95;314;151.69999999999999;162.30000000000001;41.899999999999999;138;139;602;75;59;129;131;614;107;103;15;220;2969
6;131103;Bustelo;734;845;706;822;412;352;375;325;37;27;8.9809999999999999;7.6699999999999999;15;321;364;8;10;29;17;249.19999999999999;115.8;133.40000000000001;41;98;110;416;56;54;116;115;464;73;77;15;217;2902
6;11401;Bustos;1253;1399;1199;1350;653;582;591;518;62;64;9.4949999999999992;10.997;31;442;636;7;9;55;55;250.40000000000001;118.3;132.09999999999999;43.619999999999997;181;160;654;143;115;194;112;711;171;211;1;13;134
6;31308;Cabanelas;1032;1070;971;1050;545;409;467;319;78;90;14.311999999999999;22.004999999999999;14;465;307;12;14;66;76;311.89999999999998;153.09999999999999;158.80000000000001;36.25;193;164;576;60;39;223;145;557;72;73;4;64;922
6;131104;Cabeça Santa;1244;1284;1134;1260;682;483;607;406;75;77;10.997;15.942;17;638;358;9;14;66;63;364.80000000000001;179.5;185.30000000000001;36.799999999999997;249;173;706;67;49;229;173;712;90;80;15;217;2903
6;180303;Cabril;204;210;193;199;70;36;62;32;8;4;11.429;11.111000000000001;42;12;40;2;4;6;0;18.800000000000001;9.3000000000000007;9.5;49.939999999999998;20;20;96;38;30;29;13;95;40;33;20;285;3917
6;81401;Cachopo;359;357;360;357;108;64;101;60;7;4;6.4809999999999999;6.25;30;38;93;0;1;7;3;3.5;1.8;1.8;64.430000000000007;16;12;120;71;140;12;16;103;88;138;9;121;1746
6;10502;Cacia;3599;3755;3424;3635;1917;1659;1724;1432;193;227;10.068;13.683;23;1266;1867;18;34;175;193;205.69999999999999;100.7;105;40.689999999999998;545;429;2074;275;276;567;413;2128;329;318;1;5;65
6;60602;Cadafaz;94;96;88;91;32;14;28;10;4;4;12.5;28.571000000000002;6;18;14;0;0;4;4;5.0999999999999996;2.5;2.6000000000000001;58.149999999999999;8;6;36;12;32;9;3;32;20;32;7;94;1536
6;50204;Cafede;122;141;118;139;59;46;53;39;6;7;10.169;15.217000000000001;3;30;59;0;1;6;6;17;7.9000000000000004;9.0999999999999996;49.310000000000002;9;6;74;17;16;18;13;69;18;23;6;79;1287
6;10927;Caldas de São Jorge;1330;1386;1260;1347;728;673;639;549;89;124;12.225;18.425000000000001;6;581;601;19;24;70;100;487.60000000000002;238.80000000000001;248.80000000000001;40.950000000000003;201;177;753;123;76;197;157;776;131;125;1;15;150
6;31402;Caldas de Vizela (São João);1635;1776;1576;1734;868;821;724;677;144;144;16.59;17.539999999999999;5;747;649;22;26;122;118;962.79999999999995;461.5;501.30000000000001;40.68;234;251;935;134;81;241;227;1018;158;132;4;65;973
6;31403;Caldas de Vizela (São Miguel);3495;3727;3355;3632;1910;1870;1624;1574;286;296;14.974;15.829000000000001;4;1746;1448;53;53;233;243;1744.0999999999999;844;900.10000000000002;38.93;576;458;2066;252;143;550;425;2210;302;240;4;65;974
6;30808;Caldelas;2802;2921;2697;2851;1495;1527;1302;1317;193;210;12.91;13.752000000000001;15;1159;1445;39;42;154;168;2124.6999999999998;1040.3;1084.4000000000001;37.270000000000003;523;373;1639;173;94;461;350;1750;191;169;4;55;603
6;170306;Calvão;159;194;156;192;49;34;42;31;7;3;14.286;8.8239999999999998;20;16;37;1;1;6;2;17.800000000000001;8;9.8000000000000007;54.979999999999997;8;10;73;33;35;18;14;76;51;35;19;271;3661
6;40205;Calvelhe;40;57;40;56;18;10;17;10;1;0;5.556;0;13;1;13;0;0;1;0;4.2999999999999998;1.8;2.5;54.210000000000001;4;3;22;5;6;4;4;19;12;18;5;67;1006
6;111302;Campelos;1378;1449;1293;1413;741;616;688;570;53;46;7.1520000000000001;7.468;151;465;642;5;4;48;42;116.5;56.799999999999997;59.700000000000003;41;234;158;759;134;93;207;154;796;143;149;12;179;2501
6;182403;Campia;748;794;682;739;386;338;366;316;20;22;5.181;6.5090000000000003;94;294;294;6;2;14;20;39.299999999999997;19.100000000000001;20.199999999999999;45.119999999999997;101;95;371;88;93;87;94;388;109;116;20;306;4251
6;131502;Campo;4538;4659;4374;4568;2489;2084;2110;1675;379;409;15.227;19.626000000000001;18;1487;2280;35;72;344;337;836;412.5;423.5;37.780000000000001;787;571;2741;283;156;788;495;2751;385;240;15;222;2998
6;182306;Campo;2480;2545;2321;2431;1272;1073;1118;909;154;164;12.106999999999999;15.284000000000001;17;409;1601;26;31;128;133;309.39999999999998;152.69999999999999;156.69999999999999;39.32;435;289;1391;241;124;443;243;1437;248;174;20;305;4220
6;110609;Campo Grande;4679;5835;5267;6651;2449;2612;2199;2372;250;240;10.208;9.1880000000000006;21;468;4082;46;55;204;185;4296.1000000000004;1911.9000000000001;2384.1999999999998;44.490000000000002;718;519;2559;414;469;681;543;2932;627;1052;12;171;2370
6;110610;Campolide;7468;7992;7580;8089;3597;3570;3089;3178;508;392;14.122999999999999;10.98;18;748;5501;68;77;440;315;5571.8999999999996;2691.5;2880.4000000000001;44.890000000000001;936;844;4280;729;679;872;709;4096;970;1345;12;171;2371
6;161001;Campos;656;711;635;688;345;321;313;284;32;37;9.2750000000000004;11.526;15;240;342;3;4;29;33;259.5;124.5;135;41.609999999999999;106;61;375;63;51;99;82;374;74;82;18;268;3606
6;30905;Campos;525;521;517;519;239;226;218;204;21;22;8.7870000000000008;9.7349999999999994;10;221;191;3;9;18;13;321.10000000000002;161.19999999999999;159.90000000000001;38.880000000000003;108;56;298;41;22;77;55;317;38;34;4;60;803
6;170701;Candedo;497;505;479;497;208;61;185;47;23;14;11.058;22.951000000000001;157;19;56;14;6;9;8;34.799999999999997;17.300000000000001;17.5;49.020000000000003;60;65;233;68;71;42;46;225;106;86;19;275;3757
6;131703;Canelas;6525;6934;6289;6814;3700;3474;3133;2788;567;686;15.324;19.747;19;1802;4100;91;98;476;588;1950.2;945.5;1004.7;37.380000000000003;1243;795;3861;390;236;1142;760;4188;446;398;15;224;3034
6;10803;Canelas;689;749;661;733;362;282;332;252;30;30;8.2870000000000008;10.638;25;238;321;3;7;27;23;134.69999999999999;64.599999999999994;70.200000000000003;44.329999999999998;103;63;386;75;62;91;67;399;94;98;1;8;94
6;130304;Caramos;893;961;832;922;509;457;456;398;53;59;10.413;12.91;18;438;398;8;12;45;47;569.29999999999995;274.19999999999999;295.10000000000002;37.630000000000003;149;116;530;59;39;159;132;552;69;49;15;209;2736
6;61603;Carapinha;190;212;184;205;101;76;92;74;9;2;8.9109999999999996;2.6320000000000001;5;85;76;1;0;8;2;42.700000000000003;20.199999999999999;22.5;45.729999999999997;25;17;105;17;26;29;20;95;30;38;7;104;1631
6;40710;Caravelas;107;107;104;103;64;50;62;47;2;3;3.125;6;73;14;22;0;1;2;2;17;8.5;8.5;55.420000000000002;7;10;45;21;24;7;3;53;18;26;5;72;1138
6;41107;Carção;198;221;193;213;74;45;65;37;9;8;12.162000000000001;17.777999999999999;16;30;56;2;5;7;3;15.300000000000001;7.2000000000000002;8.0999999999999996;54.859999999999999;20;12;88;38;40;12;20;76;64;49;5;76;1236
6;30107;Carrazedo;335;397;325;399;194;171;173;142;21;29;10.824999999999999;16.959;19;111;185;2;5;19;24;270.30000000000001;123.7;146.59999999999999;39.030000000000001;48;44;204;23;16;72;37;218;35;35;4;53;473
6;140707;Carregueira;973;1047;920;1007;466;403;399;352;67;51;14.378;12.654999999999999;58;277;416;4;10;63;41;20.5;9.9000000000000004;10.6;45.590000000000003;123;77;549;131;93;134;104;521;141;147;16;231;3102
6;30219;Carreira;710;741;673;728;381;370;339;327;42;43;11.023999999999999;11.622;27;390;249;8;11;34;32;448.19999999999999;219.30000000000001;228.90000000000001;38.490000000000002;140;84;399;57;30;98;105;430;60;48;4;54;511
6;121403;Carreiras;298;285;290;280;136;126;127;112;9;14;6.6180000000000003;11.111000000000001;30;52;157;2;5;7;9;17.5;8.9000000000000004;8.5;46.890000000000001;33;37;152;29;47;29;20;154;29;53;14;205;2661
6;181604;Carvalhais;694;742;648;764;337;269;313;230;24;39;7.1219999999999999;14.497999999999999;60;177;306;6;7;18;32;62;30;32;44.530000000000001;105;86;350;85;68;93;71;369;107;102;20;298;4110
6;30220;Carvalhal;668;723;653;712;362;289;339;261;23;28;6.3540000000000001;9.6890000000000001;14;350;236;5;4;18;24;539.20000000000005;258.89999999999998;280.30000000000001;42.530000000000001;84;80;395;65;44;96;75;401;88;63;4;54;512
6;50902;Carvalhal;203;262;196;255;103;91;98;81;5;10;4.8540000000000001;10.989000000000001;21;67;91;0;5;5;5;46.399999999999999;20.300000000000001;26.199999999999999;47.829999999999998;19;24;112;26;22;27;24;125;33;53;6;86;1419
6;90903;Carvalhal;49;60;46;57;20;6;17;6;3;0;15;0;4;10;9;0;0;3;0;9.1999999999999993;4.0999999999999996;5;50.289999999999999;5;2;25;11;6;11;2;21;13;13;10;143;2002
6;90710;Carvalhal Meão;24;27;24;27;7;3;6;1;1;2;14.286;66.667000000000002;2;3;2;0;0;1;2;6.9000000000000004;3.2000000000000002;3.6000000000000001;64.799999999999997;;;8;7;9;1;1;6;8;11;10;141;1950
6;180902;Carvalhal Redondo;468;506;456;497;176;151;163;125;13;26;7.3860000000000001;17.219000000000001;3;147;138;2;6;11;20;121.59999999999999;58.5;63.200000000000003;47.520000000000003;65;36;246;63;58;50;43;254;77;82;20;291;4028
6;130902;Carvalhosa;2266;2317;2193;2249;1320;1108;1144;955;176;153;13.333;13.808999999999999;9;1281;809;17;23;159;130;765.20000000000005;378.39999999999998;386.89999999999998;36.170000000000002;440;322;1290;127;87;426;317;1314;142;118;15;215;2861
6;141805;Casais;1128;1214;1070;1180;548;428;453;353;95;75;17.335999999999999;17.523;20;242;544;11;18;84;57;85.599999999999994;41.299999999999997;44.399999999999999;45.409999999999997;163;119;603;118;125;157;124;602;158;173;16;243;3216
6;111115;Casal de Cambra;6168;6533;5999;6436;3383;3435;2830;2964;553;471;16.346;13.712;9;1164;4621;109;92;444;379;5854.3000000000002;2843;3011.3000000000002;35.859999999999999;1257;802;3487;440;182;1236;817;3770;457;253;12;177;2482
6;90711;Casal de Cinza;274;287;249;257;141;104;126;86;15;18;10.638;17.308;10;61;141;2;1;13;17;31.199999999999999;15.300000000000001;16;45.649999999999999;31;34;146;27;36;36;33;137;36;45;10;141;1951
6;50306;Casegas;179;246;162;233;60;63;53;51;7;12;11.667;19.047999999999998;1;34;69;0;2;7;10;10.300000000000001;4.4000000000000004;6;56.590000000000003;10;14;80;47;28;15;15;102;44;70;6;80;1315
6;91303;Castanheira;105;89;117;127;50;27;46;26;4;1;8;3.7039999999999997;19;17;36;0;0;4;1;19.399999999999999;10.5;8.9000000000000004;43.939999999999998;18;12;53;8;14;6;10;49;10;14;10;147;2114
6;90904;Casteição;56;63;53;60;11;13;9;8;2;5;18.181999999999999;38.462000000000003;3;3;11;0;0;2;5;9.8000000000000007;4.5999999999999996;5.2000000000000002;58.039999999999999;5;6;17;12;16;5;1;24;16;17;10;143;2003
6;50205;Castelo Branco;16645;18597;15998;18320;8776;9207;7955;8204;821;1003;9.3550000000000004;10.894;248;3218;12693;174;195;647;808;207;97.799999999999997;109.2;40.899999999999999;2601;1890;9709;1375;1070;2631;1996;10619;1634;1717;6;79;1288
6;181102;Castelo de Penalva;440;474;434;476;165;114;155;82;10;32;6.0609999999999999;28.07;25;97;115;3;9;7;23;33.700000000000003;16.199999999999999;17.5;52.979999999999997;47;40;196;65;92;34;30;221;73;116;20;293;4048
6;31210;Castelões;997;1024;962;997;505;469;448;407;57;62;11.287000000000001;13.220000000000001;7;523;325;9;5;48;57;572.79999999999995;282.60000000000002;290.19999999999999;38.460000000000001;203;115;569;61;49;150;126;589;80;79;4;63;877
6;131107;Castelões;657;740;620;730;366;294;321;241;45;53;12.295;18.027000000000001;7;298;257;5;5;40;48;331.10000000000002;155.69999999999999;175.40000000000001;39.479999999999997;96;81;403;45;32;120;83;423;55;59;15;217;2906
6;182105;Castelões;703;839;665;814;317;265;278;226;39;39;12.303000000000001;14.717000000000001;44;188;272;4;11;35;28;90.099999999999994;41.100000000000001;49;49.329999999999998;90;68;349;111;85;82;61;400;127;169;20;303;4186
6;180304;Castro Daire;2210;2464;2072;2353;1070;882;979;782;91;100;8.5050000000000008;11.337999999999999;43;351;1367;23;25;68;75;143.69999999999999;67.900000000000006;75.799999999999997;41.719999999999999;384;263;1182;194;187;384;273;1266;244;297;20;285;3918
6;131204;Cedofeita;9736;12341;9970;12844;4891;5399;4043;4611;848;788;17.338000000000001;14.595000000000001;19;1012;7623;162;166;686;622;8157.3999999999996;3597.4000000000001;4560;47.119999999999997;1066;1000;5436;1219;1015;1042;1016;6592;1668;2023;15;218;2941
6;90316;Celorico (Santa Maria);424;471;410;458;227;204;190;180;37;24;16.300000000000001;11.765000000000001;10;105;255;8;8;29;16;57.799999999999997;27.399999999999999;30.399999999999999;44.200000000000003;62;44;240;38;40;47;40;260;65;59;10;137;1869
6;110403;Cercal;266;294;199;250;127;93;111;76;16;17;12.598000000000001;18.280000000000001;19;39;129;1;2;15;15;27.600000000000001;13.1;14.5;46.609999999999999;29;21;150;27;39;44;16;137;41;56;12;169;2348
6;150903;Cercal;1650;1712;1517;1614;829;596;745;497;84;99;10.132999999999999;16.611000000000001;75;382;785;9;16;75;83;24.5;12;12.5;48.590000000000003;170;134;897;219;230;172;150;844;256;290;17;254;3303
6;180802;Cercosa;148;155;136;146;71;48;68;43;3;5;4.2249999999999996;10.417;8;45;58;1;1;2;4;34.799999999999997;17;17.800000000000001;49.82;10;15;76;30;17;10;15;84;21;25;20;290;4017
6;40103;Cerejais;90;112;86;109;32;28;28;24;4;4;12.5;14.286;8;10;34;0;0;4;4;11.9;5.2999999999999998;6.5999999999999996;59.649999999999999;6;7;40;18;19;2;7;45;19;39;5;66;982
6;50904;Cernache do Bonjardim;1451;1601;1359;1527;683;549;615;460;68;89;9.9559999999999995;16.210999999999999;57;370;648;14;25;54;64;42.600000000000001;20.300000000000001;22.399999999999999;45.380000000000003;205;152;807;139;148;185;155;822;190;249;6;86;1421
6;170603;Cervos;137;134;137;131;58;51;46;45;12;6;20.690000000000001;11.765000000000001;29;21;41;3;2;9;4;8.1999999999999993;4.2000000000000002;4.0999999999999996;50.579999999999998;9;22;68;22;16;13;11;63;19;28;19;274;3724
6;100931;Chainça;403;369;382;366;209;166;190;154;19;12;9.0909999999999993;7.2290000000000001;4;154;186;4;3;15;9;142.5;74.400000000000006;68.099999999999994;41.490000000000002;58;67;212;40;26;49;44;208;39;29;11;157;2234
6;31005;Chamoim;128;163;128;165;51;51;44;32;7;19;13.725;37.255000000000003;8;30;38;5;6;2;13;36.399999999999999;16;20.399999999999999;45.590000000000003;17;15;59;19;18;28;13;75;19;28;4;61;832
6;120102;Chancelaria;202;246;203;250;84;71;74;65;10;6;11.904999999999999;8.4510000000000005;39;18;82;1;0;9;6;6.2999999999999998;2.7999999999999998;3.3999999999999999;54.850000000000001;15;15;103;25;44;20;20;87;41;78;14;192;2588
6;130111;Chapa;143;158;133;158;81;51;75;42;6;9;7.407;17.646999999999998;4;66;47;1;0;5;9;92.200000000000003;43.799999999999997;48.399999999999999;40.850000000000001;19;12;92;11;9;24;17;83;20;14;15;207;2684
6;150309;Charneca de Caparica;14647;15116;13899;14705;7545;7331;6702;6563;843;768;11.173;10.475999999999999;41;2060;11164;166;141;677;627;1286.0999999999999;632.89999999999998;653.20000000000005;39.509999999999998;2792;1510;8154;1371;820;2622;1322;8630;1394;1148;17;248;3261
6;91404;Chãs;130;148;132;147;48;25;47;24;1;1;2.0830000000000002;4;31;7;33;0;1;1;0;15.800000000000001;7.4000000000000004;8.4000000000000004;58.640000000000001;8;11;59;24;28;7;11;43;35;52;10;148;2144
6;10407;Chave;604;649;573;619;331;267;311;249;20;18;6.0419999999999998;6.742;45;279;236;6;1;14;17;114.90000000000001;55.399999999999999;59.5;42.390000000000001;76;85;344;54;45;90;73;349;70;67;1;4;50
6;40602;Cicouro;47;48;48;49;15;9;14;9;1;0;6.6669999999999998;0;6;9;8;0;0;1;0;6.4000000000000004;3.2000000000000002;3.2000000000000002;52.789999999999999;5;6;19;8;9;3;4;19;10;12;5;71;1114
6;180104;Cimbres;148;160;141;151;57;42;50;31;7;11;12.281000000000001;26.190000000000001;20;13;48;1;5;6;6;50.700000000000003;24.399999999999999;26.300000000000001;46.560000000000002;22;13;73;25;15;14;23;73;23;27;20;283;3892
6;170309;Cimo de Vila da Castanheira;230;249;222;247;85;24;75;16;10;8;11.765000000000001;33.332999999999998;39;21;31;5;2;5;6;29.199999999999999;14;15.199999999999999;50.82;19;20;119;33;39;22;33;108;43;43;19;271;3663
6;11904;Codal;471;475;460;467;272;216;259;195;13;21;4.7789999999999999;9.7219999999999995;1;271;182;1;5;12;16;321.10000000000002;159.90000000000001;161.19999999999999;40.890000000000001;69;53;288;41;20;62;44;285;50;34;1;19;202
6;60108;Coja;680;747;646;724;330;278;298;254;32;24;9.6969999999999992;8.6329999999999991;8;201;343;6;3;26;21;68.099999999999994;32.5;35.700000000000003;48.479999999999997;73;72;366;101;68;61;66;385;100;135;7;89;1446
6;90405;Colmeal;23;19;24;20;12;6;11;6;1;0;8.3330000000000002;0;14;0;3;0;0;1;0;1;0.59999999999999998;0.5;54.259999999999998;3;;11;4;5;3;;9;4;3;10;138;1890
6;120903;Comenda;418;472;393;455;159;137;135;110;24;27;15.093999999999999;19.707999999999998;23;61;161;2;6;22;21;9.9000000000000004;4.5999999999999996;5.2000000000000002;54.5;35;30;183;70;100;35;36;177;94;130;14;200;2631
6;150106;Comporta;652;616;621;594;355;285;309;244;46;41;12.958;14.385999999999999;110;110;333;4;5;42;36;8.4000000000000004;4.2999999999999998;4.0999999999999996;43.25;94;65;376;67;50;75;59;348;65;69;17;246;3251
6;140117;Concavada;343;310;312;294;159;109;121;86;38;23;23.899000000000001;21.100999999999999;4;89;114;6;2;32;21;31.800000000000001;16.699999999999999;15.1;43.140000000000001;55;39;188;32;29;42;28;156;40;44;16;225;3063
6;140801;Constância;468;525;439;508;225;235;200;216;25;19;11.111000000000001;8.0850000000000009;7;84;325;5;4;20;15;112.40000000000001;53;59.5;42.740000000000002;89;45;256;42;36;73;39;291;47;75;16;232;3109
6;40603;Constantim;49;60;47;53;11;11;9;8;2;3;18.181999999999999;27.273;6;1;10;0;2;2;1;5.0999999999999996;2.2999999999999998;2.7999999999999998;64.359999999999999;2;2;16;13;16;1;1;19;18;21;5;71;1115
6;60205;Cordinhã;500;534;472;521;254;208;239;189;15;19;5.9059999999999997;9.1349999999999998;64;139;225;2;2;13;17;104.3;50.399999999999999;53.899999999999999;45.829999999999998;66;48;277;63;46;60;44;284;75;71;7;90;1462
6;151005;Corroios;22843;24818;21515;23980;12253;12454;10766;10943;1487;1511;12.135999999999999;12.132999999999999;40;3288;18381;299;290;1188;1221;2785.5;1335;1450.5;39.780000000000001;3923;2563;13239;2083;1035;3723;2506;14783;2079;1727;17;255;3315
6;20902;Corte do Pinto;430;427;427;416;154;104;113;81;41;23;26.623000000000001;22.114999999999998;14;34;146;3;4;38;19;12;6;6;51.799999999999997;45;40;197;81;67;42;30;174;92;89;3;47;415
6;180803;Cortegaça;208;229;205;225;99;78;93;73;6;5;6.0609999999999999;6.4100000000000001;13;40;113;0;0;6;5;34.5;16.399999999999999;18.100000000000001;46.060000000000002;26;23;113;34;12;24;16;126;36;27;20;290;4018
6;100911;Cortes;1492;1509;1392;1441;792;667;735;609;57;58;7.1970000000000001;8.6959999999999997;24;434;886;13;17;44;41;179.30000000000001;89.200000000000003;90.200000000000003;42.75;206;197;841;146;102;192;169;841;166;141;11;157;2237
6;70608;Cortiçadas de Lavre;402;419;380;411;198;117;185;109;13;8;6.5659999999999998;6.8380000000000001;52;95;147;1;1;12;7;8.3000000000000007;4.0999999999999996;4.2000000000000002;51.399999999999999;38;32;203;63;66;40;27;182;86;84;8;111;1699
6;71102;Corval;668;721;654;698;315;234;263;202;52;32;16.507999999999999;13.675000000000001;72;121;272;12;4;40;28;14.4;6.9000000000000004;7.5;48.520000000000003;90;63;332;89;94;67;69;334;94;157;8;116;1726
6;30874;Corvite;448;435;436;429;249;210;225;184;24;26;9.6389999999999993;12.381;0;247;162;2;2;22;24;477.89999999999998;242.5;235.40000000000001;36.469999999999999;84;65;256;24;19;82;61;237;25;30;4;55;610
6;170106;Cotas;119;126;111;122;63;37;56;26;7;11;11.111000000000001;29.73;49;14;19;0;3;7;8;15.9;7.7000000000000002;8.1999999999999993;46.350000000000001;17;6;70;13;13;13;11;65;20;17;19;269;3626
6;31311;Coucieiro;248;283;247;277;136;121;127;99;9;22;6.6180000000000003;18.181999999999999;27;45;154;1;6;8;16;125.90000000000001;58.799999999999997;67.099999999999994;42.829999999999998;32;33;141;19;23;37;31;152;28;35;4;64;927
6;160304;Cousso;122;172;119;162;31;23;28;21;3;2;9.6769999999999996;8.6959999999999997;2;19;28;1;0;2;2;40.600000000000001;16.899999999999999;23.800000000000001;59.57;8;4;50;33;27;5;7;77;39;44;18;261;3405
6;160109;Couto;286;329;279;313;112;93;101;79;11;14;9.8209999999999997;15.054;9;61;110;1;2;10;12;106.3;49.399999999999999;56.899999999999999;51.18;31;21;148;54;32;23;26;160;55;65;18;259;3341
6;150304;Cova da Piedade;9082;10822;8525;10410;4306;4583;3700;3997;606;586;14.073;12.786;13;1071;6613;108;110;498;476;13984;6380.8000000000002;7603.1999999999998;46.939999999999998;1164;823;4838;1270;987;1165;845;5642;1580;1590;17;248;3263
6;181605;Covas do Rio;55;65;56;64;17;8;16;8;1;0;5.8819999999999997;0;11;6;7;0;0;1;0;5.2999999999999998;2.3999999999999999;2.8999999999999999;61.159999999999997;1;1;22;7;24;4;5;25;12;19;20;298;4111
6;130401;Covelo;819;828;797;810;467;338;422;287;45;51;9.6359999999999992;15.089;5;282;422;8;10;37;41;147.40000000000001;73.299999999999997;74.099999999999994;41.640000000000001;121;89;505;58;46;95;105;472;80;76;15;210;2766
6;131705;Crestuma;1273;1348;1221;1312;693;602;574;472;119;130;17.172000000000001;21.594999999999999;3;412;631;9;11;110;119;559.60000000000002;271.80000000000001;287.80000000000001;42.219999999999999;187;142;754;117;73;178;149;776;125;120;15;224;3036
6;160208;Cristelo;121;123;151;120;58;50;51;43;7;7;12.069000000000001;14;4;22;68;1;0;6;7;73.700000000000003;36.600000000000001;37.200000000000003;44.829999999999998;19;15;63;12;12;11;9;73;13;17;18;260;3389
6;160506;Cristelo;151;166;146;161;73;56;59;48;14;8;19.178000000000001;14.286;9;39;59;4;4;10;4;105.7;50.299999999999997;55.299999999999997;46.159999999999997;16;14;85;16;20;24;12;85;23;22;18;263;3458
6;160804;Cristelo Covo;457;508;442;503;231;211;194;172;37;39;16.016999999999999;18.483000000000001;4;126;236;3;9;34;30;321.30000000000001;152.09999999999999;169.09999999999999;44.07;58;50;264;51;34;59;50;274;63;62;18;266;3553
6;160305;Cristoval;231;297;219;279;70;60;60;50;10;10;14.286;16.667000000000002;5;24;81;4;4;6;6;95;41.600000000000001;53.5;56.159999999999997;15;23;100;44;49;17;18;118;60;84;18;261;3406
6;160306;Cubalhão;69;87;68;86;12;9;11;9;1;0;8.3330000000000002;0;5;2;13;0;0;1;0;13.4;5.9000000000000004;7.5;59.939999999999998;4;2;21;24;18;4;5;36;22;20;18;261;3407
6;160606;Cuide de Vila Verde;157;187;155;184;76;56;72;45;4;11;5.2629999999999999;19.643000000000001;6;48;63;1;5;3;6;90.099999999999994;41.100000000000001;49;43.280000000000001;28;15;82;15;17;27;18;92;21;29;18;264;3479
6;160507;Cunha;255;274;241;257;132;101;118;88;14;13;10.606;12.871;6;117;83;7;4;7;9;53;25.600000000000001;27.5;43.229999999999997;44;28;136;20;27;28;30;144;31;41;18;263;3459
6;30309;Cunha;308;338;290;325;159;162;142;148;17;14;10.692;8.6419999999999995;26;125;139;6;0;11;14;195;93;102;38.659999999999997;69;35;175;13;16;48;36;207;13;34;4;55;614
6;180604;Cunha Alta;57;82;55;79;22;23;20;22;2;1;9.0909999999999993;4.3479999999999999;0;15;27;0;0;2;1;32.899999999999999;13.5;19.399999999999999;50.079999999999998;6;4;25;10;12;9;12;34;9;18;20;288;3981
6;180203;Currelos;1168;1279;1121;1256;547;519;479;463;68;56;12.430999999999999;10.789999999999999;21;308;613;12;15;56;41;148.90000000000001;71.099999999999994;77.799999999999997;41.689999999999998;207;130;599;117;115;204;125;665;136;149;20;284;3910
6;130801;Custóias;9287;9363;8992;9190;4912;4420;4192;3747;720;673;14.657999999999999;15.226000000000001;60;1742;6137;107;123;613;550;3090.5;1539;1551.5999999999999;40.479999999999997;1426;1158;5448;789;466;1337;1004;5434;890;698;15;214;2850
6;40211;Deilão;80;88;79;88;23;11;20;9;3;2;13.042999999999999;18.181999999999999;14;8;7;1;1;2;1;4;1.8999999999999999;2.1000000000000001;60.509999999999998;3;3;38;17;19;2;8;27;26;25;5;67;1012
6;181905;Desejosa;88;87;67;69;50;18;48;17;2;1;4;5.556;46;8;11;2;0;0;1;23.399999999999999;11.800000000000001;11.6;47.649999999999999;6;9;55;9;9;8;9;45;13;12;20;301;4159
6;181003;Destriz;161;186;147;178;89;59;86;52;3;7;3.371;11.864000000000001;17;79;42;0;2;3;5;26.699999999999999;12.4;14.300000000000001;47.609999999999999;14;17;94;19;17;19;14;94;25;34;20;292;4037
6;40212;Donai;216;230;200;217;107;86;99;76;8;10;7.4770000000000003;11.628;16;35;124;2;4;6;6;29.600000000000001;14.300000000000001;15.300000000000001;43.880000000000003;42;24;116;21;13;22;25;123;25;35;5;67;1013
6;30814;Donim;386;447;363;444;183;192;163;165;20;27;10.929;14.063000000000001;5;191;132;4;5;16;22;261.60000000000002;121.2;140.40000000000001;41.409999999999997;64;59;199;36;28;64;44;237;49;53;4;55;615
6;170608;Donões;30;32;28;32;10;6;10;6;0;0;0;0;4;3;9;0;0;0;0;3.6000000000000001;1.8;1.8999999999999999;48.420000000000002;4;1;17;4;4;6;2;14;7;3;19;274;3729
6;30108;Dornelas;246;262;239;261;116;70;110;57;6;13;5.1719999999999997;18.571000000000002;7;61;99;0;1;6;12;150;72.700000000000003;77.400000000000006;42.520000000000003;40;23;142;24;17;34;30;138;32;28;4;53;474
6;170210;Dornelas;155;183;176;200;45;20;41;17;4;3;8.8889999999999993;15;23;12;23;1;0;3;3;9.1999999999999993;4.2000000000000002;5;56.789999999999999;7;8;74;31;35;12;15;69;38;49;19;270;3649
6;90105;Dornelas;329;361;317;351;126;110;120;104;6;6;4.7620000000000005;5.4550000000000001;45;47;132;2;1;4;5;29.100000000000001;13.9;15.199999999999999;52.340000000000003;29;33;176;41;50;23;36;163;52;87;10;135;1826
6;141105;Dornes;288;306;287;301;112;100;101;91;11;9;9.8209999999999997;9;48;52;92;1;1;10;8;27.100000000000001;13.199999999999999;14;50.039999999999999;41;27;132;40;48;31;25;127;60;63;16;235;3126
6;131109;Duas Igrejas;1188;1238;1084;1227;649;506;581;436;68;70;10.478;13.834;25;635;357;10;21;58;49;297.5;145.69999999999999;151.80000000000001;35.119999999999997;229;187;653;69;50;256;184;660;77;61;15;217;2908
6;41207;Edrosa;75;76;75;75;24;17;23;16;1;1;4.1669999999999998;5.8819999999999997;17;4;18;1;1;0;0;6.9000000000000004;3.3999999999999999;3.5;55.93;3;8;36;11;17;4;2;36;17;17;5;77;1250
6;160110;Eiras;128;141;130;139;47;28;39;27;8;1;17.021000000000001;3.5709999999999997;6;31;29;3;0;5;1;69;32.799999999999997;36.200000000000003;53.280000000000001;12;17;61;21;17;7;10;65;26;33;18;259;3342
6;10503;Eirol;375;378;359;365;187;152;175;140;12;12;6.4169999999999998;7.8949999999999996;11;147;157;1;2;11;10;131.90000000000001;65.700000000000003;66.200000000000003;44.82;47;51;199;34;44;35;45;205;42;51;1;5;66
6;140602;Ereira;310;326;305;325;134;104;119;91;15;13;11.194000000000001;12.5;9;52;149;1;1;14;12;100.8;49.200000000000003;51.700000000000003;47.850000000000001;43;18;157;59;33;48;16;151;50;61;16;230;3095
6;131503;Ermesinde;18358;20440;17463;19844;9784;9615;8260;7838;1524;1777;15.576000000000001;18.481999999999999;29;3795;12274;278;337;1246;1440;5070;2399;2671.0999999999999;40.810000000000002;2978;2151;10604;1660;965;2780;2081;12083;1930;1566;15;222;2999
6;160608;Ermida;31;30;30;29;6;4;5;3;1;1;16.667000000000002;25;1;3;4;0;1;1;0;5.5;2.7999999999999998;2.7000000000000002;56.149999999999999;3;4;12;5;7;1;1;12;9;7;18;264;3481
6;180306;Ermida;124;133;124;132;32;36;24;30;8;6;25;16.667000000000002;24;13;17;1;3;7;3;27.800000000000001;13.4;14.4;54.340000000000003;10;11;49;22;32;13;13;44;33;30;20;285;3920
6;140906;Erra;491;513;457;499;230;198;205;174;25;24;10.869999999999999;12.121;57;119;203;4;3;21;21;15.699999999999999;7.7000000000000002;8;49.43;52;53;241;71;74;42;41;247;97;86;16;233;3116
6;91008;Ervas Tenras;69;73;64;67;36;27;33;25;3;2;8.3330000000000002;7.407;14;14;30;2;2;1;0;26.199999999999999;12.699999999999999;13.5;43.030000000000001;13;7;39;5;5;6;14;31;11;11;10;144;2023
6;170312;Ervededo;328;318;319;309;100;50;86;47;14;3;14;6;37;25;71;4;1;10;2;32;16.199999999999999;15.699999999999999;51.719999999999999;30;25;168;52;53;29;19;148;64;58;19;271;3666
6;90406;Escalhão;355;415;343;408;144;111;126;98;18;13;12.5;11.712;59;33;132;1;2;17;11;9.8000000000000007;4.5;5.2999999999999998;51.509999999999998;35;41;174;53;52;34;32;169;70;110;10;138;1891
6;10904;Escapães;1571;1738;1509;1696;898;857;806;737;92;120;10.244999999999999;14.002000000000001;6;718;819;13;23;79;97;768.79999999999995;365;403.80000000000001;41;211;181;961;129;89;240;204;997;152;145;1;15;152
6;90407;Escarigo;39;60;39;60;9;5;9;3;0;2;0;40;8;2;2;0;1;0;1;5.7000000000000002;2.2999999999999998;3.5;60.950000000000003;2;2;12;10;13;7;2;16;10;25;10;138;1892
6;50415;Escarigo;100;124;96;119;31;36;22;24;9;12;29.032;33.332999999999998;8;20;18;0;2;9;10;24.5;10.9;13.6;58.369999999999997;3;5;46;21;25;6;9;49;25;35;6;81;1355
6;31346;Escariz (São Martinho);183;178;178;174;93;77;86;65;7;12;7.5270000000000001;15.584;11;60;80;2;1;5;11;152.90000000000001;77.5;75.400000000000006;43.57;28;22;96;24;13;17;18;101;21;21;4;64;932
6;31214;Esmeriz;1095;1123;1062;1110;611;556;544;474;67;82;10.965999999999999;14.747999999999999;11;501;506;7;13;60;69;562.20000000000005;277.60000000000002;284.69999999999999;37.759999999999998;216;121;644;75;39;194;127;653;82;67;4;63;881
6;120202;Esperança;369;370;361;367;165;105;126;86;39;19;23.635999999999999;18.094999999999999;27;51;134;2;0;37;19;12.9;6.5;6.5;51.810000000000002;34;27;180;53;75;33;28;153;63;93;14;193;2592
6;180804;Espinho;528;577;502;559;244;143;230;121;14;22;5.7379999999999995;15.385;42;151;158;2;2;12;20;26.699999999999999;12.800000000000001;14;50.020000000000003;47;50;287;79;65;47;48;288;94;100;20;290;4019
6;142105;Espite;501;603;487;583;197;173;185;157;12;16;6.0910000000000002;9.2490000000000006;3;138;201;1;1;11;15;55.799999999999997;25.300000000000001;30.5;50.130000000000003;62;56;218;85;80;50;58;265;104;126;16;238;3146
6;10410;Espiunca;194;188;174;171;87;57;82;37;5;20;5.7469999999999999;35.088000000000001;28;46;45;0;6;5;14;26.899999999999999;13.6;13.199999999999999;43.469999999999999;21;31;101;20;21;23;25;91;28;21;1;4;53
6;31315;Esqueiros;237;256;222;241;132;108;108;89;24;19;18.181999999999999;17.593;4;71;122;5;5;19;14;254.19999999999999;122.2;132;40.020000000000003;33;38;135;21;10;40;25;151;20;20;4;64;933
6;131307;Estela;1123;1193;1063;1170;592;542;539;482;53;60;8.9529999999999994;11.07;196;394;431;11;20;42;40;198.09999999999999;96;102;38.619999999999997;233;142;615;83;50;188;148;645;122;90;15;219;2959
6;180307;Ester;108;112;111;111;39;19;27;13;12;6;30.768999999999998;31.579000000000001;16;14;10;3;5;9;1;19;9.4000000000000004;9.6999999999999993;52.25;11;14;46;11;26;9;12;41;18;32;20;285;3921
6;80601;Estômbar;2488;2497;2524;2452;1336;1176;1085;979;251;197;18.786999999999999;16.751999999999999;26;390;1648;30;30;221;167;205.90000000000001;102.8;103.09999999999999;41.759999999999998;372;254;1422;267;173;386;266;1346;253;246;9;125;1773
6;30708;Estorãos;715;793;708;788;367;333;318;269;49;64;13.350999999999999;19.219000000000001;6;338;243;7;9;42;55;255.40000000000001;121.09999999999999;134.30000000000001;41.869999999999997;99;84;423;57;52;108;99;443;69;74;4;59;772
6;110504;Estoril;12062;14337;11586;13849;6024;6232;5236;5461;788;771;13.081;12.372;57;1107;9533;168;148;620;623;2987;1364.8;1622.2;43.149999999999999;1855;1476;6450;1265;1016;1839;1396;7715;1641;1746;12;170;2359
6;50604;Estreito;439;458;405;440;166;104;163;99;3;5;1.8069999999999999;4.8079999999999998;10;100;152;2;2;1;3;12.800000000000001;6.2999999999999998;6.5999999999999996;56.850000000000001;24;35;208;78;94;17;26;174;114;127;6;83;1391
6;100108;Évora de Alcobaça;2200;2285;2089;2223;1139;934;1048;818;91;116;7.9889999999999999;12.42;190;628;1048;17;31;74;85;105.7;51.899999999999999;53.899999999999999;43.32;329;254;1226;212;179;297;242;1207;273;266;11;149;2167
6;160112;Extremo;73;87;72;86;27;21;25;18;2;3;7.407;14.286;6;11;26;0;3;2;0;37.299999999999997;17;20.300000000000001;50.189999999999998;6;5;43;8;11;10;8;39;13;17;18;259;3344
6;30709;Fafe;7368;8335;6939;8040;3817;3910;3227;3280;590;630;15.457000000000001;16.113;26;2295;4186;111;109;479;521;1970.3;924.5;1045.8;39.979999999999997;1249;929;4243;590;357;1162;968;4801;741;663;4;59;773
6;30408;Faia;283;275;265;272;123;74;105;51;18;23;14.634;31.081;13;64;79;3;9;15;14;108.40000000000001;55;53.399999999999999;40.509999999999998;52;44;133;30;24;47;33;134;35;26;4;56;716
6;90716;Faia;95;132;94;131;40;33;37;30;3;3;7.5;9.0909999999999993;5;8;54;0;1;3;2;22.699999999999999;9.5;13.199999999999999;56.109999999999999;6;9;42;25;13;7;8;55;30;32;10;141;1956
6;131607;Fajozes;699;726;661;715;377;328;340;282;37;46;9.8140000000000001;14.023999999999999;37;232;353;5;4;32;42;239;117.3;121.8;41.240000000000002;105;82;404;71;37;103;80;405;72;66;15;223;3008
6;90717;Famalicão;294;321;290;318;117;96;94;86;23;10;19.658000000000001;10.417;16;95;69;0;0;23;10;38.399999999999999;18.399999999999999;20;50.159999999999997;34;22;142;34;62;41;19;135;62;64;10;141;1957
6;30606;Fão;1465;1638;1373;1569;798;806;694;695;104;111;13.032999999999999;13.772;27;439;923;14;13;90;98;538.79999999999995;254.40000000000001;284.39999999999998;40.950000000000003;234;196;834;119;82;210;170;954;134;170;4;58;753
6;30710;Fareja;420;435;409;423;219;202;200;188;19;14;8.6760000000000002;6.931;5;262;121;4;4;15;10;265.39999999999998;130.40000000000001;135;36.32;80;62;239;23;16;83;63;238;24;27;4;59;774
6;182314;Farminhão;339;411;324;402;159;151;142;140;17;11;10.692;7.2850000000000001;6;53;223;4;4;13;7;68.400000000000006;30.899999999999999;37.5;48.700000000000003;44;29;172;49;45;47;29;191;56;88;20;305;4227
6;142106;Fátima;5238;6358;5073;6361;2747;2864;2542;2616;205;248;7.4630000000000001;8.6590000000000007;26;1388;3744;37;51;168;197;161.40000000000001;72.900000000000006;88.5;41.460000000000001;910;670;2847;429;382;891;731;3257;660;819;16;238;3147
6;10906;Feira;5947;6564;5680;6352;3378;3409;2994;2922;384;487;11.368;14.286;19;1666;4231;66;76;318;411;1221.4000000000001;580.60000000000002;640.79999999999995;37.82;1064;741;3499;380;263;1034;705;3987;469;369;1;15;154
6;181304;Feirão;54;63;51;57;28;9;26;8;2;1;7.1429999999999998;11.111000000000001;5;15;14;0;1;2;0;23.899999999999999;11.1;12.9;44.340000000000003;4;8;31;5;6;8;10;26;7;12;20;295;4072
6;40907;Felgar;455;499;450;485;219;144;198;115;21;29;9.5890000000000004;20.138999999999999;23;96;194;6;9;15;20;27.699999999999999;13.199999999999999;14.5;46.479999999999997;51;53;237;63;51;63;50;243;71;72;5;74;1200
6;181305;Felgueiras;152;167;145;159;69;46;62;35;7;11;10.145;23.913;23;26;48;2;5;5;6;38;18.100000000000001;19.899999999999999;43.210000000000001;32;13;76;12;19;19;21;79;20;28;20;295;4073
6;10411;Fermedo;640;700;614;675;349;264;326;235;23;29;6.5899999999999999;10.984999999999999;30;333;198;5;7;18;22;120.7;57.600000000000001;63;40.530000000000001;100;74;368;69;29;126;64;367;77;66;1;4;54
6;80602;Ferragudo;1003;970;1053;1020;501;433;423;368;78;65;15.568999999999999;15.012;34;115;642;10;10;68;55;364.69999999999999;185.40000000000001;179.30000000000001;45.979999999999997;139;94;562;119;89;97;74;544;125;130;9;125;1774
6;80104;Ferreiras;3178;3228;3017;3127;1900;1755;1606;1457;294;298;15.474;16.98;21;438;2604;35;45;259;253;318.30000000000001;157.90000000000001;160.40000000000001;38.130000000000003;540;368;1909;218;143;546;332;1916;226;208;9;120;1740
6;131608;Ferreiró;339;351;322;345;172;148;156;130;16;18;9.3019999999999996;12.162000000000001;28;148;110;4;5;12;13;140.30000000000001;68.900000000000006;71.400000000000006;36.539999999999999;80;36;186;19;18;66;52;182;29;22;15;223;3009
6;180508;Ferreiros de Avões;254;255;249;241;126;99;112;83;14;16;11.111000000000001;16.161999999999999;9;63;123;3;2;11;14;192.19999999999999;95.900000000000006;96.299999999999997;43.450000000000003;34;33;138;29;20;31;25;140;31;28;20;287;3960
6;182107;Ferreirós do Dão;210;231;174;197;83;59;72;55;11;4;13.253;6.7800000000000002;18;48;61;0;1;11;3;53.200000000000003;25.300000000000001;27.899999999999999;49.710000000000001;22;17;104;34;33;26;24;101;41;39;20;303;4188
6;171210;Fiães;51;60;48;59;14;3;12;1;2;2;14.286;66.667000000000002;4;1;8;0;1;2;1;10.9;5;5.9000000000000004;58.18;2;4;21;10;14;3;4;21;19;13;19;280;3819
6;30816;Figueiredo;201;235;196;232;112;110;94;96;18;14;16.071000000000002;12.727;2;111;77;2;5;16;9;212;97.700000000000003;114.2;37.140000000000001;31;36;114;14;6;45;35;124;16;15;4;55;625
6;182406;Figueiredo das Donas;173;179;163;179;80;60;70;48;10;12;12.5;20;5;38;75;4;0;6;12;81.799999999999997;40.200000000000003;41.600000000000001;48.390000000000001;17;20;85;31;20;19;12;96;29;23;20;306;4254
6;130906;Figueiró;1237;1259;1193;1240;725;619;637;529;88;90;12.138;14.539999999999999;11;665;490;17;14;71;76;875.29999999999995;433.80000000000001;441.5;35.850000000000001;252;169;710;68;38;230;173;727;83;46;15;215;2865
6;90504;Figueiró da Granja;206;208;191;210;110;62;103;49;7;13;6.3639999999999999;20.968;6;62;84;0;3;7;10;35.399999999999999;17.600000000000001;17.800000000000001;46.93;24;25;104;32;21;23;18;90;40;37;10;139;1906
6;110404;Figueiros;333;357;323;346;172;136;151;121;21;15;12.209;11.029;20;93;159;0;3;21;12;134.19999999999999;64.799999999999997;69.5;45.409999999999997;50;28;182;40;33;39;34;182;49;53;12;169;2349
6;91114;Fóios;162;200;159;199;40;26;38;26;2;0;5;0;7;12;45;0;0;2;0;12.800000000000001;5.7000000000000002;7.0999999999999996;62.299999999999997;8;10;68;31;45;6;6;59;51;78;10;145;2056
6;91204;Folhadosa;139;188;124;153;61;54;56;50;5;4;8.1969999999999992;7.407;1;31;74;0;0;5;4;89.299999999999997;37.899999999999999;51.299999999999997;54.799999999999997;8;17;73;20;21;16;9;68;29;66;10;146;2086
6;30909;Fonte Arcada;583;690;535;668;285;270;263;228;22;42;7.7190000000000003;15.556000000000001;8;240;243;3;7;19;35;215.40000000000001;98.700000000000003;116.8;41.43;100;70;328;53;32;88;68;403;61;70;4;60;807
6;30233;Fonte Coberta;288;294;283;296;163;147;141;126;22;21;13.497;14.286;6;138;123;4;8;18;13;283.80000000000001;140.40000000000001;143.40000000000001;38.159999999999997;46;33;176;16;17;52;33;176;21;12;4;54;525
6;11803;Fonte de Angeão;562;617;537;606;279;267;260;236;19;31;6.8100000000000005;11.609999999999999;45;160;291;5;8;14;23;113;53.799999999999997;59.100000000000001;44.380000000000003;75;81;301;45;60;74;64;299;83;97;1;18;191
6;90906;Fonte Longa;54;76;54;76;14;12;14;12;0;0;0;0;12;7;7;0;0;0;0;13;5.4000000000000004;7.5999999999999996;59.850000000000001;2;2;25;12;13;3;4;29;20;20;10;143;2005
6;180107;Fontelo;288;353;273;335;139;97;131;77;8;20;5.7549999999999999;20.619;29;48;131;1;12;7;8;85.200000000000003;38.299999999999997;46.899999999999999;44.07;43;29;151;33;32;51;35;181;48;38;20;283;3895
6;171103;Fontes;388;447;381;435;173;97;160;82;13;15;7.5140000000000002;15.464;95;40;107;2;3;11;12;53.299999999999997;24.800000000000001;28.5;48.619999999999997;53;30;197;58;50;42;43;195;77;90;19;279;3802
6;91115;Forcalhos;44;44;42;44;11;9;11;9;0;0;0;0;0;7;13;0;0;0;0;7.0999999999999996;3.6000000000000001;3.6000000000000001;55.759999999999998;6;4;17;9;8;2;1;16;12;13;10;145;2057
6;160722;Fornelos;768;870;719;847;400;319;362;282;38;37;9.5;11.599;28;305;311;3;10;35;27;153.59999999999999;72;81.599999999999994;40;135;100;414;58;61;129;104;459;86;92;18;265;3520
6;180607;Fornos de Maceira Dão;718;741;683;712;370;284;337;229;33;55;8.9190000000000005;19.366;19;252;295;5;8;28;47;89.799999999999997;44.200000000000003;45.600000000000001;45.689999999999998;92;74;384;85;83;79;79;392;99;92;20;288;3984
6;141505;Foros de Salvaterra;2350;2570;2197;2517;1195;1071;1007;849;188;222;15.731999999999999;20.728000000000002;185;469;1202;22;25;166;197;128;61.100000000000001;66.900000000000006;42.079999999999998;412;239;1290;237;172;397;236;1366;279;292;16;240;3173
6;30362;Fradelos;396;390;369;376;221;203;204;177;17;26;7.6920000000000002;12.808;3;173;205;3;4;14;22;641.39999999999998;323.10000000000002;318.30000000000001;37.509999999999998;66;70;216;27;17;58;49;237;22;24;4;55;626
6;31215;Fradelos;1906;2008;1830;1960;1080;939;979;801;101;138;9.3520000000000003;14.696;88;1040;652;14;20;87;118;232.90000000000001;113.40000000000001;119.5;36.469999999999999;376;268;1070;109;83;370;263;1121;134;120;4;63;882
6;40215;França;104;134;109;140;26;28;22;24;4;4;15.385;14.286;4;15;27;1;2;3;2;4.4000000000000004;1.8999999999999999;2.5;56.700000000000003;8;4;50;22;20;7;15;51;28;33;5;67;1016
6;51101;Fratel;284;324;272;314;76;61;66;59;10;2;13.157999999999999;3.2789999999999999;11;36;78;1;1;9;1;6.2000000000000002;2.8999999999999999;3.2999999999999998;59.420000000000002;19;12;112;53;88;20;19;102;78;105;6;88;1435
6;130907;Frazão;2095;2169;2038;2135;1180;956;1011;798;169;158;14.321999999999999;16.527000000000001;1;994;814;24;32;145;126;768.89999999999998;377.80000000000001;391.10000000000002;38.68;379;276;1179;161;100;361;249;1220;204;135;15;215;2866
6;40716;Frechas;444;485;421;467;200;173;158;138;42;35;21;20.231000000000002;23;86;187;7;5;35;30;50.100000000000001;24;26.199999999999999;48.399999999999999;59;36;231;66;52;45;48;234;81;77;5;72;1144
6;31316;Freiriz;526;573;501;562;267;200;243;178;24;22;8.9890000000000008;11;7;265;149;6;4;18;18;188.09999999999999;90;98.099999999999994;39.32;101;78;271;42;34;95;66;296;48;68;4;64;934
6;90409;Freixeda do Torrão;120;142;114;139;52;29;46;24;6;5;11.538;17.241;16;13;41;0;2;6;3;10.800000000000001;4.9000000000000004;5.9000000000000004;53.799999999999997;10;13;60;20;17;10;10;52;29;41;10;138;1894
6;41005;Freixiel;303;337;294;323;125;74;117;60;8;14;6.4000000000000004;18.919;78;39;60;2;5;6;9;18.399999999999999;8.6999999999999993;9.6999999999999993;53.170000000000002;28;27;153;45;50;19;26;152;56;84;5;75;1215
6;181809;Freixinho;74;66;70;65;31;13;29;12;2;1;6.452;7.6920000000000002;5;17;19;0;1;2;0;22.5;11.9;10.6;48.75;6;14;31;11;12;8;2;34;11;11;20;300;4146
6;180608;Freixiosa;114;143;113;140;33;30;31;21;2;9;6.0609999999999999;30;2;19;31;0;1;2;8;35.100000000000001;15.6;19.5;54.460000000000001;18;5;48;18;25;15;6;49;26;47;20;288;3985
6;130709;Freixo;418;427;384;402;233;203;188;164;45;39;19.312999999999999;19.212;9;169;174;10;12;35;27;184;91;93;37.280000000000001;77;59;242;21;19;65;59;248;18;37;15;213;2827
6;91406;Freixo de Numão;233;269;224;251;98;74;91;66;7;8;7.1429999999999998;10.811;63;14;80;2;1;5;7;18;8.4000000000000004;9.6999999999999993;47.439999999999998;33;14;115;43;28;33;26;126;52;32;10;148;2146
6;130305;Friande;912;926;852;897;522;473;472;410;50;63;9.5790000000000006;13.319000000000001;19;503;360;10;17;40;46;559.20000000000005;277.5;281.69999999999999;35.380000000000003;182;140;517;47;26;188;116;526;54;42;15;209;2737
6;110706;Frielas;1088;1083;1051;1049;601;550;523;492;78;58;12.978;10.545;10;194;811;14;13;64;45;390.19999999999999;195.5;194.59999999999999;38.990000000000002;179;138;636;86;49;179;129;614;88;73;12;172;2420
6;160806;Friestas;250;312;236;299;109;115;94;102;15;13;13.760999999999999;11.304;3;49;144;2;3;13;10;135.5;60.299999999999997;75.200000000000003;44.530000000000001;39;29;124;35;23;40;32;153;39;48;18;266;3555
6;10205;Frossos;434;453;415;433;247;199;227;177;20;22;8.0969999999999995;11.055;8;193;203;4;6;16;16;121.8;59.600000000000001;62.200000000000003;42.270000000000003;53;53;263;35;30;69;32;270;42;40;1;2;25
6;51001;Fundada;311;327;296;316;108;75;93;72;15;3;13.888999999999999;4;7;51;107;0;0;15;3;17.5;8.5;9;57.740000000000002;29;21;129;54;78;23;13;108;62;121;6;87;1432
6;11003;Gafanha da Nazaré;7088;7668;6548;7386;3839;3690;3407;3207;432;483;11.253;13.089;308;1893;4413;67;68;365;415;1011.3;485.80000000000001;525.60000000000002;39.780000000000001;1202;799;4143;565;379;1136;833;4440;671;588;1;9;100
6;70205;Gafanhoeira (São Pedro);234;260;222;250;127;102;120;88;7;14;5.5120000000000005;13.725;43;52;113;1;3;6;11;10.699999999999999;5.0999999999999996;5.5999999999999996;48.689999999999998;26;22;129;17;40;20;28;130;38;44;8;107;1655
6;120604;Gáfete;407;449;397;446;185;181;151;155;34;26;18.378;14.365;7;140;159;4;3;30;23;18.600000000000001;8.8000000000000007;9.6999999999999993;52.649999999999999;32;22;226;64;63;32;28;227;75;87;14;197;2612
6;90719;Gagos;64;63;61;63;26;13;23;10;3;3;11.538;23.077000000000002;3;18;12;0;1;3;2;12.5;6.2999999999999998;6.2000000000000002;53.25;4;6;35;7;12;6;1;28;12;16;10;141;1959
6;170803;Galafura;308;356;285;335;148;112;145;108;3;4;2.0270000000000001;3.5709999999999997;136;47;70;1;3;2;1;58;26.899999999999999;31.100000000000001;41.310000000000002;54;38;167;23;26;61;41;181;40;33;19;276;3769
6;151207;Gâmbia-Pontes-Alto da Guerra;2954;2931;2828;2894;1567;1402;1390;1239;177;163;11.295;11.625999999999999;96;686;1847;34;21;143;142;178.5;89.599999999999994;88.900000000000006;38.969999999999999;584;299;1689;239;143;532;243;1678;237;241;17;257;3321
6;141628;Gançaria;247;267;239;259;120;120;111;111;9;9;7.5;7.5;18;82;122;1;0;8;9;92;44.200000000000003;47.799999999999997;48.600000000000001;27;21;131;41;27;23;18;138;39;49;16;241;3190
6;60706;Gândaras;640;668;615;647;311;264;274;225;37;39;11.897;14.773;25;187;287;8;7;29;32;130.30000000000001;63.700000000000003;66.5;43.039999999999999;93;66;362;65;54;99;70;339;79;81;7;95;1542
6;160807;Gandra;595;723;575;702;305;297;267;260;38;37;12.459;12.458;19;172;336;4;6;34;31;111.90000000000001;50.5;61.399999999999999;42.659999999999997;82;62;344;66;41;106;73;386;79;79;18;266;3556
6;131011;Gandra;3448;3526;3379;3634;1974;1595;1742;1322;232;273;11.753;17.116;22;1327;1715;32;48;200;225;593.29999999999995;293.30000000000001;300;35.43;683;474;2021;181;89;648;443;2056;218;161;15;216;2886
6;130116;Gatão;795;791;748;769;421;365;389;314;32;51;7.601;13.973000000000001;23;283;397;9;13;23;38;264.89999999999998;132.80000000000001;132.09999999999999;39.25;134;119;435;64;43;121;75;473;63;59;15;207;2691
6;31216;Gavião;1764;1983;1664;1924;911;912;803;778;108;134;11.855;14.693;13;621;947;13;26;95;108;927.29999999999995;436.5;490.69999999999999;42.229999999999997;281;206;1006;171;100;260;182;1120;217;204;4;63;883
6;160113;Gavieira;128;170;122;168;46;34;42;33;4;1;8.6959999999999997;2.9409999999999998;39;8;28;1;0;3;1;5.2000000000000002;2.2000000000000002;3;57.590000000000003;12;5;59;29;23;8;7;70;38;47;18;259;3345
6;31317;Geme;258;293;249;296;129;109;123;92;6;17;4.6509999999999998;15.596;7;56;152;0;7;6;10;345.10000000000002;161.59999999999999;183.5;39.520000000000003;45;30;143;22;18;58;35;142;28;30;4;64;935
6;40605;Genísio;94;92;92;87;30;18;27;11;3;7;10;38.889000000000003;10;15;13;1;4;2;3;6.2999999999999998;3.2000000000000002;3.1000000000000001;58.469999999999999;8;2;42;22;20;3;2;36;25;26;5;71;1117
6;40216;Gimonde;158;183;168;183;87;68;79;62;8;6;9.1950000000000003;8.8239999999999998;3;34;104;4;3;4;3;20.699999999999999;9.5999999999999996;11.1;47.329999999999998;11;13;99;20;15;24;16;89;25;29;5;67;1017
6;31320;Gomide;116;112;113;110;50;43;40;33;10;10;20;23.256;9;20;44;2;3;8;7;69.700000000000003;35.5;34.200000000000003;43.630000000000003;19;10;65;12;10;14;10;60;14;14;4;64;938
6;90720;Gonçalo;518;565;510;552;225;205;189;168;36;37;16;18.048999999999999;12;135;210;2;1;34;36;72.700000000000003;34.799999999999997;37.899999999999999;50.920000000000002;52;38;259;90;79;43;45;271;86;120;10;141;1961
6;131012;Gondalães;600;628;586;620;344;286;298;239;46;47;13.372;16.434000000000001;18;259;260;4;13;42;34;604.79999999999995;295.5;309.30000000000001;34.520000000000003;126;96;328;34;16;123;89;357;35;24;15;216;2887
6;130117;Gondar;830;856;769;825;447;311;406;259;41;52;9.1720000000000006;16.719999999999999;12;250;403;8;11;33;41;174.90000000000001;86.099999999999994;88.799999999999997;40.219999999999999;132;105;473;71;49;142;96;458;77;83;15;207;2692
6;31321;Gondiães;164;183;157;180;77;77;66;66;11;11;14.286;14.286;14;36;82;3;3;8;8;110.5;52.200000000000003;58.299999999999997;39.289999999999999;30;22;86;10;16;28;21;101;13;20;4;64;939
6;31217;Gondifelos;1160;1278;1111;1265;649;581;571;471;78;110;12.018000000000001;18.933;48;509;485;6;17;72;93;307.5;146.30000000000001;161.19999999999999;36.670000000000002;216;146;685;63;50;250;157;706;91;74;4;63;884
6;130605;Gondim;1062;1146;1036;1134;574;538;496;428;78;110;13.589;20.446000000000002;7;357;560;11;20;67;90;1585.7;762.70000000000005;823;38.289999999999999;208;128;608;80;38;185;143;662;82;74;15;212;2808
6;130409;Gondomar (São Cosme);13068;13979;12479;13617;7110;6711;6085;5714;1025;997;14.416;14.856;78;2553;9168;182;185;843;812;2298.5999999999999;1110.5999999999999;1188;40.119999999999997;2217;1515;7592;1101;643;2020;1459;8303;1187;1010;15;210;2769
6;30715;Gontim;42;47;42;45;9;5;9;3;0;2;0;40;4;5;3;0;1;0;1;27.300000000000001;12.9;14.4;53.210000000000001;4;3;20;5;10;4;3;20;11;9;4;59;779
6;180309;Gosende;200;226;195;228;65;27;65;27;0;0;0;0;23;27;42;0;0;0;0;20.800000000000001;9.8000000000000007;11.1;50.200000000000003;17;23;101;25;34;27;18;91;37;53;20;285;3923
6;90618;Gouveia (São Pedro);834;1016;781;970;355;399;303;326;52;73;14.648;18.295999999999999;18;92;519;9;13;43;60;67.200000000000003;30.300000000000001;36.899999999999999;49.049999999999997;93;75;442;111;113;100;84;506;144;182;10;140;1926
6;182002;Gouviães;199;215;163;192;88;73;75;63;13;10;14.773;13.699;23;27;88;1;4;12;6;116.7;56.100000000000001;60.600000000000001;45.350000000000001;28;27;102;23;19;25;26;103;24;37;20;302;4173
6;101301;Graça;381;405;373;398;116;102;101;80;15;22;12.931000000000001;21.568999999999999;10;50;121;3;4;12;18;25;12.1;12.9;52.68;46;36;157;69;73;31;21;168;94;91;11;161;2267
6;110616;Graça;2613;3174;2514;3092;1287;1346;1083;1176;204;170;15.850999999999999;12.630000000000001;3;224;2032;25;29;179;141;16507.900000000001;7453.8000000000002;9054.1000000000004;47.130000000000003;330;242;1443;316;282;289;244;1576;428;637;12;171;2377
6;170212;Granja;117;113;113;111;52;40;52;36;0;4;0;10;4;24;60;0;2;0;2;26.300000000000001;13.4;12.9;48.590000000000003;11;12;66;17;11;8;7;61;25;12;19;270;3651
6;91309;Granja;75;76;68;73;35;23;34;19;1;4;2.8570000000000002;17.390999999999998;12;20;21;0;2;1;2;16.300000000000001;8.0999999999999996;8.1999999999999993;49.909999999999997;7;12;36;5;15;7;8;31;9;21;10;147;2120
6;61506;Granja do Ulmeiro;866;1000;800;964;443;452;406;398;37;54;8.3520000000000003;11.946999999999999;6;150;648;5;15;32;39;369.39999999999998;171.40000000000001;197.90000000000001;42.710000000000001;130;88;485;80;83;142;98;524;106;130;7;103;1622
6;181907;Granjinha;27;30;27;30;8;8;7;8;1;0;12.5;0;1;1;13;0;0;1;0;22;10.4;11.6;55.509999999999998;2;1;12;5;7;3;1;13;5;8;20;301;4161
6;30239;Grimancelos;360;431;352;422;188;165;175;133;13;32;6.915;19.393999999999998;15;178;115;4;6;9;26;261.10000000000002;118.8;142.30000000000001;39.960000000000001;65;43;199;36;17;64;55;233;42;37;4;54;533
6;30319;Gualtar;2564;2722;2473;2747;1367;1358;1241;1199;126;159;9.2170000000000005;11.708;12;572;1856;31;30;95;129;1932.2;937.20000000000005;995;38.020000000000003;437;325;1482;189;131;414;339;1620;194;155;4;55;636
6;90741;Guarda (São Vicente);5444;6235;5007;5850;2947;3175;2609;2757;338;418;11.468999999999999;13.164999999999999;61;802;4503;59;78;279;340;988.5;460.80000000000001;527.70000000000005;39.909999999999997;903;590;3230;443;278;930;623;3698;516;468;10;141;1962
6;182108;Guardão;706;784;702;790;303;294;277;275;26;19;8.5809999999999995;6.4630000000000001;68;147;337;2;3;24;16;78.599999999999994;37.299999999999997;41.399999999999999;50.329999999999998;65;73;372;108;88;74;69;350;122;169;20;303;4189
6;130606;Gueifães;5712;6252;5439;6077;3081;2980;2676;2551;405;429;13.145;14.396000000000001;10;1281;3936;71;73;334;356;4175.1000000000004;1993.3;2181.8000000000002;41.020000000000003;885;641;3352;502;332;871;634;3716;560;471;15;212;2809
6;80102;Guia;2148;2228;2439;2452;1208;1135;1049;968;159;167;13.162000000000001;14.714;35;258;1724;23;23;136;144;163.30000000000001;80.200000000000003;83.099999999999994;41.149999999999999;320;228;1243;188;169;318;230;1286;169;225;9;120;1741
6;130802;Guifões;4552;4943;4370;4855;2337;2083;1906;1688;431;395;18.442;18.963000000000001;34;835;2725;55;61;376;334;2574.8000000000002;1234.4000000000001;1340.4000000000001;42.68;639;550;2635;487;241;607;533;2837;532;434;15;214;2851
6;131611;Guilhabreu;1154;1203;1091;1182;685;589;582;468;103;121;15.036;20.542999999999999;48;512;490;10;21;93;100;364.89999999999998;178.69999999999999;186.30000000000001;40.049999999999997;169;149;675;109;52;174;146;687;108;88;15;223;3012
6;91310;Guilheiro;91;93;91;93;44;27;44;24;0;3;0;11.111000000000001;7;22;39;0;2;0;1;13.5;6.7000000000000002;6.7999999999999998;47.490000000000002;14;7;47;8;15;8;9;44;16;16;10;147;2121
6;30860;Guimarães (São Paio);1325;1571;1303;1565;656;640;522;514;134;126;20.427;19.687999999999999;3;307;726;26;22;108;104;6373.8000000000002;2916.1999999999998;3457.5999999999999;47.240000000000002;119;162;780;139;125;118;140;890;216;207;4;55;639
6;11004;Ílhavo (São Salvador);7791;8806;7357;8503;4025;3990;3575;3508;450;482;11.18;12.08;175;2199;4709;76;73;374;409;393.60000000000002;184.69999999999999;208.80000000000001;42.240000000000002;1219;875;4405;771;521;1209;877;4864;957;899;1;9;102
6;30824;Infantas;869;895;837;862;488;480;415;417;73;63;14.959;13.125;3;559;270;9;13;64;50;271.60000000000002;133.80000000000001;137.80000000000001;36.920000000000002;153;129;497;53;37;135;132;512;65;51;4;55;642
6;181105;Ínsua;968;1077;904;1040;470;431;437;359;33;72;7.0209999999999999;16.704999999999998;31;224;541;3;10;30;62;216.69999999999999;102.59999999999999;114.09999999999999;44.829999999999998;147;104;501;108;108;132;102;535;136;172;20;293;4051
6;40220;Izeda;614;392;608;380;117;90;110;81;7;9;5.9829999999999997;10;17;39;135;4;6;3;3;29.5;18;11.5;47.200000000000003;38;54;406;66;50;46;34;173;60;79;5;67;1021
6;90722;João Antão;78;82;75;77;34;21;31;18;3;3;8.8239999999999998;14.286;1;25;23;0;0;3;3;18.199999999999999;8.9000000000000004;9.3000000000000007;51.289999999999999;5;9;37;7;20;7;8;35;10;22;10;141;1966
6;160119;Jolda (Madalena);172;178;165;173;72;47;68;41;4;6;5.556;12.766;13;41;55;1;3;3;3;140.09999999999999;68.799999999999997;71.200000000000003;45.549999999999997;23;24;93;16;16;19;15;89;27;28;18;259;3350
6;160142;Jolda (São Paio);165;195;151;193;81;65;74;54;7;11;8.6419999999999995;16.923000000000002;3;63;62;1;6;6;5;211.80000000000001;97.099999999999994;114.7;40.75;24;18;95;19;9;38;24;95;24;14;18;259;3351
6;90508;Juncais;137;147;132;140;62;45;53;39;9;6;14.516;13.333;1;21;70;4;3;5;3;31.399999999999999;15.199999999999999;16.300000000000001;48.810000000000002;18;8;74;16;21;16;11;69;21;30;10;139;1910
6;50210;Juncal do Campo;158;197;147;191;70;52;61;49;9;3;12.856999999999999;5.7690000000000001;2;50;58;0;1;9;2;16;7.0999999999999996;8.9000000000000004;55.32;8;9;85;30;26;8;12;87;39;51;6;79;1293
6;141806;Junceira;422;467;418;461;172;150;149;135;23;15;13.372;10;4;68;212;5;7;18;8;68.099999999999994;32.299999999999997;35.799999999999997;45.149999999999999;70;50;204;48;50;63;40;207;64;93;16;243;3217
6;130308;Lagares;1133;1187;1105;1164;647;595;591;554;56;41;8.6549999999999994;6.891;11;866;268;4;8;52;33;815.5;398.30000000000001;417.19999999999999;38.609999999999999;207;166;626;86;48;162;176;664;111;74;15;209;2740
6;131116;Lagares;1214;1243;1159;1223;662;455;595;383;67;72;10.121;15.824;15;476;487;6;17;61;55;225.30000000000001;111.3;114;37.32;231;183;675;67;58;210;176;671;97;89;15;217;2915
6;61106;Lagares;648;750;617;723;312;301;286;259;26;42;8.3330000000000002;13.952999999999999;19;284;242;4;8;22;34;106;49.100000000000001;56.899999999999999;44.689999999999998;93;82;339;63;71;88;81;374;84;123;7;99;1574
6;90607;Lagarinhos;204;239;199;228;94;82;82;66;12;16;12.766;19.512;26;39;83;1;2;11;14;41;18.899999999999999;22.100000000000001;47.189999999999998;27;21;106;26;24;25;27;112;28;47;10;140;1927
6;100305;Lagarteira;228;276;216;272;120;87;112;77;8;10;6.6669999999999998;11.494;3;104;82;3;2;5;8;67;30.300000000000001;36.700000000000003;44.960000000000001;31;25;129;25;18;37;32;131;29;47;11;151;2187
6;30113;Lago;927;983;878;958;488;416;436;357;52;59;10.656000000000001;14.183;11;325;457;9;14;43;45;478.69999999999999;232.30000000000001;246.40000000000001;37.850000000000001;176;140;511;61;39;155;141;555;71;61;4;53;479
6;31220;Lagoa;440;471;418;458;240;216;208;176;32;40;13.333;18.518999999999998;1;207;176;2;5;30;35;486.60000000000002;235;251.59999999999999;38.439999999999998;76;51;263;30;20;88;51;272;32;28;4;63;887
6;80705;Lagos (Santa Maria);3817;4229;3801;4223;1992;1984;1714;1722;278;262;13.956;13.206;28;502;2906;36;38;242;224;860.89999999999998;408.39999999999998;452.5;41.700000000000003;650;418;2117;349;283;620;437;2337;371;464;9;126;1780
6;131411;Lama;655;738;624;725;332;334;281;272;51;62;15.361000000000001;18.562999999999999;4;239;310;4;8;47;54;669.79999999999995;314.89999999999998;354.89999999999998;43.829999999999998;74;70;381;85;45;91;78;403;90;76;15;220;2975
6;30322;Lamas;419;423;403;416;230;202;214;171;16;31;6.9569999999999999;15.347;7;185;193;3;6;13;25;671.70000000000005;334.30000000000001;337.5;35.75;82;66;238;21;12;79;51;249;22;22;4;55;644
6;40518;Lamas;139;139;136;137;59;39;59;38;0;1;0;2.5640000000000001;16;25;56;0;0;0;1;35.700000000000003;17.800000000000001;17.800000000000001;49.119999999999997;11;19;74;20;15;11;9;70;30;19;5;70;1091
6;180501;Lamego (Almacave);4133;4617;3853;4439;2139;2173;1901;1857;238;316;11.127000000000001;14.542;65;547;3146;61;81;177;235;847;400.10000000000002;446.89999999999998;40.890000000000001;657;531;2365;347;233;657;496;2616;411;437;20;287;3963
6;180521;Lamego (Sé);1628;1836;1605;1814;827;798;743;673;84;125;10.157;15.664;53;215;1148;19;31;65;94;351.10000000000002;165;186.09999999999999;41.740000000000002;279;180;895;147;127;264;157;990;207;218;20;287;3964
6;130909;Lamoso;804;809;790;801;458;381;384;331;74;50;16.157;13.122999999999999;2;543;170;15;5;59;45;748.20000000000005;372.89999999999998;375.19999999999999;35.549999999999997;170;104;455;43;32;162;104;459;49;35;15;215;2868
6;31221;Landim;1403;1431;1348;1402;753;650;606;510;147;140;19.521999999999998;21.538;16;584;516;25;19;122;121;628.39999999999998;311.10000000000002;317.30000000000001;40.780000000000001;213;181;811;120;78;179;158;850;125;119;4;63;888
6;140603;Lapa;576;624;550;608;282;230;244;203;38;27;13.475;11.739000000000001;24;122;301;4;5;34;22;190.19999999999999;91.299999999999997;98.900000000000006;46.25;66;64;311;80;55;73;48;332;78;93;16;230;3096
6;160409;Lapela;99;124;94;117;43;23;40;22;3;1;6.9770000000000003;4.3479999999999999;0;20;42;0;0;3;1;141;62.600000000000001;78.400000000000006;52.969999999999999;4;7;59;16;13;9;9;56;24;26;18;262;3429
6;60506;Lavos;1882;2117;1674;2028;913;744;818;639;95;105;10.404999999999999;14.113;94;560;803;20;15;75;90;113.59999999999999;53.5;60.100000000000001;46.359999999999999;233;187;1042;214;206;263;185;1055;277;337;7;93;1524
6;130803;Lavra;4861;5172;4575;4979;2719;2501;2350;2125;369;376;13.571;15.034000000000001;115;1226;3134;51;71;318;305;970.89999999999998;470.39999999999998;500.5;40.57;760;497;2939;415;250;755;447;3112;458;400;15;214;2852
6;100912;Leiria;6828;8081;7231;8623;3790;4026;3351;3595;439;431;11.583;10.705;41;1338;5567;90;92;349;339;2303.6999999999998;1055;1248.5999999999999;41.210000000000001;1004;937;3826;592;469;992;843;4589;793;864;11;157;2238
6;40404;Ligares;183;214;178;209;56;38;52;32;4;6;7.1429999999999998;15.789;28;17;39;2;1;2;5;8.6999999999999993;4;4.7000000000000002;56.439999999999998;13;18;88;25;39;11;18;75;46;64;5;69;1071
6;170904;Limões;164;171;171;172;70;35;65;27;5;8;7.1429999999999998;22.856999999999999;40;19;33;1;1;4;7;18.800000000000001;9.1999999999999993;9.5999999999999996;48.560000000000002;21;16;84;21;22;23;11;70;25;42;19;277;3781
6;160512;Linhares;97;101;96;101;44;40;42;34;2;6;4.5449999999999999;15;5;39;32;0;0;2;6;42.299999999999997;20.699999999999999;21.600000000000001;44.770000000000003;15;10;51;9;12;10;11;57;11;12;18;263;3464
6;90308;Linhares;114;145;119;142;47;46;42;39;5;7;10.638;15.217000000000001;16;27;38;2;2;3;5;16.5;7.2999999999999998;9.1999999999999993;49.909999999999997;14;14;54;14;18;12;18;51;31;33;10;137;1874
6;171109;Lobrigos (São Miguel);647;718;615;697;338;296;293;250;45;46;13.314;15.541;116;84;343;11;4;34;42;297.60000000000002;141.09999999999999;156.59999999999999;40.75;105;83;368;56;35;109;74;393;63;79;19;279;3805
6;41006;Lodões;57;43;54;42;18;7;18;7;0;0;0;0;9;5;11;0;0;0;0;9.1999999999999993;5.2000000000000002;4;52.5;5;5;27;9;11;4;2;18;11;8;5;75;1216
6;130209;Loivos da Ribeira;230;250;223;245;95;56;82;42;13;14;13.683999999999999;25;11;47;66;0;3;13;11;189.90000000000001;91;98.900000000000006;41.079999999999998;39;29;125;15;22;38;38;120;27;27;15;208;2720
6;130119;Lomba;369;424;363;415;155;129;148;118;7;11;4.516;8.5269999999999992;4;73;189;1;6;6;5;218.5;101.7;116.8;41.009999999999998;62;49;200;33;25;50;62;230;42;40;15;207;2695
6;121305;Longomel;603;625;573;608;286;222;202;147;84;75;29.370999999999999;33.783999999999999;79;80;190;4;5;80;70;26.100000000000001;12.800000000000001;13.300000000000001;48.090000000000003;54;78;311;71;89;70;63;278;90;124;14;204;2654
6;160411;Longos Vales;451;538;426;525;196;150;178;134;18;16;9.1839999999999993;10.667;29;126;157;1;5;17;11;70.700000000000003;32.200000000000003;38.399999999999999;48.460000000000001;45;59;227;69;51;48;48;270;83;89;18;262;3431
6;90907;Longroiva;124;162;123;163;37;34;35;27;2;7;5.4050000000000002;20.588000000000001;17;8;37;0;2;2;5;6.9000000000000004;3;3.8999999999999999;58.409999999999997;4;9;49;32;30;11;7;60;44;40;10;143;2006
6;80808;Loulé (São Clemente);8293;9065;7896;8650;4559;4472;3942;3918;617;554;13.534000000000001;12.388;43;1364;6453;92;88;525;466;375.80000000000001;179.5;196.19999999999999;41.07;1346;957;4665;729;596;1291;862;5088;828;996;9;127;1789
6;80809;Loulé (São Sebastião);3656;3777;3515;3640;1828;1584;1610;1366;218;218;11.926;13.763;43;563;2370;42;52;176;166;118.59999999999999;58.299999999999997;60.200000000000003;42.93;549;410;1977;401;319;533;361;2034;405;444;9;127;1790
6;31109;Louredo;224;212;222;211;78;43;71;35;7;8;8.9740000000000002;18.605;3;43;60;0;1;7;7;57.299999999999997;29.399999999999999;27.800000000000001;45.240000000000002;32;25;113;35;19;27;15;107;36;27;4;62;853
6;170805;Loureiro;555;599;506;561;279;226;228;180;51;46;18.280000000000001;20.353999999999999;59;117;232;7;11;44;35;237.5;114.2;123.3;46.100000000000001;61;66;317;61;50;55;64;322;72;86;19;276;3771
6;61109;Lourosa;268;287;262;285;117;80;97;62;20;18;17.094000000000001;22.5;13;83;63;3;3;17;15;39.799999999999997;19.199999999999999;20.600000000000001;45.850000000000001;39;18;149;36;26;42;30;126;44;45;7;99;1577
6;40911;Lousa;161;197;153;188;55;30;54;29;1;1;1.8180000000000001;3.3330000000000002;41;7;35;0;1;1;0;10.6;4.7000000000000002;5.7999999999999998;59.520000000000003;8;10;72;32;39;6;11;69;60;51;5;74;1204
6;50213;Lousa;304;317;295;317;120;81;102;68;18;13;15;16.048999999999999;16;75;79;2;3;16;10;17.300000000000001;8.5;8.9000000000000004;55.520000000000003;17;21;145;51;70;16;21;130;63;87;6;79;1296
6;80703;Luz;1731;1814;1860;1949;825;751;691;626;134;125;16.242000000000001;16.643999999999998;20;249;1048;18;20;116;105;162.69999999999999;79.5;83.299999999999997;44.909999999999997;249;178;918;218;168;232;178;969;246;189;9;126;1782
6;90309;Maçal do Chão;81;79;83;80;43;35;40;32;3;3;6.9770000000000003;8.5709999999999997;34;11;27;0;1;3;2;10.6;5.4000000000000004;5.2000000000000002;45.109999999999999;18;7;39;7;10;9;4;36;13;17;10;137;1875
6;11504;Maceda;1727;1794;1687;1769;912;822;785;666;127;156;13.925000000000001;18.978000000000002;9;689;753;21;31;106;125;219;107.40000000000001;111.59999999999999;41.07;279;247;942;157;102;238;205;1042;163;146;1;14;143
6;40221;Macedo do Mato;104;104;102;104;23;12;22;11;1;1;4.3479999999999999;8.3330000000000002;13;8;12;0;1;1;0;13.4;6.7000000000000002;6.7000000000000002;61.859999999999999;3;5;39;24;33;3;3;37;28;33;5;67;1022
6;111320;Maceira;951;981;958;1016;517;435;443;363;74;72;14.313000000000001;16.552;83;198;525;5;4;69;68;230.30000000000001;113.40000000000001;117;41.859999999999999;128;85;577;103;58;139;102;563;104;73;12;179;2506
6;10111;Macieira de Alcoba;38;46;38;44;8;10;7;10;1;0;12.5;0;7;3;7;1;0;0;0;10.9;4.9000000000000004;6;63.079999999999998;3;1;10;14;10;;1;17;14;14;1;1;12
6;11306;Macinhata da Seixa;697;693;660;664;379;324;361;285;18;39;4.7489999999999997;12.037000000000001;16;318;312;2;13;16;26;406.80000000000001;204;202.80000000000001;41.200000000000003;113;78;403;61;42;84;93;390;70;56;1;12;119
6;130122;Madalena;894;1062;884;1078;449;472;402;400;47;72;10.468;15.254;5;181;616;8;8;39;64;1255.5;573.89999999999998;681.70000000000005;38.909999999999997;153;103;522;62;54;176;140;588;80;78;15;207;2698
6;130710;Magrelos;399;401;328;394;206;97;173;73;33;24;16.018999999999998;24.742000000000001;7;166;73;4;5;29;19;307.69999999999999;153.40000000000001;154.19999999999999;39.259999999999998;61;70;214;33;21;63;58;210;36;34;15;213;2828
6;170316;Mairos;154;190;149;189;65;48;52;36;13;12;20;25;25;12;51;5;8;8;4;29.5;13.199999999999999;16.300000000000001;51.259999999999998;18;20;76;23;17;10;19;84;29;48;19;271;3671
6;140205;Malhou;388;385;381;379;189;145;173;135;16;10;8.4659999999999993;6.8970000000000002;9;105;194;1;2;15;8;65.799999999999997;33;32.799999999999997;45.539999999999999;59;36;199;53;41;50;25;190;59;61;16;226;3079
6;50214;Malpica do Tejo;242;275;246;280;64;53;60;50;4;3;6.25;5.6600000000000001;35;20;55;0;0;4;3;2.1000000000000001;1;1.1000000000000001;59.57;13;17;95;40;77;15;16;75;68;101;6;79;1297
6;90803;Manteigas (São Pedro);670;776;754;883;280;207;245;177;35;30;12.5;14.493;13;112;297;4;2;31;28;23.800000000000001;11;12.800000000000001;49.689999999999998;61;68;357;98;86;82;71;356;114;153;10;142;1997
6;181107;Mareco;45;61;44;60;16;10;15;7;1;3;6.25;30;4;9;9;0;0;1;3;29.399999999999999;12.5;16.899999999999999;58.899999999999999;1;3;18;12;11;5;4;18;15;19;20;293;4053
6;141502;Marinhais;3072;3264;2890;3181;1513;1317;1298;1090;215;227;14.210000000000001;17.236000000000001;113;614;1661;17;19;198;208;167.30000000000001;81.099999999999994;86.200000000000003;42.700000000000003;502;339;1650;322;259;489;297;1703;381;394;16;240;3176
6;30612;Marinhas;2959;3234;2738;3108;1624;1468;1487;1263;137;205;8.4359999999999999;13.965;42;1141;1567;28;40;109;165;593.89999999999998;283.80000000000001;310.10000000000002;38.240000000000002;534;380;1691;229;125;517;416;1834;252;215;4;58;759
6;100118;Martingança;557;588;535;563;274;262;250;221;24;41;8.7590000000000003;15.649000000000001;4;252;215;5;10;19;31;141.40000000000001;68.799999999999997;72.599999999999994;42.109999999999999;87;68;309;57;36;85;52;321;75;55;11;149;2169
6;111116;Massamá;13374;14738;12525;14098;7477;7999;6567;6994;910;1005;12.170999999999999;12.564;18;1894;11649;223;235;687;770;15373.200000000001;7313.6000000000004;8059.6000000000004;38.100000000000001;2359;1892;7784;932;407;2257;1783;9085;948;665;12;177;2484
6;131207;Massarelos;3088;3701;3523;4175;1610;1677;1366;1437;244;240;15.154999999999999;14.311;4;354;2445;44;49;200;191;3490.6999999999998;1587.8;1903;45.859999999999999;387;330;1757;316;298;315;341;2023;461;561;15;218;2944
6;41108;Matela;110;118;112;120;24;12;23;11;1;1;4.1669999999999998;8.3330000000000002;15;4;15;0;1;1;0;5.0999999999999996;2.5;2.7000000000000002;59.829999999999998;7;7;46;29;21;6;3;44;33;32;5;76;1237
6;130712;Maureles;232;228;218;223;111;55;97;50;14;5;12.613;9.0909999999999993;5;96;46;3;2;11;3;143.5;72.400000000000006;71.099999999999994;33.68;66;28;117;14;7;52;29;116;14;17;15;213;2830
6;111308;Maxial;1315;1436;1230;1403;658;495;579;444;79;51;12.006;10.303000000000001;76;413;534;11;6;68;45;94.099999999999994;45;49.100000000000001;45.140000000000001;188;132;693;171;131;207;115;730;175;209;12;179;2508
6;160916;Mazarefes;651;692;616;679;332;282;303;239;29;43;8.7349999999999994;15.247999999999999;8;218;316;4;8;25;35;331.10000000000002;160.5;170.59999999999999;43.729999999999997;89;72;378;61;51;77;64;400;79;72;18;267;3583
6;160414;Mazedo;868;991;815;949;438;429;392;397;46;32;10.502000000000001;7.4589999999999996;23;224;542;8;10;38;22;245.80000000000001;114.8;131;40.579999999999998;141;100;498;78;51;137;106;556;106;86;18;262;3434
6;40405;Mazouco;77;90;77;88;9;6;5;4;4;2;44.444000000000003;33.332999999999998;1;3;5;2;2;2;0;8.9000000000000004;4.0999999999999996;4.7999999999999998;64.280000000000001;1;1;25;26;24;1;4;30;27;28;5;69;1072
6;61006;Meãs do Campo;889;964;837;941;476;413;424;348;52;65;10.923999999999999;15.738;103;194;475;4;13;48;52;190.19999999999999;91.200000000000003;98.900000000000006;42.119999999999997;138;101;482;96;72;134;94;518;94;124;7;98;1561
6;110107;Meca;847;872;808;854;469;362;433;308;36;54;7.6760000000000002;14.917;18;252;471;3;5;33;49;121.7;60;61.700000000000003;43.460000000000001;123;86;471;102;65;118;80;478;101;95;12;165;2315
6;90909;Meda;949;1038;909;997;466;422;429;362;37;60;7.9399999999999995;14.218;55;165;571;7;12;30;48;73.099999999999994;34.899999999999999;38.200000000000003;44.640000000000001;133;102;516;95;103;133;92;552;103;158;10;143;2008
6;130513;Meinedo;1936;2116;1804;2062;1030;893;913;751;117;142;11.359;15.901;12;776;876;16;27;101;115;435.19999999999999;207.90000000000001;227.30000000000001;39.200000000000003;327;260;1102;140;107;323;291;1172;168;162;15;211;2792
6;90725;Meios;101;96;101;94;50;33;43;24;7;9;14;27.273;3;36;28;0;0;7;9;40.799999999999997;20.899999999999999;19.899999999999999;45.960000000000001;12;17;54;9;9;12;8;44;12;20;10;141;1969
6;101515;Meirinhas;870;905;820;867;462;392;436;358;26;34;5.6280000000000001;8.673;16;302;476;8;10;18;24;184.19999999999999;90.299999999999997;93.900000000000006;41.009999999999998;150;111;449;90;70;133;102;478;111;81;11;163;2285
6;170614;Meixide;47;41;42;38;16;3;14;2;2;1;12.5;33.332999999999998;4;7;5;2;0;0;1;7.7000000000000002;4.0999999999999996;3.6000000000000001;58.420000000000002;1;6;21;9;10;;3;12;13;13;19;274;3735
6;130910;Meixomil;1808;1868;1764;1841;1042;861;886;749;156;112;14.971;13.007999999999999;10;843;782;23;26;133;86;839.79999999999995;413;426.69999999999999;37.5;326;247;1034;135;66;339;215;1076;129;109;15;215;2869
6;180514;Melcões;59;66;59;66;25;17;19;14;6;3;24;17.646999999999998;7;13;13;1;1;5;2;48.899999999999999;23.100000000000001;25.800000000000001;49.950000000000003;5;7;29;10;8;5;4;31;11;15;20;287;3968
6;150503;Melides;825;833;846;856;388;289;343;264;45;25;11.598000000000001;8.6509999999999998;54;140;413;2;2;43;23;10.699999999999999;5.2999999999999998;5.4000000000000004;49.840000000000003;90;55;435;130;115;73;61;394;171;134;17;250;3280
6;161009;Mentrestido;123;141;119;138;48;52;45;50;3;2;6.25;3.8460000000000001;5;49;41;0;0;3;2;56.100000000000001;26.199999999999999;30;47.299999999999997;19;14;58;20;12;10;12;67;27;25;18;268;3614
6;30347;Merelim (São Pedro);947;973;909;956;517;464;463;397;54;67;10.445;14.44;16;247;597;8;12;46;55;1037.7;511.80000000000001;525.89999999999998;39.210000000000001;163;125;537;72;50;141;128;545;79;80;4;55;651
6;90215;Mesquitela;22;23;22;24;6;2;6;1;0;1;0;50;3;1;3;0;0;0;1;9.5999999999999996;4.7000000000000002;4.9000000000000004;52.469999999999999;3;1;12;3;3;3;1;10;6;3;10;136;1849
6;81102;Mexilhoeira Grande;2000;2029;1949;1997;968;821;815;709;153;112;15.806000000000001;13.641999999999999;65;291;1168;20;18;133;94;44.200000000000003;21.899999999999999;22.300000000000001;45.719999999999999;275;186;1061;241;237;257;167;1069;240;296;9;130;1803
6;40223;Milhão;76;85;71;81;32;21;31;17;1;4;3.125;19.047999999999998;13;9;26;0;2;1;2;5.5;2.6000000000000001;2.8999999999999999;52.439999999999998;4;7;37;10;18;8;8;36;18;15;5;67;1024
6;140206;Minde;1551;1742;1463;1676;814;769;721;667;93;102;11.425000000000001;13.263999999999999;3;539;846;14;20;79;82;155.69999999999999;73.400000000000006;82.400000000000006;44.090000000000003;238;162;842;161;148;236;176;892;199;239;16;226;3080
6;90311;Minhocal;82;93;75;92;37;28;33;24;4;4;10.811;14.286;13;23;21;0;1;4;3;16.300000000000001;7.5999999999999996;8.6999999999999993;50.469999999999999;7;9;42;9;15;6;13;42;14;18;10;137;1877
6;181307;Miomães;174;185;153;188;79;52;69;38;10;14;12.657999999999999;26.923000000000002;12;44;51;1;4;9;10;126.3;61.200000000000003;65.099999999999994;42.159999999999997;30;17;91;21;15;26;24;92;23;20;20;295;4075
6;110802;Miragaia;905;917;853;891;455;378;413;329;42;49;9.2309999999999999;12.962999999999999;103;269;370;5;10;37;39;149.09999999999999;74.099999999999994;75;42.340000000000003;155;97;483;109;61;130;89;504;109;85;12;173;2435
6;60902;Miranda do Corvo;3642;3972;3416;3815;1789;1765;1621;1565;168;200;9.391;11.331;32;597;2557;44;42;124;158;163.69999999999999;78.299999999999997;85.400000000000006;42.079999999999998;623;407;1991;349;272;546;420;2123;411;472;7;97;1551
6;40721;Mirandela;5620;6232;5542;6179;2875;2943;2575;2606;300;337;10.435;11.451000000000001;125;803;4253;67;98;233;239;365.30000000000001;173.19999999999999;192.09999999999999;40.409999999999997;938;687;3168;476;351;922;690;3542;510;568;5;72;1149
6;30325;Mire de Tibães;1187;1250;1144;1253;640;568;580;459;60;109;9.375;19.190000000000001;6;500;533;11;15;49;94;559.29999999999995;272.39999999999998;286.89999999999998;39.719999999999999;203;154;683;85;62;184;163;705;103;95;4;55;653
6;131617;Modivas;873;933;828;912;486;441;412;353;74;88;15.226000000000001;19.954999999999998;20;299;446;11;19;63;69;440.60000000000002;213;227.59999999999999;42.789999999999999;128;89;527;74;55;114;89;546;96;88;15;223;3018
6;40810;Mogadouro;1752;1797;1667;1698;861;770;780;672;81;98;9.4079999999999995;12.727;57;236;1159;29;40;52;58;72.799999999999997;36;36.899999999999999;42.93;247;196;984;170;155;229;202;983;193;190;5;73;1175
6;180408;Moimenta;196;212;171;201;92;54;80;43;12;11;13.042999999999999;20.370000000000001;3;56;64;1;7;11;4;62.399999999999999;30;32.399999999999999;45.170000000000002;25;14;110;23;24;30;20;105;25;32;20;286;3944
6;10307;Moita;1200;1284;1159;1250;621;534;560;475;61;59;9.8230000000000004;11.048999999999999;50;433;552;10;12;51;47;72.700000000000003;35.100000000000001;37.600000000000001;45.619999999999997;170;113;676;134;107;145;109;678;164;188;1;3;36
6;160212;Moledo;602;720;579;691;294;294;268;257;26;37;8.8439999999999994;12.585000000000001;23;121;381;6;9;20;28;188.30000000000001;85.799999999999997;102.59999999999999;44.079999999999998;79;68;337;73;45;87;60;400;86;87;18;260;3393
6;110804;Moledo;232;240;226;235;113;96;97;85;16;11;14.159000000000001;11.458;42;42;98;1;2;15;9;63.299999999999997;31.100000000000001;32.200000000000003;42.450000000000003;36;27;119;30;20;36;25;122;30;27;12;173;2437
6;171416;Mondrões;524;541;510;531;245;190;215;166;30;24;12.244999999999999;12.632;18;91;272;1;9;29;15;96.5;47.5;49;43.399999999999999;71;63;286;49;55;82;57;269;65;68;19;282;3874
6;50216;Monforte da Beira;184;194;185;196;31;14;28;14;3;0;9.6769999999999996;0;10;11;21;0;0;3;0;3.1000000000000001;1.5;1.6000000000000001;58.93;24;11;61;40;48;11;11;51;38;83;6;79;1299
6;50508;Monsanto;369;460;389;495;92;55;82;53;10;2;10.869999999999999;3.6360000000000001;13;36;86;5;1;5;1;6.2999999999999998;2.7999999999999998;3.5;63.130000000000003;13;24;132;72;128;17;18;125;113;187;6;82;1378
6;121205;Montalvão;199;243;198;243;48;48;39;40;9;8;18.75;16.667000000000002;5;10;64;0;0;9;8;3.6000000000000001;1.6000000000000001;2;65.439999999999998;9;6;73;33;78;9;7;63;48;116;14;203;2646
6;30251;Monte de Fralães;200;208;189;202;113;92;105;82;8;10;7.0800000000000001;10.869999999999999;7;97;83;2;0;6;10;258.39999999999998;126.7;131.80000000000001;34.810000000000002;44;28;112;9;7;38;29;120;16;5;4;54;545
6;81603;Monte Gordo;1589;1719;2303;2447;838;686;601;525;237;161;28.282;23.469000000000001;60;171;895;15;7;222;154;783;376.10000000000002;406.89999999999998;42.240000000000002;218;186;937;147;101;248;221;885;168;197;9;134;1819
6;111309;Monte Redondo;371;424;363;409;179;152;163;137;16;15;8.9390000000000001;9.8680000000000003;11;78;211;4;1;12;14;86.900000000000006;40.600000000000001;46.399999999999999;45.640000000000001;49;35;188;49;50;58;42;201;50;73;12;179;2509
6;100119;Montes;282;307;263;293;117;104;105;88;12;16;10.256;15.385;15;92;86;3;2;9;14;108.09999999999999;51.799999999999997;56.299999999999997;48.310000000000002;36;25;144;37;40;34;24;145;43;61;11;149;2170
6;70703;Mora;1231;1291;1152;1251;594;539;528;446;66;93;11.111000000000001;17.254000000000001;84;201;689;5;11;61;82;19.800000000000001;9.5999999999999996;10.1;48.049999999999997;151;129;633;154;164;137;97;641;176;240;8;112;1709
6;30515;Moreira do Castelo;322;305;283;289;164;96;138;80;26;16;15.853999999999999;16.667000000000002;14;123;81;4;5;22;11;102.2;52.5;49.700000000000003;39.780000000000001;69;31;166;21;35;41;43;158;36;27;4;57;742
6;170616;Morgade;113;115;114;116;53;20;51;17;2;3;3.774;15;21;13;34;1;0;1;3;10.800000000000001;5.2999999999999998;5.4000000000000004;53.640000000000001;9;11;59;14;20;7;5;53;24;26;19;274;3737
6;30326;Morreira;382;365;375;361;196;176;177;151;19;25;9.6939999999999991;14.205;8;157;163;4;4;15;21;207.40000000000001;106;101.3;38.890000000000001;78;43;211;31;19;58;33;212;31;31;4;55;655
6;91408;Mós;94;96;90;90;35;15;33;11;2;4;5.7140000000000004;26.667000000000002;11;7;26;0;1;2;3;14.5;7.2000000000000002;7.2999999999999998;55.530000000000001;6;11;39;21;17;7;4;41;14;30;10;148;2148
6;40224;Mós;90;88;91;88;29;26;24;22;5;4;17.241;15.385;3;15;28;1;1;4;3;15.300000000000001;7.7000000000000002;7.5999999999999996;53.710000000000001;10;7;39;14;20;4;6;43;16;19;5;67;1025
6;50607;Mosteiro;152;155;137;141;63;36;63;33;0;3;0;8.3330000000000002;14;35;47;0;1;0;2;17.399999999999999;8.5999999999999996;8.8000000000000007;54.090000000000003;5;17;76;21;33;13;7;71;24;40;6;83;1394
6;131618;Mosteiró;451;480;450;481;242;207;203;180;39;27;16.116;13.042999999999999;12;153;218;2;1;37;26;305.5;148;157.5;41.759999999999998;68;52;251;41;39;73;42;258;53;54;15;223;3019
6;10915;Mosteiró;987;1051;955;1028;556;491;514;439;42;52;7.5540000000000003;10.590999999999999;6;468;479;8;9;34;43;588.10000000000002;284.80000000000001;303.30000000000001;40.159999999999997;162;118;569;77;61;161;117;591;112;70;1;15;163
6;41007;Mourão;53;51;51;50;14;8;11;3;3;5;21.428999999999998;62.5;8;5;1;0;0;3;5;19;9.6999999999999993;9.3000000000000007;60.280000000000001;2;5;18;15;13;2;1;18;13;17;5;75;1217
6;30252;Moure;443;482;413;464;241;232;216;202;25;30;10.372999999999999;12.931000000000001;13;235;170;2;5;23;25;363.69999999999999;174.19999999999999;189.5;37.439999999999998;86;53;258;27;19;75;59;278;35;35;4;54;546
6;130311;Moure;673;648;642;635;376;320;340;281;36;39;9.5739999999999998;12.188000000000001;12;370;239;7;9;29;30;430.39999999999998;219.30000000000001;211.09999999999999;36.869999999999997;131;95;376;45;26;107;84;373;50;34;15;209;2744
6;160513;Mozelos;169;178;166;172;86;64;78;58;8;6;9.3019999999999996;9.375;6;50;80;1;1;7;5;103.3;50.299999999999997;53;47.399999999999999;24;10;98;19;18;13;19;94;21;31;18;263;3465
6;170705;Murça;1021;1115;982;1092;478;485;445;419;33;66;6.9039999999999999;13.608000000000001;44;199;621;5;18;28;48;153;73.099999999999994;79.900000000000006;43.350000000000001;152;106;550;125;88;144;122;602;106;141;19;275;3761
6;60208;Murtede;683;748;652;726;321;301;306;279;15;22;4.673;7.3090000000000002;36;176;373;2;4;13;18;71;33.899999999999999;37.100000000000001;48.359999999999999;83;63;357;101;79;69;55;380;114;130;7;90;1466
6;11203;Murtosa;1746;1953;1691;1917;735;605;680;524;55;81;7.4829999999999997;13.388;188;393;623;4;15;51;66;254.19999999999999;120;134.19999999999999;46.170000000000002;277;169;844;245;211;262;170;879;291;351;1;11;113
6;91410;Muxagata;143;166;140;166;56;29;55;29;1;0;1.786;0;45;11;28;0;0;1;0;11.699999999999999;5.4000000000000004;6.2999999999999998;50.549999999999997;13;12;73;26;19;16;16;72;36;26;10;148;2150
6;41008;Nabo;75;69;72;68;23;19;23;15;0;4;0;21.053000000000001;12;5;21;0;3;0;1;17.199999999999999;9;8.1999999999999993;56.649999999999999;4;;40;15;16;4;3;34;14;14;5;75;1218
6;40723;Navalho;45;51;40;49;18;16;18;13;0;3;0;18.75;11;13;7;0;0;0;3;11.300000000000001;5.2999999999999998;6;41.57;5;9;26;4;1;7;9;22;7;6;5;72;1151
6;131430;Negrelos (São Tomé);1923;2109;1831;2058;962;921;836;719;126;202;13.098000000000001;21.933;10;901;644;12;19;114;183;659.20000000000005;314.39999999999998;344.80000000000001;43.039999999999999;268;194;1117;215;129;276;222;1176;259;176;15;220;2979
6;90612;Nespereira;364;394;345;381;150;150;128;131;22;19;14.667;12.667;13;50;196;1;3;21;16;140.80000000000001;67.599999999999994;73.200000000000003;47.979999999999997;48;35;197;37;47;40;29;201;50;74;10;140;1932
6;161010;Nogueira;153;162;147;153;86;73;80;66;6;7;6.9770000000000003;9.5890000000000004;6;59;81;1;0;5;7;137.19999999999999;66.599999999999994;70.599999999999994;39.5;23;13;91;18;8;31;18;85;15;13;18;268;3615
6;130610;Nogueira;2621;2852;2498;2790;1490;1426;1331;1203;159;223;10.670999999999999;15.638;8;794;1732;25;24;134;199;1561.8;748;813.89999999999998;37.219999999999999;514;275;1552;171;109;507;260;1703;210;172;15;212;2813
6;170318;Nogueira da Montanha;276;253;278;255;120;35;105;27;15;8;12.5;22.856999999999999;68;26;38;7;5;8;3;31.699999999999999;16.600000000000001;15.199999999999999;50.520000000000003;27;32;138;44;35;15;23;132;47;36;19;271;3673
6;121206;Nossa Senhora da Graça;761;829;734;801;346;315;312;277;34;38;9.827;12.063000000000001;14;96;479;7;4;27;34;42.299999999999997;20.199999999999999;22;47.700000000000003;90;85;421;71;94;95;66;410;86;172;14;203;2647
6;142115;Nossa Senhora da Piedade;3464;3753;3175;3570;1853;1796;1703;1630;150;166;8.0950000000000006;9.2430000000000003;32;953;2348;31;24;119;142;353.39999999999998;169.59999999999999;183.80000000000001;39.049999999999997;657;449;1872;292;194;600;424;2061;348;320;16;238;3152
6;70504;Nossa Senhora da Tourega;342;344;336;344;170;153;158;145;12;8;7.0590000000000002;5.2290000000000001;37;57;209;1;0;11;8;3.5;1.7;1.8;45.75;55;31;174;38;44;34;30;178;53;49;8;110;1686
6;70604;Nossa Senhora da Vila;2978;3092;2872;3002;1549;1404;1420;1266;129;138;8.3279999999999994;9.8290000000000006;246;513;1927;31;36;98;102;32.5;15.9;16.5;42.859999999999999;469;304;1600;290;315;448;278;1636;329;401;8;111;1702
6;70516;Nossa Senhora de Guadalupe;219;246;213;245;125;110;117;101;8;9;6.4000000000000004;8.1820000000000004;33;52;133;0;5;8;4;6.9000000000000004;3.2999999999999998;3.7000000000000002;43;30;15;130;19;25;46;18;131;23;28;8;110;1687
6;70503;Nossa Senhora de Machede;556;567;549;566;280;234;256;211;24;23;8.5709999999999997;9.8290000000000006;66;91;310;5;5;19;18;6.0999999999999996;3;3.1000000000000001;44.350000000000001;87;65;280;60;64;71;54;287;78;77;8;110;1688
6;170706;Noura;287;288;269;279;135;94;125;83;10;11;7.407;11.702;55;35;118;1;4;9;7;39.200000000000003;19.600000000000001;19.699999999999999;44.579999999999998;42;35;154;34;22;31;26;162;34;35;19;275;3762
6;171214;Nozelos;52;59;54;59;11;7;11;6;0;1;0;14.286;5;3;9;0;1;0;0;21.300000000000001;10;11.4;57.189999999999998;6;3;19;17;7;2;3;26;17;11;19;280;3823
6;80403;Odeleite;398;365;400;366;108;62;95;53;13;9;12.037000000000001;14.516;24;33;91;1;2;12;7;5.4000000000000004;2.7999999999999998;2.6000000000000001;59.340000000000003;21;25;152;81;119;22;14;120;95;114;9;123;1765
6;21105;Odemira (Santa Maria);609;692;607;711;305;297;270;277;35;20;11.475;6.734;50;53;444;4;3;31;17;21.899999999999999;10.300000000000001;11.699999999999999;46.100000000000001;84;49;338;55;83;80;55;353;88;116;3;49;436
6;20804;Odivelas;270;272;263;256;154;127;132;107;22;20;14.286;15.747999999999999;88;62;89;2;1;20;19;4.9000000000000004;2.5;2.5;47.579999999999998;29;30;153;32;26;19;25;151;36;41;3;46;412
6;111004;Oeiras e São Julião da Barra;15241;18586;14421;17982;7649;8508;6794;7619;855;889;11.178000000000001;10.449;43;1595;12775;168;185;687;704;5029.1999999999998;2266;2763.3000000000002;44.600000000000001;2285;1541;8293;1693;1429;2169;1596;10205;2256;2360;12;176;2473
6;141808;Olalhas;690;725;641;704;282;202;234;169;48;33;17.021000000000001;16.337;38;157;208;4;7;44;26;40.799999999999997;19.899999999999999;20.899999999999999;47.780000000000001;82;85;342;93;88;67;76;313;132;137;16;243;3219
6;131121;Oldrões;957;1047;920;1039;516;399;471;323;45;76;8.7210000000000001;19.047999999999998;6;451;337;8;20;37;56;459.10000000000002;219.19999999999999;239.90000000000001;35.920000000000002;192;123;545;56;41;224;145;552;69;57;15;217;2920
6;50608;Oleiros;1102;1204;945;1050;514;424;486;399;28;25;5.4470000000000001;5.8959999999999999;72;258;555;5;8;23;17;20;9.5;10.4;48.450000000000003;114;109;595;132;152;119;104;585;171;225;6;83;1395
6;30254;Oliveira;504;500;475;488;259;219;230;190;29;29;11.196999999999999;13.242000000000001;18;262;140;10;7;19;22;184;92.400000000000006;91.599999999999994;38.770000000000003;98;67;269;40;30;84;56;275;44;41;4;54;548
6;130124;Oliveira;420;442;401;434;216;133;202;114;14;19;6.4809999999999999;14.286;3;149;164;1;3;13;16;291;141.80000000000001;149.19999999999999;38.789999999999999;76;54;238;26;26;69;62;249;34;28;15;207;2700
6;31239;Oliveira (Santa Maria);1681;1739;1611;1706;888;829;750;666;138;163;15.541;19.661999999999999;8;867;541;19;16;119;147;756.5;371.80000000000001;384.69999999999999;39.969999999999999;258;221;998;128;76;243;187;1032;151;126;4;63;896
6;31242;Oliveira (São Mateus);1300;1414;1249;1383;674;578;526;463;148;115;21.957999999999998;19.896000000000001;5;526;458;23;16;125;99;1250.4000000000001;598.89999999999998;651.5;44.100000000000001;168;157;737;132;106;164;134;792;150;174;4;63;897
6;180204;Oliveira do Conde;1469;1653;1390;1634;671;590;597;526;74;64;11.028;10.847;27;465;631;10;20;64;44;88.599999999999994;41.700000000000003;46.899999999999999;44.630000000000003;210;184;752;195;128;214;171;823;246;199;20;284;3911
6;40523;Olmos;103;105;98;103;44;23;41;19;3;4;6.8179999999999996;17.390999999999998;10;15;35;0;0;3;4;11.1;5.5;5.5999999999999996;52.340000000000003;4;9;59;16;15;6;5;59;17;18;5;70;1096
6;70302;Orada;361;379;346;370;195;160;181;140;14;20;7.1790000000000003;12.5;93;81;147;1;3;13;17;14.6;7.0999999999999996;7.5;47.810000000000002;37;37;198;39;50;38;28;186;58;69;8;108;1663
6;50420;Orca;323;327;320;320;107;65;90;50;17;15;15.888;23.077000000000002;28;34;78;1;3;16;12;11.800000000000001;5.9000000000000004;6;58.07;26;24;133;60;80;12;13;130;65;107;6;81;1361
6;50312;Orjais;386;420;372;410;175;173;160;161;15;12;8.5709999999999997;6.9359999999999999;23;129;169;2;3;13;9;42.700000000000003;20.399999999999999;22.199999999999999;47.020000000000003;47;50;200;48;41;34;37;224;58;67;6;80;1325
6;170319;Oucidres;97;97;95;97;37;10;37;6;0;4;0;40;21;5;17;0;2;0;2;14.1;7.0999999999999996;7.0999999999999996;52.350000000000001;14;5;42;15;21;6;7;40;24;20;19;271;3674
6;170320;Oura;294;308;287;306;116;84;101;62;15;22;12.931000000000001;26.190000000000001;14;40;109;1;2;14;20;41.5;20.300000000000001;21.199999999999999;47.829999999999998;34;33;158;41;28;39;24;146;45;54;19;271;3675
6;60209;Ourentã;595;613;567;586;289;229;270;215;19;14;6.5739999999999998;6.1139999999999999;62;135;288;4;7;15;7;65.799999999999997;32.399999999999999;33.399999999999999;46.590000000000003;69;60;310;100;56;68;54;310;105;76;7;90;1467
6;50313;Ourondo;164;208;152;202;65;41;58;33;7;8;10.769;19.512;3;31;57;0;2;7;6;52.5;23.100000000000001;29.300000000000001;53.490000000000002;16;12;83;26;27;19;15;75;31;68;6;80;1326
6;181205;Ourozinho;60;76;60;69;17;17;17;13;0;4;0;23.529;4;11;15;0;1;0;3;12.199999999999999;5.4000000000000004;6.7999999999999998;47.5;6;5;31;11;7;10;8;36;9;13;20;294;4064
6;41214;Ousilhão;56;67;55;65;20;14;18;13;2;1;10;7.1429999999999998;9;5;17;0;0;2;1;8.9000000000000004;4.0999999999999996;4.9000000000000004;58.93;2;4;23;11;16;3;2;29;11;22;5;77;1257
6;160925;Outeiro;582;652;551;632;297;244;275;211;22;33;7.407;13.525;14;200;272;8;5;14;28;65.599999999999994;30.899999999999999;34.600000000000001;44.689999999999998;93;57;322;64;46;77;58;329;100;88;18;267;3590
6;170619;Outeiro;82;74;78;72;42;19;41;17;1;2;2.3810000000000002;10.526;37;5;16;1;1;0;1;3;1.6000000000000001;1.3999999999999999;52.420000000000002;6;13;40;13;10;2;8;28;18;18;19;274;3740
6;111319;Outeiro da Cabeça;412;428;398;425;226;177;210;164;16;13;7.0800000000000001;7.3449999999999998;22;167;185;3;0;13;13;147.5;72.299999999999997;75.099999999999994;44.049999999999997;58;42;232;41;39;56;39;225;55;53;12;179;2510
6;130211;Ovil;329;372;301;363;134;105;113;74;21;31;15.672000000000001;29.524000000000001;7;55;125;6;9;15;22;42.100000000000001;19.699999999999999;22.300000000000001;47.219999999999999;40;37;158;41;53;33;43;182;59;55;15;208;2723
6;160124;Paçô;449;484;421;456;232;217;218;193;14;24;6.0339999999999998;11.06;12;118;281;2;9;12;15;202.69999999999999;97.599999999999994;105.2;41.329999999999998;67;62;245;45;30;65;56;269;52;42;18;259;3357
6;111005;Paço de Arcos;6977;8338;6774;8055;3768;4171;3337;3728;431;443;11.438000000000001;10.621;21;825;6219;88;72;343;371;4512;2055.5;2456.5;42.409999999999997;1156;692;3973;603;553;1050;739;4750;855;944;12;176;2474
6;80103;Paderne;1645;1659;1629;1623;819;675;706;576;113;99;13.797000000000001;14.667;66;190;1026;15;11;98;88;62.899999999999999;31.300000000000001;31.600000000000001;45.700000000000003;212;173;895;185;180;190;146;864;216;243;9;120;1743
6;170620;Padornelos;57;67;43;59;23;4;21;4;2;0;8.6959999999999997;0;13;4;8;1;0;1;0;7.9000000000000004;3.6000000000000001;4.2999999999999998;55.060000000000002;4;2;28;10;13;6;3;26;13;19;19;274;3741
6;171215;Padrela e Tazem;164;195;161;193;77;19;75;17;2;2;2.597;10.526;60;13;19;0;1;2;1;15.5;7.0999999999999996;8.4000000000000004;51.340000000000003;12;17;84;29;22;15;22;88;41;29;19;280;3824
6;180807;Pala;508;508;480;488;249;129;239;121;10;8;4.016;6.202;51;133;176;1;2;9;6;20.800000000000001;10.4;10.4;46.399999999999999;61;52;283;63;49;55;33;270;88;62;20;290;4022
6;91015;Pala;247;296;236;287;112;86;100;60;12;26;10.714;30.233000000000001;38;24;98;1;1;11;25;38.100000000000001;17.300000000000001;20.800000000000001;51.68;27;23;121;38;38;22;21;127;56;70;10;144;2030
6;11311;Palmaz;1016;1063;979;1026;539;420;487;370;52;50;9.6470000000000002;11.904999999999999;17;479;361;5;8;47;42;140;68.400000000000006;71.599999999999994;42.310000000000002;141;124;581;102;68;144;121;577;113;108;1;12;125
6;30331;Palmeira;2634;2834;2508;2752;1455;1346;1319;1196;136;150;9.3469999999999995;11.144;32;813;1670;27;44;109;106;615.79999999999995;296.60000000000002;319.19999999999999;40.140000000000001;416;340;1531;211;136;405;315;1664;221;229;4;55;663
6;11106;Pampilhosa;1967;2131;1871;2066;1011;989;934;896;77;93;7.6159999999999997;9.4030000000000005;12;564;1254;13;23;64;70;301.30000000000001;144.59999999999999;156.69999999999999;42.340000000000003;326;186;1110;180;165;284;205;1176;227;239;1;10;108
6;30332;Panoias;812;851;770;823;442;402;403;340;39;62;8.8239999999999998;15.423;7;259;477;4;8;35;54;1249;609.89999999999998;639.20000000000005;37.450000000000003;157;121;459;45;30;152;106;485;49;59;4;55;664
6;180205;Papízios;325;354;301;344;147;113;129;99;18;14;12.244999999999999;12.388999999999999;11;87;130;2;4;16;10;50.299999999999997;24.100000000000001;26.199999999999999;45.43;47;28;174;49;27;42;35;175;62;40;20;284;3912
6;160126;Parada;189;194;189;192;104;90;98;78;6;12;5.7690000000000001;13.333;1;55;120;0;3;6;9;192.69999999999999;95.099999999999994;97.599999999999994;41.200000000000003;28;19;107;20;15;24;22;109;19;20;18;259;3361
6;171420;Parada de Cunhos;943;996;911;962;484;498;414;410;70;88;14.462999999999999;17.670999999999999;12;165;647;9;17;61;71;275.39999999999998;133.90000000000001;141.5;39.130000000000003;162;140;528;64;49;141;118;580;90;67;19;282;3877
6;31331;Parada de Gatim;392;401;363;393;198;132;187;117;11;15;5.556;11.364000000000001;22;187;95;0;3;11;12;246.59999999999999;121.90000000000001;124.7;38.039999999999999;77;62;196;28;29;69;57;202;33;40;4;64;951
6;30333;Parada de Tibães;605;644;568;629;326;287;300;251;26;36;7.9749999999999996;12.544;8;213;330;5;8;21;28;663.89999999999998;321.60000000000002;342.30000000000001;36.890000000000001;134;77;340;35;19;120;88;353;46;37;4;55;665
6;131017;Parada de Todeia;909;939;862;908;498;443;422;362;76;81;15.260999999999999;18.283999999999999;10;295;479;6;11;70;70;529.10000000000002;260.19999999999999;268.80000000000001;37.280000000000001;173;123;514;65;34;158;118;545;71;47;15;216;2892
6;160312;Parada do Monte;150;220;139;212;43;37;42;32;1;5;2.3260000000000001;13.513999999999999;12;30;32;0;1;1;4;20.300000000000001;8.1999999999999993;12.1;55.909999999999997;9;15;64;29;33;15;14;88;47;56;18;261;3413
6;30257;Paradela;415;435;385;419;244;161;225;141;19;20;7.7869999999999999;12.422000000000001;42;187;137;4;6;15;14;101.7;49.700000000000003;52;37.789999999999999;76;60;229;29;21;79;59;227;37;33;4;54;551
6;40610;Paradela;75;76;72;74;25;15;25;15;0;0;0;0;9;11;20;0;0;0;0;9.4000000000000004;4.7000000000000002;4.7000000000000002;54.369999999999997;4;6;40;11;14;4;6;34;16;16;5;71;1122
6;61306;Paradela;108;117;101;115;59;31;56;27;3;4;5.085;12.903;7;25;51;0;1;3;3;30.199999999999999;14.5;15.699999999999999;44.469999999999999;7;18;64;9;10;18;12;58;16;13;7;101;1605
6;180712;Paradinha;55;70;56;72;25;15;24;15;1;0;4;0;3;10;26;0;0;1;0;21.899999999999999;9.5999999999999996;12.199999999999999;47.859999999999999;5;3;32;7;8;15;3;31;8;13;20;289;4007
6;10603;Paraíso;473;451;445;443;239;161;206;115;33;46;13.808;28.571000000000002;30;154;137;2;7;31;39;42.100000000000001;21.600000000000001;20.600000000000001;39.899999999999999;81;72;261;24;35;73;52;234;38;54;1;6;80
6;40311;Parambos;125;122;115;112;46;34;37;28;9;6;19.565000000000001;17.646999999999998;11;13;41;1;2;8;4;22.100000000000001;11.199999999999999;10.9;51.020000000000003;14;15;53;22;21;8;8;59;22;25;5;68;1059
6;40229;Parâmio;97;117;97;116;43;20;38;14;5;6;11.628;30;27;11;14;0;1;5;5;9.5;4.2999999999999998;5.2000000000000002;55.289999999999999;9;4;45;17;22;4;14;42;32;25;5;67;1030
6;10704;Paramos;1731;1784;1689;1745;883;789;727;613;156;176;17.667000000000002;22.306999999999999;15;634;691;18;32;138;144;598.60000000000002;294.80000000000001;303.80000000000001;42.310000000000002;246;229;976;164;116;236;208;991;195;154;1;7;90
6;100919;Parceiros;2271;2393;2196;2354;1289;1278;1213;1169;76;109;5.8959999999999999;8.5289999999999999;14;675;1693;16;25;60;84;402.89999999999998;196.19999999999999;206.69999999999999;38.030000000000001;395;241;1363;161;111;393;225;1441;169;165;11;157;2246
6;141908;Parceiros de Igreja;434;473;423;465;221;160;201;141;20;19;9.0500000000000007;11.875;9;143;190;5;4;15;15;73.200000000000003;35;38.200000000000003;48.689999999999998;40;39;235;58;62;55;45;206;71;96;16;244;3235
6;170507;Pardelhas;36;41;35;41;9;5;9;4;0;1;0;20;5;3;5;0;1;0;0;10;4.7000000000000002;5.4000000000000004;43.789999999999999;7;3;17;4;5;7;5;21;4;4;19;273;3720
6;31332;Passó;104;104;98;104;49;16;45;13;4;3;8.1630000000000003;18.75;7;25;26;0;2;4;1;74.200000000000003;37.100000000000001;37.100000000000001;46;12;19;45;12;16;12;14;46;10;22;4;64;952
6;40724;Passos;210;213;196;200;89;51;78;41;11;10;12.359999999999999;19.608000000000001;29;31;59;2;3;9;7;23;11.4;11.6;50.369999999999997;10;30;108;31;31;18;23;100;35;37;5;72;1152
6;30258;Pedra Furada;199;200;185;196;108;88;98;82;10;6;9.2590000000000003;6.8179999999999996;13;95;72;2;1;8;5;168.40000000000001;84;84.400000000000006;40.509999999999998;34;33;114;9;9;27;15;119;15;24;4;54;552
6;30413;Pedraça;372;388;344;370;165;112;139;83;26;29;15.757999999999999;25.893000000000001;22;94;106;3;12;23;17;62.5;30.600000000000001;31.899999999999999;40.490000000000002;70;50;187;36;29;54;67;190;35;42;4;56;721
6;30334;Pedralva;537;573;491;554;305;246;266;226;39;20;12.787000000000001;8.1300000000000008;15;250;227;9;5;30;15;137.59999999999999;66.599999999999994;71;39.439999999999998;87;71;314;38;27;89;77;299;51;57;4;55;667
6;130312;Pedreira;762;802;732;793;445;356;418;332;27;24;6.0670000000000002;6.742;11;539;200;5;6;22;18;438.30000000000001;213.5;224.80000000000001;37.920000000000002;121;137;427;47;30;138;111;445;51;57;15;209;2745
6;141810;Pedreira;253;296;258;292;94;98;87;84;7;14;7.4470000000000001;14.286;2;58;111;1;1;6;13;45.5;21;24.5;48.579999999999998;43;17;115;39;39;35;22;136;46;57;16;243;3221
6;141909;Pedrógão;970;1067;917;1017;467;381;437;339;30;42;6.4240000000000004;11.023999999999999;7;357;412;3;6;27;36;51.799999999999997;24.699999999999999;27.100000000000001;45.740000000000002;117;103;536;104;110;130;107;530;147;153;16;244;3236
6;101302;Pedrógão Grande;1196;1354;1149;1337;536;463;478;380;58;83;10.821;17.927;49;184;625;10;13;48;70;31.800000000000001;14.9;16.899999999999999;48.060000000000002;169;126;596;123;182;147;120;617;186;284;11;161;2268
6;50911;Pedrógão Pequeno;359;394;352;371;152;107;119;85;33;22;21.710999999999999;20.561;24;52;128;6;7;27;15;20.399999999999999;9.6999999999999993;10.699999999999999;51.060000000000002;33;34;185;46;61;33;27;189;68;77;6;86;1428
6;90729;Pega;79;82;79;84;31;21;26;16;5;5;16.129000000000001;23.809999999999999;2;15;25;1;0;4;5;15.1;7.4000000000000004;7.7000000000000002;58.259999999999998;3;10;33;16;17;3;4;28;19;28;10;141;1973
6;130313;Penacova;564;566;550;553;325;292;303;273;22;19;6.7690000000000001;6.5069999999999997;7;449;120;1;5;21;14;376.80000000000001;188.09999999999999;188.69999999999999;37.590000000000003;103;88;308;42;23;84;94;305;51;32;15;209;2746
6;180516;Penajóia;477;546;458;539;247;136;238;110;9;26;3.6440000000000001;19.117999999999999;113;89;146;4;10;5;16;101;47.100000000000001;53.899999999999999;44.859999999999999;61;52;269;57;38;62;52;281;77;74;20;287;3970
6;61113;Penalva de Alva;438;488;418;467;179;158;161;140;18;18;10.055999999999999;11.391999999999999;4;164;133;1;0;17;18;78.200000000000003;37;41.200000000000003;49.170000000000002;43;40;227;71;57;41;45;240;73;89;7;99;1581
6;182203;Pendilhe;282;264;257;253;103;45;99;41;4;4;3.883;8.8889999999999993;12;35;93;0;0;4;4;22.600000000000001;11.699999999999999;10.9;45.149999999999999;38;42;138;24;40;29;31;131;31;42;20;304;4210
6;61406;Penela (São Miguel);788;812;751;803;371;304;325;279;46;25;12.399000000000001;8.2240000000000002;19;168;417;9;5;37;20;48.799999999999997;24.100000000000001;24.800000000000001;45.590000000000003;98;89;412;99;90;96;68;399;132;117;7;102;1614
6;110625;Penha de França;5680;7100;5431;6975;3105;3180;2713;2864;392;316;12.625;9.9369999999999994;7;584;4986;68;58;324;258;18708.700000000001;8315;10393.700000000001;45.840000000000003;670;531;3319;578;582;722;542;3682;857;1297;12;171;2386
6;50510;Penha Garcia;361;387;347;379;121;88;113;78;8;10;6.6120000000000001;11.364000000000001;37;31;123;2;1;6;9;5.7999999999999998;2.7999999999999998;3;59.740000000000002;21;26;142;59;113;18;19;128;90;132;6;82;1380
6;141308;Penhascoso;382;420;355;404;152;115;129;110;23;5;15.132;4.3479999999999999;11;72;156;5;0;18;5;20.300000000000001;9.6999999999999993;10.6;54.960000000000001;33;33;176;45;95;31;21;167;64;137;16;237;3140
6;101404;Peniche (São Pedro);1032;1085;961;1025;528;499;453;396;75;103;14.205;20.640999999999998;77;194;578;18;13;57;90;924.10000000000002;450.5;473.60000000000002;43.719999999999999;162;107;566;118;79;130;86;607;146;116;11;162;2274
6;160313;Penso;248;275;237;264;88;71;80;64;8;7;9.0909999999999993;9.859;7;64;73;3;2;5;5;59.100000000000001;28;31.100000000000001;52.659999999999997;26;17;113;49;43;21;15;130;48;61;18;261;3414
6;181813;Penso;112;118;116;118;48;33;37;24;11;9;22.917000000000002;27.273;16;13;32;5;4;6;5;29.100000000000001;14.199999999999999;14.9;44.899999999999999;12;10;67;15;8;16;12;58;22;10;20;300;4150
6;30340;Penso (Santo Estêvão);213;222;200;218;112;107;99;95;13;12;11.606999999999999;11.215;8;86;100;5;2;8;10;194.19999999999999;95.099999999999994;99.099999999999994;38.979999999999997;45;31;111;8;18;30;31;121;18;22;4;55;669
6;30350;Penso (São Vicente);158;156;159;154;97;66;78;58;19;8;19.588000000000001;12.121;10;60;66;3;4;16;4;199.09999999999999;100.2;98.900000000000006;39.740000000000002;21;25;96;14;2;19;21;90;15;11;4;55;670
6;51102;Perais;247;263;244;264;89;51;77;42;12;9;13.483000000000001;17.646999999999998;13;35;71;0;2;12;7;6.2000000000000002;3;3.2000000000000002;59.770000000000003;7;8;119;46;67;8;17;97;64;77;6;88;1436
6;110407;Peral;467;438;447;431;227;173;211;151;16;22;7.048;12.717000000000001;62;56;244;0;2;16;20;55;28.399999999999999;26.600000000000001;45.960000000000001;66;34;259;63;45;50;34;233;58;63;12;169;2352
6;40914;Peredo dos Castelhanos;49;62;49;62;17;7;16;6;1;1;5.8819999999999997;14.286;8;3;11;0;1;1;0;6.2000000000000002;2.7000000000000002;3.5;67.629999999999995;2;1;21;7;18;;2;10;14;36;5;74;1207
6;61008;Pereira;1612;1653;1510;1614;900;864;839;789;61;75;6.7780000000000005;8.6810000000000009;15;263;1350;19;13;42;62;264.60000000000002;130.59999999999999;134;39.630000000000003;254;127;989;119;123;234;116;1003;134;166;7;98;1563
6;110408;Pêro Moniz;321;318;308;304;154;117;125;91;29;26;18.831;22.222000000000001;36;44;136;2;2;27;24;24.899999999999999;12.5;12.4;44.090000000000003;64;29;167;35;26;40;25;168;48;37;12;169;2353
6;90731;Pêro Soares;35;35;35;34;15;17;14;16;1;1;6.6669999999999998;5.8819999999999997;0;13;17;0;0;1;1;24.5;12.300000000000001;12.300000000000001;47.829999999999998;3;7;17;4;4;2;5;16;7;5;10;141;1975
6;131125;Perozelo;629;717;580;711;357;270;328;238;29;32;8.1229999999999993;11.852;15;358;193;5;5;24;27;352.19999999999999;164.59999999999999;187.59999999999999;35.939999999999998;124;97;355;38;15;136;105;378;47;51;15;217;2924
6;131714;Perosinho;3151;3208;3006;3130;1692;1468;1399;1163;293;305;17.317;20.777000000000001;17;866;1679;43;43;250;262;1201.5999999999999;595.39999999999998;606.20000000000005;40.990000000000002;479;380;1825;262;205;478;314;1855;281;280;15;224;3045
6;180715;Peva;194;224;179;213;67;43;65;39;2;4;2.9849999999999999;9.3019999999999996;20;31;53;1;1;1;3;19.699999999999999;9.0999999999999996;10.5;49.689999999999998;18;26;93;28;29;20;25;96;41;42;20;289;4010
6;130518;Pias;625;663;579;648;346;317;315;282;31;35;8.9600000000000009;11.041;15;276;306;9;11;22;24;602.5;292.39999999999998;310.19999999999999;35.810000000000002;123;78;370;31;23;126;77;394;36;30;15;211;2797
6;141109;Pias;216;240;211;235;89;73;81;64;8;9;8.9890000000000008;12.329000000000001;31;45;69;2;2;6;7;45.600000000000001;21.600000000000001;24;47.590000000000003;29;20;102;36;29;29;28;105;36;42;16;235;3130
6;180318;Picão;132;146;129;149;42;20;42;19;0;1;0;5;1;21;39;0;0;0;1;41.399999999999999;19.699999999999999;21.699999999999999;45.890000000000001;13;14;72;16;17;16;22;70;14;24;20;285;3932
6;10920;Pigeiros;560;621;533;597;307;274;276;234;31;40;10.098000000000001;14.599;4;322;184;6;17;25;23;233;110.5;122.5;40.649999999999999;88;68;331;49;24;78;92;334;62;55;1;15;167
6;181608;Pindelo dos Milagres;291;368;281;352;103;70;99;58;4;12;3.883;17.143000000000001;20;53;84;0;3;4;9;27.600000000000001;12.199999999999999;15.4;49.920000000000002;39;25;152;44;31;34;24;184;63;63;20;298;4114
6;40230;Pinela;103;116;121;132;40;19;35;14;5;5;12.5;26.315999999999999;21;14;14;0;0;5;5;9.6999999999999993;4.5999999999999996;5.0999999999999996;53.490000000000002;5;8;53;23;14;10;6;53;22;25;5;67;1031
6;31112;Pinheiro;229;218;196;211;97;58;78;43;19;15;19.588000000000001;25.861999999999998;4;56;61;3;5;16;10;43.5;22.300000000000001;21.199999999999999;43.909999999999997;35;22;122;24;26;25;25;114;27;27;4;62;856
6;180319;Pinheiro;340;390;333;389;112;46;100;41;12;5;10.714;10.869999999999999;37;36;68;1;2;11;3;37.299999999999997;17.399999999999999;19.899999999999999;54.280000000000001;29;29;154;59;69;28;31;174;67;90;20;285;3933
6;41217;Pinheiro Novo;52;54;52;54;12;8;9;5;3;3;25;37.5;2;1;11;3;3;0;0;3.2000000000000002;1.6000000000000001;1.6000000000000001;60.25;1;2;26;9;14;;4;24;16;10;5;77;1260
6;60111;Piódão;93;85;112;110;35;13;30;12;5;1;14.286;7.6920000000000002;4;13;25;0;0;5;1;4.9000000000000004;2.5;2.2999999999999998;55.520000000000003;3;8;47;18;17;7;2;31;21;24;7;89;1449
6;100505;Pó;444;486;417;464;276;235;260;218;16;17;5.7969999999999997;7.234;261;63;154;4;8;12;9;137.40000000000001;65.599999999999994;71.799999999999997;41.439999999999998;60;51;265;27;41;73;63;262;41;47;11;153;2197
6;160422;Podame;121;157;118;153;54;46;47;40;7;6;12.962999999999999;13.042999999999999;3;23;61;2;5;5;1;76.200000000000003;33.200000000000003;43;50.560000000000002;10;11;65;19;16;14;14;73;26;30;18;262;3442
6;40406;Poiares;206;205;198;199;76;50;74;47;2;3;2.6320000000000001;6;45;26;50;1;0;1;3;10.1;5.0999999999999996;5;52.450000000000003;21;20;85;37;43;14;20;75;49;47;5;69;1073
6;91019;Pomares;58;62;57;62;28;16;24;12;4;4;14.286;25;4;11;21;0;2;4;2;9.3000000000000007;4.5;4.7999999999999998;53.079999999999998;4;4;32;8;10;4;7;26;11;14;10;144;2034
6;130315;Pombeiro de Ribavizela;1079;1139;1023;1104;614;582;556;524;58;58;9.4459999999999997;9.9659999999999993;9;763;308;12;8;46;50;461.19999999999999;224.40000000000001;236.90000000000001;37.520000000000003;183;152;621;75;48;187;179;621;82;70;15;209;2748
6;170624;Pondras;58;73;57;71;20;21;18;18;2;3;10;14.286;12;4;20;1;2;1;1;12;5.2999999999999998;6.7000000000000002;54.469999999999999;4;4;29;6;15;4;10;28;11;20;19;274;3745
6;30838;Ponte;3223;3387;3102;3335;1793;1767;1578;1509;215;258;11.991;14.600999999999999;25;1572;1490;36;39;179;219;1099.7;536.20000000000005;563.5;36.409999999999997;618;414;1908;189;94;589;415;1994;217;172;4;55;673
6;160735;Ponte de Lima;1294;1577;1283;1614;643;676;579;605;64;71;9.9529999999999994;10.503;7;229;948;8;17;56;54;1647.5;742.60000000000002;904.89999999999998;41.659999999999997;231;166;692;110;95;228;145;824;158;222;18;265;3533
6;11806;Ponte de Vagos;869;921;839;903;463;366;436;334;27;32;5.8319999999999999;8.7430000000000003;35;297;438;7;14;20;18;280.60000000000002;136.19999999999999;144.40000000000001;38.960000000000001;146;124;489;66;44;145;124;493;85;74;1;18;194
6;140604;Pontével;2249;2365;2158;2294;1111;931;976;820;135;111;12.151;11.923;70;469;1257;14;19;121;92;165.69999999999999;80.799999999999997;84.900000000000006;43.450000000000003;353;218;1249;256;173;325;211;1253;315;261;16;230;3097
6;111605;Pontinha;11027;12014;10521;11621;5725;5680;4735;4917;990;763;17.292999999999999;13.433;13;1695;7944;162;139;828;624;4970.6999999999998;2378.9000000000001;2591.8000000000002;41.950000000000003;1663;1295;6207;1160;702;1585;1311;6633;1335;1150;12;175;2464
6;30261;Pousa;1092;1180;987;1141;618;509;550;406;68;103;11.003;20.236000000000001;13;583;360;9;19;59;84;342.60000000000002;164.69999999999999;177.90000000000001;36.289999999999999;212;175;601;59;45;220;171;625;84;80;4;54;555
6;91122;Pousafoles do Bispo;120;157;114;152;37;37;31;32;6;5;16.216000000000001;13.513999999999999;9;15;39;1;2;5;3;14.199999999999999;6.0999999999999996;8;62.759999999999998;3;5;53;22;37;4;10;51;23;69;10;145;2064
6;61611;Póvoa de Midões;274;308;258;295;135;106;123;95;12;11;8.8889999999999993;10.377000000000001;14;99;105;1;3;11;8;61.100000000000001;28.800000000000001;32.399999999999999;44.630000000000003;30;33;163;22;26;39;29;158;38;44;7;104;1639
6;181208;Póvoa de Penela;151;174;145;170;67;44;65;38;2;6;2.9849999999999999;13.635999999999999;52;10;41;0;2;2;4;33.299999999999997;15.5;17.800000000000001;45.969999999999999;21;15;80;18;17;18;20;83;28;25;20;294;4067
6;21002;Póvoa de São Miguel;456;432;440;418;198;119;165;80;33;39;16.667000000000002;32.773000000000003;98;29;118;0;1;33;38;4.7999999999999998;2.3999999999999999;2.2999999999999998;45.390000000000001;58;60;228;64;46;50;52;194;71;65;3;48;426
6;91314;Póvoa do Concelho;132;144;131;134;69;33;61;29;8;4;11.593999999999999;12.121;14;29;47;2;1;6;3;25.5;12.199999999999999;13.300000000000001;48.909999999999997;11;20;67;19;15;10;18;69;23;24;10;147;2125
6;30848;Prazins (Santo Tirso);503;490;481;480;290;247;251;225;39;22;13.448;8.907;12;304;160;6;6;33;16;362.39999999999998;183.59999999999999;178.80000000000001;33.520000000000003;116;77;270;20;20;115;58;270;27;20;4;55;676
6;180518;Pretarouca;32;37;33;38;9;7;7;6;2;1;22.222000000000001;14.286;2;5;6;1;0;1;1;16.199999999999999;7.5;8.6999999999999993;51.640000000000001;2;2;16;6;6;6;1;14;6;10;20;287;3972
6;50804;Proença-a-Nova;2060;2235;1881;2118;1009;796;931;711;78;85;7.7300000000000004;10.678000000000001;57;500;1085;14;18;64;67;29.800000000000001;14.300000000000001;15.5;46.119999999999997;254;250;1131;200;225;263;221;1101;246;404;6;85;1415
6;80806;Querença;385;374;391;371;172;125;144;109;28;16;16.279;12.800000000000001;7;66;180;1;0;27;16;22.600000000000001;11.4;11.1;52.450000000000003;46;18;193;65;63;33;19;168;65;89;9;127;1792
6;180614;Quintela de Azurara;256;286;232;271;131;125;121;109;10;16;7.6340000000000003;12.800000000000001;3;80;147;2;3;8;13;56.5;26.699999999999999;29.800000000000001;43.399999999999999;33;26;146;32;19;39;28;160;38;21;20;288;3991
6;40233;Quintela de Lampaças;103;112;101;109;34;20;32;16;2;4;5.8819999999999997;20;12;10;26;0;1;2;3;10.800000000000001;5.2000000000000002;5.5999999999999996;56.759999999999998;6;7;49;20;21;7;5;39;32;29;5;67;1034
6;41218;Quirás;101;79;100;78;27;6;25;4;2;2;7.407;33.332999999999998;10;10;9;0;2;2;0;7;3.8999999999999999;3.1000000000000001;62.710000000000001;3;6;36;27;29;;4;20;29;26;5;77;1261
6;90914;Rabaçal;126;152;135;151;59;43;57;39;2;4;3.3900000000000001;9.3019999999999996;21;35;40;0;1;2;3;19.800000000000001;9;10.800000000000001;51.850000000000001;13;15;61;15;22;9;17;61;26;39;10;143;2013
6;30337;Real;3697;3969;3499;3856;2108;2133;1857;1822;251;311;11.907;14.58;8;1025;2646;48;60;203;251;5081.3999999999996;2450.5;2630.8000000000002;34.200000000000003;813;440;2190;170;84;775;448;2399;203;144;4;55;678
6;10606;Real;635;665;598;643;334;229;286;171;48;58;14.371;25.327999999999999;27;221;209;4;13;44;45;39.299999999999997;19.199999999999999;20.100000000000001;40.299999999999997;93;80;385;38;39;102;80;361;58;64;1;6;83
6;40235;Rebordainhos;72;74;69;72;27;11;24;9;3;2;11.111000000000001;18.181999999999999;9;12;12;0;0;3;2;11;5.4000000000000004;5.5999999999999996;55.659999999999997;1;7;34;10;20;6;5;29;15;19;5;67;1036
6;130128;Rebordelo;174;191;150;177;90;54;84;37;6;17;6.6669999999999998;31.481000000000002;21;43;57;2;13;4;4;23.300000000000001;11.1;12.199999999999999;40.75;31;21;97;10;15;31;19;91;17;33;15;207;2704
6;131416;Rebordões;1641;1775;1598;1743;832;792;709;575;123;217;14.784000000000001;27.399000000000001;9;691;584;13;20;110;197;789.39999999999998;379.19999999999999;410.19999999999999;44.539999999999999;213;176;928;191;133;197;158;1033;195;192;15;220;2981
6;131019;Recarei;2309;2322;2202;2272;1299;947;1110;767;189;180;14.550000000000001;19.007000000000001;10;848;1019;20;38;169;142;317.10000000000002;158.09999999999999;159;38.939999999999998;397;303;1345;165;99;345;274;1362;188;153;15;216;2894
6;131417;Refojos de Riba de Ave;456;506;430;486;241;210;216;180;25;30;10.372999999999999;14.286;17;176;203;1;4;24;26;147.90000000000001;70.099999999999994;77.799999999999997;42.539999999999999;73;56;254;40;33;70;55;273;61;47;15;220;2982
6;100207;Rego da Murta;406;448;396;443;193;147;181;127;12;20;6.218;13.605;23;118;167;1;9;11;11;49.399999999999999;23.5;25.899999999999999;47.200000000000003;49;41;204;52;60;56;37;211;71;73;11;150;2182
6;131418;Reguenga;760;836;740;822;416;370;346;304;70;66;16.826999999999998;17.838000000000001;19;306;325;16;8;54;58;318.89999999999998;151.90000000000001;167.09999999999999;42.530000000000001;103;96;426;81;54;106;84;465;98;83;15;220;2983
6;121405;Reguengo;311;319;308;312;141;126;130;109;11;17;7.8010000000000002;13.492000000000001;21;56;162;2;4;9;13;21.899999999999999;10.800000000000001;11.1;47.07;39;18;166;39;49;36;23;171;38;51;14;205;2663
6;110805;Reguengo Grande;793;833;748;799;362;306;330;287;32;19;8.8399999999999999;6.2089999999999996;115;154;348;4;2;28;17;104.3;50.899999999999999;53.399999999999999;44.630000000000003;129;64;424;99;77;101;86;428;98;120;12;173;2438
6;90413;Reigada;146;157;135;152;75;44;69;36;6;8;8;18.181999999999999;28;30;47;2;5;4;3;12.800000000000001;6.2000000000000002;6.7000000000000002;48.140000000000001;14;11;83;14;24;18;20;75;17;27;10;138;1898
6;10509;Requeixo;610;612;577;573;302;261;279;231;23;30;7.6159999999999997;11.494;18;203;289;2;6;21;24;117.90000000000001;58.899999999999999;59.100000000000001;41.93;105;73;328;51;53;91;56;334;68;63;1;5;73
6;50219;Retaxo;402;441;376;427;153;134;135;111;18;23;11.765000000000001;17.164000000000001;3;66;177;4;1;14;22;68.700000000000003;32.799999999999997;35.899999999999999;52.189999999999998;28;38;214;70;52;34;29;217;78;83;6;79;1302
6;31234;Riba de Ave;1627;1798;1561;1761;861;847;696;690;165;157;19.164000000000001;18.536000000000001;4;619;763;24;21;141;136;1242.2;590.10000000000002;652.10000000000002;41.560000000000002;253;181;947;146;100;235;181;1035;193;154;4;63;903
6;182322;Ribafeita;587;640;541;605;244;194;229;173;15;21;6.1479999999999997;10.824999999999999;20;119;263;3;1;12;20;67.700000000000003;32.399999999999999;35.299999999999997;47.859999999999999;70;59;295;93;70;63;52;325;111;89;20;305;4235
6;110116;Ribafria;478;492;459;483;232;175;221;165;11;10;4.7409999999999997;5.7140000000000004;28;128;230;2;2;9;8;106.2;52.399999999999999;53.899999999999999;43.780000000000001;71;49;257;60;41;70;43;252;68;59;12;165;2319
6;40315;Ribalonga;46;46;46;46;21;4;20;4;1;0;4.7620000000000005;0;12;5;7;0;0;1;0;13.1;6.5;6.5;56.049999999999997;5;1;23;5;12;4;;18;12;12;5;68;1063
6;170111;Ribalonga;105;126;100;119;37;24;34;22;3;2;8.1080000000000005;8.3330000000000002;16;16;24;1;0;2;2;25.300000000000001;11.5;13.800000000000001;50.899999999999999;13;11;47;17;17;7;16;53;23;27;19;269;3631
6;90614;Ribamondego;143;174;134;169;41;42;38;30;3;12;7.3170000000000002;28.571000000000002;3;17;48;2;4;1;8;42;18.899999999999999;23;54.390000000000001;17;11;52;23;40;17;11;60;33;53;10;140;1934
6;60315;Ribeira de Frades;908;994;881;971;459;442;415;401;44;41;9.5860000000000003;9.2759999999999998;7;196;613;7;12;37;29;320.69999999999999;153.09999999999999;167.59999999999999;44.770000000000003;130;91;515;107;65;107;95;547;118;127;7;91;1493
6;121406;Ribeira de Nisa;681;685;632;652;316;289;290;261;26;28;8.2279999999999998;9.6890000000000001;20;89;442;4;4;22;24;80.099999999999994;39.899999999999999;40.100000000000001;45.880000000000003;81;77;366;68;89;90;59;345;89;102;14;205;2664
6;142118;Ribeira do Fárrio;383;453;362;438;188;120;179;112;9;8;4.7869999999999999;6.6669999999999998;5;140;146;3;3;6;5;42.200000000000003;19.300000000000001;22.899999999999999;47.140000000000001;60;40;186;39;58;49;50;196;65;93;16;238;3155
6;31235;Ribeirão;4344;4484;4181;4433;2481;2223;2201;1781;280;442;11.286;19.882999999999999;39;2332;1611;31;52;249;390;857.89999999999998;422.10000000000002;435.69999999999999;37.270000000000003;778;621;2512;270;163;776;575;2563;288;282;4;63;904
6;30725;Ribeiros;314;326;287;318;163;142;139;116;24;26;14.724;18.309999999999999;12;132;111;1;6;23;20;129.09999999999999;63.299999999999997;65.799999999999997;42.299999999999997;45;43;177;25;24;41;31;185;26;43;4;59;789
6;30266;Rio Covo (Santa Eulália);451;519;414;506;256;238;236;205;20;33;7.8129999999999997;13.866;12;278;151;4;5;16;28;219.59999999999999;102.09999999999999;117.5;38.359999999999999;72;63;258;42;16;92;62;291;36;38;4;54;559
6;142112;Rio de Couros;895;982;845;943;419;362;392;319;27;43;6.444;11.878;23;331;357;8;10;19;33;89.799999999999997;42.799999999999997;47;44.600000000000001;125;114;460;103;93;123;104;488;143;124;16;238;3156
6;130716;Rio de Galinhas;942;1072;846;1042;530;426;465;335;65;91;12.263999999999999;21.361999999999998;6;267;527;13;16;52;75;963.39999999999998;450.60000000000002;512.79999999999995;37.280000000000001;164;123;560;63;32;188;142;605;75;62;15;213;2834
6;131129;Rio de Moinhos;1434;1452;1311;1403;771;488;674;386;97;102;12.581;20.902000000000001;28;624;408;14;34;83;68;352.30000000000001;175;177.19999999999999;37.369999999999997;264;219;796;79;76;244;217;780;98;113;15;217;2930
6;181707;Rio de Moinhos;430;512;407;494;170;112;158;101;12;11;7.0590000000000002;9.8209999999999997;28;67;164;2;2;10;9;85.299999999999997;39;46.399999999999999;50.770000000000003;41;43;210;74;62;50;43;213;96;110;20;299;4132
6;160130;Rio Frio;306;378;303;378;103;62;91;55;12;7;11.65;11.289999999999999;6;63;77;4;4;8;3;35.5;15.9;19.600000000000001;55.390000000000001;24;27;131;57;67;21;24;157;87;89;18;259;3366
6;31339;Rio Mau;319;348;311;339;140;98;129;91;11;7;7.8570000000000002;7.1429999999999998;6;120;94;2;1;9;6;195;93.299999999999997;101.7;43.479999999999997;52;38;161;32;36;43;37;166;50;52;4;64;960
6;90736;Rocamondo;46;43;41;42;28;19;24;18;4;1;14.286;5.2629999999999999;1;15;26;0;0;4;1;15.4;7.9000000000000004;7.4000000000000004;41.75;5;6;29;1;5;8;3;20;4;8;10;141;1980
6;11705;Rocas do Vouga;851;927;788;879;424;337;391;294;33;43;7.7830000000000004;12.76;55;298;332;5;1;28;42;120;57.399999999999999;62.600000000000001;45.600000000000001;126;103;449;93;80;87;95;480;109;156;1;17;185
6;100503;Roliça;1406;1402;1320;1360;683;527;610;462;73;65;10.688000000000001;12.334;226;231;615;13;11;60;54;124.09999999999999;62.100000000000001;61.899999999999999;45.460000000000001;184;152;771;154;145;164;125;727;165;221;11;153;2198
6;141618;Romeira;388;395;365;376;175;170;146;156;29;14;16.571000000000002;8.2349999999999994;17;53;232;4;1;25;13;70.299999999999997;34.799999999999997;35.5;43.490000000000002;65;38;212;34;39;55;36;202;45;57;16;241;3196
6;40726;Romeu;126;154;128;154;55;48;53;43;2;5;3.6360000000000001;10.417;18;26;52;0;1;2;4;19.399999999999999;8.6999999999999993;10.699999999999999;51.93;12;11;61;16;26;11;13;66;28;36;5;72;1154
6;30264;Roriz;1059;1093;1005;1075;542;485;470;429;72;56;13.284000000000001;11.545999999999999;37;631;231;9;13;63;43;329.39999999999998;162.09999999999999;167.30000000000001;36.840000000000003;234;137;575;67;46;203;134;590;88;78;4;54;560
6;31113;Rossas;786;887;751;869;323;232;281;179;42;53;13.003;22.844999999999999;35;177;248;3;13;39;40;53;24.899999999999999;28.100000000000001;44.840000000000003;114;83;420;85;84;103;104;435;116;129;4;62;857
6;180716;Rua;295;306;280;297;116;82;109;74;7;8;6.0339999999999998;9.7560000000000002;25;35;123;5;4;2;4;62.200000000000003;30.5;31.699999999999999;49.219999999999999;29;36;139;45;46;29;30;150;55;42;20;289;4011
6;31114;Ruivães;349;389;317;369;127;89;112;72;15;17;11.811;19.100999999999999;10;64;110;2;4;13;13;24.399999999999999;11.6;12.9;50.329999999999998;33;36;163;55;62;37;37;165;67;83;4;62;858
6;31236;Ruivães;927;950;888;927;477;416;412;328;65;88;13.627000000000001;21.154;14;412;314;9;9;56;79;606;299.30000000000001;306.69999999999999;43.210000000000001;127;127;512;87;74;107;103;539;115;86;4;63;905
6;91128;Ruivós;27;43;41;48;13;12;13;12;0;0;0;0;5;10;10;0;0;0;0;10.300000000000001;4;6.2999999999999998;48.240000000000002;1;3;15;2;6;7;5;17;5;9;10;145;2070
6;160132;Sá;58;80;59;83;26;29;23;24;3;5;11.538;17.241;8;13;26;0;4;3;1;50.700000000000003;21.300000000000001;29.399999999999999;55.770000000000003;3;3;32;10;10;2;7;40;15;16;18;259;3367
6;160425;Sá;87;113;85;112;36;38;34;33;2;5;5.556;13.157999999999999;8;19;40;0;3;2;2;49.399999999999999;21.5;27.899999999999999;49.880000000000003;8;9;44;13;13;9;10;58;13;23;18;262;3445
6;91021;Safurdão;55;53;53;50;22;12;20;9;2;3;9.0909999999999993;25;3;10;16;0;0;2;3;11.1;5.7000000000000002;5.5;56.399999999999999;3;7;21;14;10;;6;19;10;18;10;144;2036
6;160426;Sago;103;122;103;115;33;26;29;23;4;3;12.121;11.538;8;21;23;0;1;4;2;71.599999999999994;32.799999999999997;38.799999999999997;51.530000000000001;14;8;47;18;16;8;10;56;25;23;18;262;3446
6;40110;Saldonha;50;42;49;41;20;6;16;5;4;1;20;16.667000000000002;8;7;6;0;0;4;1;10.699999999999999;5.7999999999999998;4.9000000000000004;55.609999999999999;3;4;21;12;10;2;4;13;14;9;5;66;989
6;90315;Salgueirais;56;58;54;58;27;17;26;15;1;2;3.7039999999999997;11.765000000000001;9;14;18;0;0;1;2;12.5;6.0999999999999996;6.4000000000000004;47.740000000000002;8;5;28;5;10;6;3;30;7;12;10;137;1881
6;100610;Salir do Porto;373;424;350;406;143;144;122;117;21;27;14.685;18.75;7;53;179;5;2;16;25;80.900000000000006;37.799999999999997;43;49.259999999999998;49;33;170;63;58;33;45;212;61;73;11;154;2210
6;182005;Salzedas;383;384;366;382;167;80;160;68;7;12;4.1920000000000002;15;44;78;106;0;3;7;9;86.799999999999997;43.399999999999999;43.5;42.409999999999997;69;46;198;45;25;47;41;205;52;39;20;302;4176
6;140502;Samora Correia;8360;8763;7854;8515;4639;4304;4056;3664;583;640;12.567;14.869999999999999;266;1870;5584;77;90;506;550;53.299999999999997;26;27.300000000000001;38.079999999999998;1624;924;4718;701;393;1534;938;4966;739;586;16;229;3092
6;41011;Sampaio;76;83;71;81;42;20;42;13;0;7;0;35;23;17;15;0;2;0;5;18.399999999999999;8.8000000000000007;9.5999999999999996;49.329999999999998;9;5;40;10;12;8;7;41;15;12;5;75;1221
6;61508;Samuel;611;643;577;631;277;219;253;185;24;34;8.6639999999999997;15.525;18;151;269;4;4;20;30;40;19.5;20.5;48.210000000000001;71;54;311;83;92;77;45;323;93;105;7;103;1624
6;31341;Sande;297;294;283;281;157;92;135;66;22;26;14.013;28.260999999999999;7;83;111;3;5;19;21;148.30000000000001;74.5;73.799999999999997;37.920000000000002;52;41;166;19;19;50;46;149;20;29;4;64;962
6;171107;Sanhoane;180;195;169;191;92;72;83;60;9;12;9.7829999999999995;16.667000000000002;57;25;61;3;0;6;12;104.40000000000001;50.100000000000001;54.299999999999997;45.390000000000001;19;20;108;17;16;25;12;105;23;30;19;279;3808
6;110628;Santa Catarina;1692;2024;1631;1960;968;989;849;871;119;118;12.292999999999999;11.931000000000001;5;160;1555;22;21;97;97;17407.099999999999;7926;9481.2000000000007;45.020000000000003;168;162;1040;164;158;182;188;1091;216;347;12;171;2389
6;60316;Santa Clara;4583;5346;4472;5267;2464;2685;2196;2440;268;245;10.877000000000001;9.125;18;560;4058;52;47;216;198;976.89999999999998;450.89999999999998;526;42.549999999999997;639;467;2709;418;350;649;447;3134;542;574;7;91;1494
6;20510;Santa Clara de Louredo;399;465;387;480;194;169;175;147;19;22;9.7940000000000005;13.018000000000001;32;61;229;4;3;15;19;12;5.5999999999999996;6.5;49;47;41;210;42;59;53;36;194;60;122;3;43;393
6;91412;Santa Comba;101;107;95;100;27;16;24;15;3;1;11.111000000000001;6.25;10;14;15;0;0;3;1;6.7999999999999998;3.2999999999999998;3.5;57.25;6;5;43;21;26;9;6;39;28;25;10;148;2152
6;40241;Santa Comba de Rossas;152;152;138;142;80;49;59;37;21;12;26.25;24.489999999999998;3;29;64;5;5;16;7;34.799999999999997;17.399999999999999;17.399999999999999;48.770000000000003;18;20;81;18;15;14;7;79;10;42;5;67;1042
6;40527;Santa Combinha;28;28;29;29;7;6;7;6;0;0;0;0;1;5;7;0;0;0;0;11.199999999999999;5.5999999999999996;5.5999999999999996;53.549999999999997;3;2;15;4;4;3;2;13;2;8;5;70;1100
6;150905;Santa Cruz;237;224;232;217;90;77;82;68;8;9;8.8889999999999993;11.688000000000001;23;34;93;1;1;7;8;17.600000000000001;9.0999999999999996;8.5999999999999996;51.130000000000003;29;20;105;40;43;18;13;108;44;41;17;254;3305
6;20205;Santa Cruz;327;324;319;321;146;94;127;63;19;31;13.013999999999999;32.978999999999999;24;69;97;1;8;18;23;5.2999999999999998;2.7000000000000002;2.6000000000000001;53.799999999999997;27;28;154;65;53;24;22;137;64;77;3;40;375
6;160743;Santa Cruz do Lima;219;261;208;249;107;100;96;78;11;22;10.279999999999999;22;3;82;89;1;5;10;17;214.90000000000001;98.099999999999994;116.90000000000001;44.109999999999999;38;24;113;25;19;32;27;135;27;40;18;265;3543
6;170352;Santa Cruz/Trindade;1526;1570;1433;1507;774;687;689;608;85;79;10.981999999999999;11.499000000000001;14;225;1058;20;17;65;62;1074.5999999999999;529.70000000000005;544.89999999999998;40.859999999999999;249;151;897;135;94;205;182;938;141;104;19;271;3684
6;120706;Santa Eulália;586;612;562;581;241;207;209;171;32;36;13.278;17.390999999999998;76;92;212;0;3;32;33;12.199999999999999;6;6.2000000000000002;46.880000000000003;72;64;286;75;89;70;58;304;79;101;14;198;2620
6;141619;Santa Iria da Ribeira de Santarém;329;416;314;407;152;137;117;112;35;25;23.026;18.248000000000001;3;46;180;5;6;30;19;51.200000000000003;22.600000000000001;28.600000000000001;45.960000000000001;45;43;169;35;37;55;45;181;62;73;16;241;3197
6;110631;Santa Justa;497;394;1069;796;291;171;249;148;42;23;14.433;13.449999999999999;0;25;372;10;7;32;16;3614;2015.9000000000001;1598.0999999999999;42.939999999999998;40;61;331;33;32;43;37;220;35;59;12;171;2392
6;70203;Santa Justa;118;107;114;104;61;44;56;35;5;9;8.1969999999999992;20.454999999999998;28;12;51;1;2;4;7;5.2000000000000002;2.7999999999999998;2.5;46.420000000000002;15;12;68;11;12;11;7;57;14;18;8;107;1658
6;181912;Santa Leocádia;57;61;54;57;23;17;20;13;3;4;13.042999999999999;23.529;8;4;21;2;2;1;2;27.199999999999999;13.199999999999999;14.1;47.100000000000001;8;12;22;11;4;6;5;25;10;15;20;301;4166
6;81408;Santa Luzia;727;728;697;690;365;290;320;241;45;49;12.329000000000001;16.896999999999998;86;80;395;5;4;40;45;171.19999999999999;85.5;85.599999999999994;44.579999999999998;103;54;419;83;68;81;69;405;89;84;9;121;1753
6;150504;Santa Margarida da Serra;94;83;94;83;33;20;31;20;2;0;6.0609999999999999;0;9;13;29;2;0;0;0;3.3999999999999999;1.8;1.6000000000000001;52.090000000000003;5;12;46;13;18;7;6;37;15;18;17;250;3281
6;170350;Santa Maria Maior;5470;6318;5093;6011;2753;2871;2348;2457;405;414;14.711;14.42;45;727;4033;87;107;318;307;2459.5999999999999;1141.3;1318.3;42.270000000000003;834;645;3069;455;467;775;683;3510;622;728;19;271;3686
6;170906;Santa Marinha;269;289;263;280;117;102;97;64;20;38;17.094000000000001;37.255000000000003;14;50;97;2;11;18;27;16.100000000000001;7.7999999999999998;8.3000000000000007;47.640000000000001;32;37;131;29;40;26;28;147;41;47;19;277;3783
6;131130;Santa Marta;652;637;614;629;370;330;332;303;38;27;10.27;8.1820000000000004;9;329;297;6;7;32;20;292.19999999999999;147.80000000000001;144.40000000000001;38.109999999999999;116;75;390;42;29;83;88;381;46;39;15;217;2932
6;171309;Santa Marta da Montanha;69;66;69;64;34;19;29;16;5;3;14.706;15.789;14;13;18;1;2;4;1;11.1;5.7000000000000002;5.4000000000000004;51.219999999999999;4;3;41;6;15;7;1;37;11;10;19;281;3851
6;160928;Santa Marta de Portuzelo;1798;2007;1680;1906;933;849;865;750;68;99;7.2880000000000003;11.661;29;588;998;13;23;55;76;513.29999999999995;242.59999999999999;270.80000000000001;42.399999999999999;287;205;1003;180;123;246;218;1120;194;229;18;267;3594
6;60516;Santana;503;555;442;527;229;208;205;181;24;27;10.48;12.981;9;132;245;3;4;21;23;70.099999999999994;33.299999999999997;36.799999999999997;45.289999999999999;72;53;258;60;60;56;52;302;82;63;7;93;1530
6;130321;Santão;379;397;345;386;205;153;177;123;28;30;13.659000000000001;19.608000000000001;9;161;130;5;6;23;24;410.69999999999999;200.59999999999999;210.09999999999999;40.960000000000001;61;56;204;37;21;63;38;222;47;27;15;209;2753
6;91216;Santiago;575;630;563;630;286;267;254;243;32;24;11.189;8.9890000000000008;8;137;352;6;8;26;16;162.09999999999999;77.299999999999997;84.700000000000003;44.810000000000002;77;61;329;57;51;67;58;350;68;87;10;146;2099
6;100307;Santiago da Guarda;1516;1631;1447;1560;719;518;673;461;46;57;6.3979999999999997;11.004;47;431;656;1;15;45;42;76.200000000000003;36.700000000000003;39.5;47.159999999999997;171;172;793;203;177;171;159;792;251;258;11;151;2189
6;150906;Santiago do Cacém;3676;3927;3564;3751;1941;1754;1831;1637;110;117;5.6669999999999998;6.6699999999999999;115;862;2491;16;30;94;87;63.600000000000001;30.800000000000001;32.899999999999999;45.18;551;303;2027;409;386;477;303;2060;449;638;17;254;3306
6;70103;Santiago Maior;1071;1134;997;1086;513;391;429;305;84;86;16.373999999999999;21.995000000000001;145;247;342;10;10;74;76;19.5;9.5;10;47.960000000000001;116;123;531;138;163;112;108;535;172;207;8;106;1651
6;91413;Santo Amaro;22;28;22;27;1;0;0;0;1;0;100;0;0;0;0;0;0;1;0;3.2999999999999998;1.5;1.8999999999999999;66.780000000000001;;1;6;7;8;;;6;13;9;10;148;2153
6;150907;Santo André;5247;5400;4896;5099;2970;2641;2794;2320;176;321;5.9260000000000002;12.154;72;1901;3141;34;67;142;254;141.80000000000001;69.900000000000006;71.900000000000006;41.890000000000001;741;583;3157;462;304;668;554;3289;474;415;17;254;3307
6;110714;Santo Antão do Tojal;2097;2119;1988;2049;1038;937;911;835;127;102;12.234999999999999;10.885999999999999;34;418;1294;23;23;104;79;278.60000000000002;138.59999999999999;140;43.340000000000003;339;260;1106;215;177;274;199;1128;266;252;12;172;2427
6;150407;Santo António da Charneca;5575;5961;5253;5743;2791;2789;2344;2355;447;434;16.015999999999998;15.561;22;975;3702;82;82;365;352;1498.8;724.29999999999995;774.5;40.350000000000001;972;646;3093;541;323;925;605;3389;593;449;17;249;3275
6;60318;Santo António dos Olivais;17659;21277;19646;23731;9262;10598;8381;9810;881;788;9.5120000000000005;7.4349999999999996;64;1860;16267;224;226;657;562;2020.2;916.20000000000005;1104;43.609999999999999;2249;2127;10133;1720;1430;2242;2094;12191;2275;2475;7;91;1495
6;110635;Santo Condestável;6628;8629;6269;8297;3243;3661;2828;3284;415;377;12.797000000000001;10.298;13;609;5490;83;78;332;299;14847.1;6449.8999999999996;8397.2000000000007;46.579999999999998;957;654;3506;683;828;929;662;4253;1109;1676;12;171;2396
6;30922;Santo Emilião;423;467;390;458;223;195;187;178;36;17;16.143000000000001;8.718;19;223;123;1;4;35;13;434.60000000000002;206.59999999999999;228.09999999999999;38.219999999999999;83;45;242;32;21;90;43;257;41;36;4;60;820
6;110912;Santo Estêvão das Galés;828;881;809;866;440;388;410;346;30;42;6.8179999999999996;10.824999999999999;35;221;500;8;6;22;36;96.099999999999994;46.600000000000001;49.5;42.789999999999999;136;76;460;92;64;119;90;475;92;105;12;174;2454
6;111201;Santo Quintino;1843;1863;1800;1877;999;848;899;755;100;93;10.01;10.967000000000001;53;502;1099;12;15;88;78;127.8;63.600000000000001;64.200000000000003;40.539999999999999;328;199;1018;188;110;295;185;1027;198;158;12;178;2497
6;150908;São Bartolomeu da Serra;209;181;203;173;104;61;95;54;9;7;8.6539999999999999;11.475;43;35;71;0;2;9;5;6.2999999999999998;3.3999999999999999;2.8999999999999999;47.880000000000003;22;22;105;31;29;21;13;93;24;30;17;254;3308
6;70907;São Bartolomeu do Outeiro;209;227;207;224;96;77;91;70;5;7;5.2080000000000002;9.0909999999999993;47;52;62;0;1;5;6;11.6;5.5999999999999996;6.0999999999999996;49.869999999999997;22;20;99;31;37;16;31;96;40;44;8;114;1720
6;110807;São Bartolomeu dos Galegos;495;516;471;500;242;207;216;181;26;26;10.744;12.56;54;124;219;6;6;20;20;80;39.200000000000003;40.799999999999997;43.340000000000003;59;59;269;66;42;75;47;282;65;47;12;173;2441
6;70409;São Bento de Ana Loura;17;15;14;11;12;4;11;4;1;0;8.3330000000000002;0;7;1;7;0;0;1;0;1.2;0.59999999999999998;0.59999999999999998;43.909999999999997;3;1;11;1;1;1;2;9;3;;8;109;1672
6;70410;São Bento do Cortiço;322;377;314;367;139;144;130;126;9;18;6.4749999999999996;12.5;40;61;155;3;4;6;14;29.899999999999999;13.800000000000001;16.100000000000001;48.969999999999999;39;33;163;40;47;32;33;177;54;81;8;109;1674
6;111510;São Brás;12625;13638;12000;13189;7312;7676;6305;6705;1007;971;13.772;12.65;20;2158;10832;202;219;805;752;5072;2438.1999999999998;2633.8000000000002;36.030000000000001;2452;1659;7508;710;296;2390;1591;8369;766;522;12;166;2330
6;182326;São Cipriano;611;672;572;653;319;261;279;223;40;38;12.539;14.558999999999999;14;159;329;7;10;33;28;101.8;48.5;53.299999999999997;42.600000000000001;97;65;341;68;40;82;81;338;85;86;20;305;4238
6;70606;São Cristóvão;258;282;295;275;134;80;123;75;11;5;8.2089999999999996;6.25;72;23;103;2;1;9;4;3.7000000000000002;1.8;1.8999999999999999;53.390000000000001;20;25;126;28;59;24;18;108;51;81;8;111;1705
6;110638;São Cristóvão e São Lourenço;675;666;647;628;373;268;311;221;62;47;16.622;17.536999999999999;1;50;481;16;11;46;36;17190.799999999999;8653.1000000000004;8537.7000000000007;47.259999999999998;51;59;446;50;69;54;47;333;77;155;12;171;2399
6;150909;São Domingos;408;446;393;437;194;136;181;120;13;16;6.7009999999999996;11.765000000000001;66;73;162;0;0;13;16;6.5999999999999996;3.1000000000000001;3.3999999999999999;49.799999999999997;34;31;227;50;66;56;38;204;68;80;17;254;3309
6;181612;São Félix;186;204;180;199;84;57;80;47;4;10;4.7620000000000005;17.544;12;35;80;0;3;4;7;122.09999999999999;58.200000000000003;63.899999999999999;47.329999999999998;25;23;92;22;24;18;21;99;33;33;20;298;4118
6;131717;São Félix da Marinha;6144;6562;5990;6374;3345;3073;2807;2521;538;552;16.084;17.963000000000001;14;1652;3662;71;86;467;466;1602.5;774.89999999999998;827.60000000000002;40;1067;628;3653;480;316;990;549;3934;591;498;15;224;3047
6;100612;São Gregório;458;497;440;497;235;186;200;155;35;31;14.894;16.667000000000002;49;83;223;10;7;25;24;68.5;32.899999999999999;35.700000000000003;45.960000000000001;69;46;255;47;41;62;25;264;67;79;11;154;2212
6;10511;São Jacinto;486;507;438;458;243;184;206;156;37;28;15.226000000000001;15.217000000000001;23;119;220;5;5;32;23;71.799999999999997;35.100000000000001;36.600000000000001;42.060000000000002;69;57;272;60;28;67;63;291;47;39;1;5;76
6;11508;São João;3023;3253;2871;3142;1559;1390;1366;1186;193;204;12.380000000000001;14.676;36;1059;1457;25;37;168;167;426;205.19999999999999;220.80000000000001;41.759999999999998;459;382;1701;271;210;459;363;1803;317;311;1;14;145
6;181508;São João da Pesqueira;1097;1109;1037;1063;594;476;539;403;55;73;9.2590000000000003;15.336;171;164;607;11;20;44;53;51.100000000000001;25.399999999999999;25.699999999999999;38.75;197;162;599;76;63;176;142;598;92;101;20;297;4100
6;111110;São João das Lampas;5600;5792;5353;5636;2978;2701;2663;2378;315;323;10.577999999999999;11.959;131;1458;3452;58;56;257;267;198.09999999999999;97.400000000000006;100.7;41.049999999999997;966;567;3111;544;412;929;539;3224;586;514;12;177;2491
6;110643;São João de Deus;4224;5574;4230;5567;2105;2397;1912;2216;193;181;9.1690000000000005;7.5510000000000002;19;354;3755;44;36;149;145;10596;4568;6028;47.32;627;488;2185;387;537;573;419;2728;660;1194;12;171;2403
6;181313;São João de Fontoura;337;363;327;358;150;57;140;50;10;7;6.6669999999999998;12.281000000000001;105;17;68;2;1;8;6;138.5;66.700000000000003;71.799999999999997;44.270000000000003;51;49;174;33;30;44;27;199;37;56;20;295;4081
6;30923;São João de Rei;201;200;193;197;108;60;104;54;4;6;3.7039999999999997;10;16;74;68;1;3;3;3;73.400000000000006;36.799999999999997;36.600000000000001;41.259999999999998;21;32;109;17;22;33;30;100;16;21;4;60;821
6;160811;São Julião;181;182;181;180;105;72;87;66;18;6;17.143000000000001;8.3330000000000002;17;74;62;0;1;18;5;70;34.899999999999999;35.100000000000001;43.329999999999998;21;27;106;12;15;18;18;100;23;23;18;266;3560
6;40243;São Julião de Palácios;111;121;102;115;38;17;35;15;3;2;7.8949999999999996;11.765000000000001;18;10;22;0;1;3;1;6;2.8999999999999999;3.1000000000000001;57.479999999999997;5;5;51;28;22;2;13;45;33;28;5;67;1043
6;70412;São Lourenço de Mamporcão;252;272;234;256;118;110;110;102;8;8;6.7800000000000002;7.2729999999999997;31;57;124;2;5;6;3;31.100000000000001;14.9;16.100000000000001;51.530000000000001;22;24;121;35;50;16;25;121;47;63;8;109;1676
6;171011;São Lourenço de Ribapinhão;184;223;177;217;78;68;67;52;11;16;14.103;23.529;11;47;61;0;2;11;14;33.799999999999997;15.300000000000001;18.5;45.770000000000003;21;22;106;16;19;25;24;114;24;36;19;278;3795
6;21106;São Luís;995;994;969;967;484;337;423;269;61;68;12.603;20.178000000000001;101;217;374;2;5;59;63;13.6;6.7999999999999998;6.7999999999999998;48.259999999999998;111;86;525;124;149;113;76;476;140;189;3;49;442
6;111121;São Marcos;8325;9087;7801;8640;4983;5360;4351;4700;632;660;12.683;12.313000000000001;14;1521;7516;128;128;504;532;7651.1000000000004;3658.1999999999998;3993;30.629999999999999;2169;926;4955;191;84;2149;932;5610;216;180;12;177;2492
6;20605;São Marcos da Ataboeira;164;174;159;169;80;56;72;46;8;10;10;17.856999999999999;17;31;70;1;2;7;8;3.2999999999999998;1.6000000000000001;1.7;48.689999999999998;20;9;90;18;27;16;15;86;25;32;3;44;403
6;81306;São Marcos da Serra;697;655;695;651;252;184;221;147;31;37;12.302;20.109000000000002;56;90;222;2;10;29;27;8.0999999999999996;4.2000000000000002;3.8999999999999999;53.719999999999999;53;28;345;119;152;66;40;285;113;151;9;132;1811
6;60114;São Martinho da Cortiça;645;674;592;651;333;223;305;204;28;19;8.4079999999999995;8.5199999999999996;40;208;261;5;4;23;15;41.799999999999997;20.5;21.399999999999999;45.75;68;84;354;85;54;79;66;329;98;102;7;89;1452
6;11315;São Martinho da Gândara;966;1019;939;1018;543;445;508;394;35;51;6.4459999999999997;11.461;78;478;346;6;12;29;39;244.09999999999999;118.8;125.3;42.969999999999999;131;120;552;94;69;121;118;548;123;109;1;12;129
6;180115;São Martinho das Chãs;246;303;217;284;124;82;117;70;7;12;5.6449999999999996;14.634;81;40;66;3;5;4;7;56.799999999999997;25.5;31.300000000000001;44.460000000000001;35;37;130;20;24;41;34;148;40;40;20;283;3903
6;60321;São Martinho de Árvore;512;521;487;508;246;249;207;222;39;27;15.853999999999999;10.843;10;96;323;9;7;30;20;224.40000000000001;111.2;113.2;42.390000000000001;85;60;277;51;39;67;45;305;55;49;7;91;1497
6;60322;São Martinho do Bispo;6618;7529;6568;7994;3466;3619;3080;3287;386;332;11.137;9.1739999999999995;40;933;5394;85;78;301;254;754.60000000000002;353;401.60000000000002;42.899999999999999;861;751;3896;604;506;939;749;4292;750;799;7;91;1498
6;121208;São Matias;129;160;129;159;34;22;30;21;4;1;11.765000000000001;4.5449999999999999;13;18;20;0;0;4;1;5.2999999999999998;2.3999999999999999;2.8999999999999999;62.5;9;3;48;24;45;6;6;41;49;58;14;203;2649
6;20516;São Matias;270;299;262;285;145;124;127;112;18;12;12.414;9.6769999999999996;54;34;151;3;2;15;10;8.0999999999999996;3.7999999999999998;4.2999999999999998;42.729999999999997;34;26;150;25;35;49;35;145;34;36;3;43;396
6;110647;São Miguel;694;837;697;837;318;342;270;301;48;41;15.093999999999999;11.988;0;71;500;7;4;41;37;29495.400000000001;13370.200000000001;16125.200000000001;47.060000000000002;63;65;410;81;75;69;47;443;127;151;12;171;2408
6;130721;São Nicolau;212;235;186;217;125;101;107;80;18;21;14.4;20.792000000000002;1;45;141;5;1;13;20;529.20000000000005;251;278.19999999999999;38.920000000000002;34;36;118;20;4;29;30;142;23;11;15;213;2839
6;90617;São Paio;386;442;366;433;182;143;122;108;60;35;32.966999999999999;24.475999999999999;16;48;166;9;8;51;27;53.200000000000003;24.800000000000001;28.399999999999999;50.630000000000003;39;31;200;66;50;46;31;199;74;92;10;140;1936
6;61116;São Paio de Gramaços;489;502;455;478;236;210;207;190;29;20;12.288;9.5240000000000009;5;153;239;6;6;23;14;225;111;114;44.530000000000001;71;60;255;53;50;64;54;259;56;69;7;99;1584
6;60514;São Pedro;1421;1489;1353;1553;677;637;583;535;94;102;13.885;16.013000000000002;116;360;642;15;18;79;84;415.39999999999998;202.90000000000001;212.59999999999999;42.840000000000003;238;160;778;136;109;192;121;818;154;204;7;93;1532
6;131718;São Pedro da Afurada;1737;1831;1708;1814;982;863;818;732;164;131;16.701000000000001;15.18;59;285;1206;14;15;150;116;3580.5;1743.0999999999999;1837.4000000000001;39.960000000000001;259;194;1110;115;59;237;191;1130;156;117;15;224;3048
6;182329;São Pedro de France;637;733;611;715;299;212;265;183;34;29;11.371;13.679;51;165;232;4;6;30;23;73.099999999999994;34;39.100000000000001;47.899999999999999;81;83;308;81;84;79;65;333;118;138;20;305;4240
6;91218;São Romão;1324;1419;1227;1347;628;576;560;504;68;72;10.827999999999999;12.5;17;314;733;18;16;50;56;121.7;58.799999999999997;63;44.280000000000001;180;154;743;138;109;164;151;747;174;183;10;146;2101
6;20909;São Sebastião dos Carros;112;108;109;105;54;24;44;22;10;2;18.518999999999998;8.3330000000000002;9;25;32;0;0;10;2;3.1000000000000001;1.6000000000000001;1.5;54.240000000000002;5;9;60;16;22;7;8;54;12;27;3;47;422
6;60324;São Silvestre;1564;1558;1480;1506;818;726;739;676;79;50;9.6579999999999995;6.8870000000000005;34;318;1063;16;10;63;40;303.89999999999998;152.19999999999999;151.69999999999999;41.340000000000003;242;182;900;140;100;219;150;890;156;143;7;91;1500
6;121209;São Simão;57;61;56;59;9;5;9;4;0;1;0;20;0;3;10;0;0;0;1;4.2000000000000002;2;2.2000000000000002;68.109999999999999;;3;17;11;26;;1;14;24;22;14;203;2650
6;101512;São Simão de Litém;656;726;639;705;247;217;224;194;23;23;9.3119999999999994;10.599;5;175;238;5;4;18;19;86.099999999999994;40.899999999999999;45.200000000000003;49.810000000000002;86;74;284;90;122;66;65;311;139;145;11;163;2290
6;110651;São Vicente de Fora;1579;1960;1529;1901;836;857;701;759;135;98;16.148;11.435;0;150;1310;21;15;114;83;11176.299999999999;4986.5;6189.6999999999998;46.740000000000002;185;135;920;160;179;192;137;981;265;385;12;171;2412
6;181009;São Vicente de Lafões;355;401;337;381;177;185;153;161;24;24;13.558999999999999;12.973000000000001;18;123;173;3;3;21;21;92.200000000000003;43.299999999999997;48.899999999999999;41.68;63;41;191;25;35;59;50;201;48;43;20;292;4043
6;120708;São Vicente e Ventosa;398;403;383;413;190;144;163;116;27;28;14.211;19.443999999999999;56;47;176;2;8;25;20;7.9000000000000004;3.8999999999999999;4;45.539999999999999;54;38;207;41;58;50;45;191;47;70;14;198;2622
6;111202;Sapataria;1534;1510;1485;1473;831;666;770;613;61;53;7.3410000000000002;7.9580000000000002;47;392;944;6;7;55;46;211.30000000000001;106.5;104.8;40.109999999999999;261;140;902;123;108;278;126;822;136;148;12;178;2498
6;170215;Sapiãos;238;250;237;244;93;63;82;49;11;14;11.827999999999999;22.222000000000001;18;43;70;2;8;9;6;23.100000000000001;11.300000000000001;11.9;48.909999999999997;33;21;117;32;35;23;22;127;38;40;19;270;3654
6;150605;Sarilhos Pequenos;540;610;524;605;268;244;237;223;31;21;11.567;8.6069999999999993;3;102;355;4;3;27;18;277.39999999999998;130.30000000000001;147.09999999999999;42.689999999999998;90;58;300;58;34;96;39;308;82;85;17;251;3286
6;60115;Sarzedo;318;367;301;362;145;144;130;126;15;18;10.345000000000001;12.5;8;129;119;3;7;12;11;59.299999999999997;27.5;31.800000000000001;46.210000000000001;46;45;151;38;38;40;40;165;51;71;7;89;1453
6;91219;Sazes da Beira;131;152;130;158;32;30;28;27;4;3;12.5;10;2;24;29;1;1;3;2;36.299999999999997;16.800000000000001;19.5;57.969999999999999;9;10;59;30;23;8;6;60;19;59;10;146;2102
6;110652;Sé;437;473;432;480;246;222;211;207;35;15;14.228;6.7569999999999997;1;34;383;4;3;31;12;7584.3000000000002;3642.0999999999999;3942.0999999999999;45.539999999999999;54;32;278;34;39;45;30;257;49;92;12;171;2413
6;70520;Sé e São Pedro;710;981;858;1237;344;388;304;341;40;47;11.628;12.113;27;70;548;7;14;33;33;2690.5;1129.7;1560.8;49.340000000000003;78;64;390;84;94;64;96;457;125;239;8;110;1694
6;91414;Sebadelhe;125;140;114;135;47;30;44;24;3;6;6.383;20;20;13;35;1;2;2;4;32.799999999999997;15.5;17.300000000000001;50.850000000000001;10;12;68;21;14;13;11;67;20;29;10;148;2154
6;60408;Sebal;1233;1245;1162;1219;667;622;638;576;29;46;4.3479999999999999;7.3949999999999996;7;265;942;5;8;24;38;203;101;102;39.619999999999997;224;111;720;97;81;200;101;735;102;107;7;92;1514
6;170809;Sedielos;413;498;377;475;172;127;147;113;25;14;14.535;11.023999999999999;138;35;87;4;5;21;9;72.099999999999994;32.700000000000003;39.399999999999999;45.530000000000001;50;56;214;46;47;64;59;225;70;80;19;276;3775
6;160427;Segude;157;199;153;198;75;53;68;47;7;6;9.3330000000000002;11.321;12;50;53;1;5;6;1;150.30000000000001;66.299999999999997;84;47.600000000000001;14;10;93;20;20;21;14;104;24;36;18;262;3447
6;91220;Seia;2993;3349;2896;3321;1500;1527;1328;1307;172;220;11.467000000000001;14.407;30;595;2010;38;52;134;168;267.60000000000002;126.3;141.30000000000001;42.549999999999997;431;345;1687;299;231;439;340;1901;330;339;10;146;2103
6;91415;Seixas;167;168;157;155;69;30;68;26;1;4;1.4490000000000001;13.333;43;17;34;0;3;1;1;27.399999999999999;13.699999999999999;13.800000000000001;51.240000000000002;15;17;83;29;23;14;11;82;28;33;10;148;2155
6;90743;Seixo Amarelo;42;42;39;40;14;2;12;2;2;0;14.286;0;3;3;8;0;0;2;0;6.9000000000000004;3.3999999999999999;3.3999999999999999;63.329999999999998;3;1;19;8;11;;2;11;11;18;10;141;1984
6;40316;Seixo de Ansiães;149;141;145;139;51;29;41;24;10;5;19.608000000000001;17.241;29;13;23;0;0;10;5;12.1;6.2000000000000002;5.9000000000000004;54.829999999999998;4;19;62;36;28;10;7;59;30;35;5;68;1064
6;61010;Seixo de Gatões;685;764;619;738;344;304;321;263;23;41;6.6859999999999999;13.487;40;172;372;4;10;19;31;133;62.899999999999999;70.099999999999994;43.119999999999997;101;66;379;82;57;104;75;406;99;80;7;98;1565
6;30856;Selho (São Lourenço);905;877;881;872;494;429;432;365;62;64;12.551;14.917999999999999;8;452;337;8;12;54;52;891.20000000000005;452.60000000000002;438.60000000000002;38.869999999999997;137;132;528;62;46;119;99;537;76;46;4;55;691
6;40317;Selores;68;73;60;69;21;18;17;14;4;4;19.047999999999998;22.222000000000001;13;3;15;0;2;4;2;18.5;8.9000000000000004;9.5999999999999996;49.960000000000001;8;10;26;11;13;9;4;29;12;19;5;68;1065
6;30353;Semelhe;365;418;353;418;204;186;174;158;30;28;14.706;15.054;6;136;190;6;7;24;21;259;120.7;138.30000000000001;42.509999999999998;47;49;205;35;29;51;61;232;34;40;4;55;692
6;40614;Sendim;670;696;630;655;308;251;294;213;14;38;4.5449999999999999;15.138999999999999;20;116;371;4;16;10;22;35.5;17.399999999999999;18.100000000000001;46.549999999999997;84;71;340;96;79;70;70;352;111;93;5;71;1126
6;20207;Senhora da Graça de Padrões;180;200;180;201;76;58;73;50;3;8;3.9470000000000001;13.792999999999999;5;63;55;0;1;3;7;10.9;5.0999999999999996;5.7000000000000002;54.57;17;17;82;19;45;16;11;85;26;62;3;40;377
6;30354;Sequeira;896;915;864;912;455;410;383;346;72;64;15.824;15.609999999999999;8;310;411;11;15;61;49;416.30000000000001;206;210.30000000000001;42.619999999999997;130;112;514;84;56;103;97;519;105;91;4;55;693
6;30121;Sequeiros;105;99;101;95;46;30;38;17;8;13;17.390999999999998;43.332999999999998;1;18;36;1;1;7;12;63;32.5;30.600000000000001;48.18;10;13;51;14;17;10;10;51;11;17;4;53;485
6;90111;Sequeiros;123;139;115;131;59;46;57;39;2;7;3.3900000000000001;15.217000000000001;11;20;65;0;2;2;5;23.399999999999999;11;12.4;49.520000000000003;9;11;70;16;17;15;12;63;20;29;10;135;1832
6;131720;Sermonde;655;705;627;688;354;274;285;201;69;73;19.492000000000001;26.641999999999999;3;186;297;8;8;61;65;819.79999999999995;394.80000000000001;425;40.829999999999998;95;96;367;65;32;125;68;391;59;62;15;224;3050
6;100613;Serra do Bouro;344;359;330;356;142;129;120;107;22;22;15.493;17.053999999999998;3;53;171;3;7;19;15;38.600000000000001;18.899999999999999;19.699999999999999;50;40;32;176;47;49;34;25;178;59;63;11;154;2213
6;30866;Serzedelo;1804;1876;1778;1877;965;902;801;750;164;152;16.995000000000001;16.850999999999999;13;964;574;22;15;142;137;715.29999999999995;350.69999999999999;364.69999999999999;40.960000000000001;255;250;1087;126;86;234;217;1117;161;147;4;55;694
6;131721;Serzedo;3767;4124;3597;4042;2095;1808;1687;1388;408;420;19.475000000000001;23.23;14;1358;1703;50;70;358;350;1181.7;564.10000000000002;617.60000000000002;39.619999999999997;622;430;2178;318;219;692;469;2326;352;285;15;224;3051
6;40528;Sezulfe;114;149;114;148;48;32;43;30;5;2;10.417;6.25;17;14;42;0;1;5;1;17.300000000000001;7.5;9.8000000000000007;52.850000000000001;11;9;52;26;16;12;11;65;23;38;5;70;1101
6;151205;Setúbal (São Sebastião);25329;27213;24083;26689;13161;12703;10938;10388;2223;2315;16.890999999999998;18.224;273;5711;15342;360;419;1863;1896;2038;982.39999999999998;1055.5;39.200000000000003;4597;2910;14364;2166;1292;4537;2842;15236;2507;2091;17;257;3328
6;180719;Sever;268;268;240;268;110;100;103;84;7;16;6.3639999999999999;16;23;31;133;1;1;6;15;53.399999999999999;26.699999999999999;26.699999999999999;47.600000000000001;34;36;128;35;35;28;25;125;44;46;20;289;4014
6;31245;Sezures;237;260;230;257;123;109;105;90;18;19;14.634;17.431000000000001;5;114;76;3;3;15;16;231.09999999999999;110.2;120.90000000000001;42.560000000000002;27;37;138;19;16;37;26;150;20;27;4;63;908
6;130614;Silva Escura;1207;1300;1176;1288;655;583;569;485;86;98;13.130000000000001;16.809999999999999;15;368;671;7;16;79;82;471;226.80000000000001;244.30000000000001;37.880000000000003;246;130;684;88;59;251;134;728;101;86;15;212;2816
6;10705;Silvalde;3247;3426;3161;3401;1620;1373;1307;1063;313;310;19.321000000000002;22.577999999999999;28;894;1448;45;56;268;254;1223.3;595.29999999999995;628.10000000000002;43.18;449;414;1852;308;224;416;381;1890;378;361;1;7;91
6;30727;Silvares (São Clemente);262;308;248;300;145;135;123;110;22;25;15.172000000000001;18.518999999999998;5;106;122;0;2;22;23;232.40000000000001;106.8;125.59999999999999;40.659999999999997;41;33;153;16;19;42;38;171;32;25;4;59;793
6;111316;Silveira;4180;4350;3972;4210;2322;1979;2056;1754;266;225;11.456;11.369;342;930;2538;49;36;217;189;341.60000000000002;167.40000000000001;174.19999999999999;40.109999999999999;686;486;2343;384;281;696;447;2421;415;371;12;179;2515
6;70609;Silveiras;287;280;272;267;147;117;136;106;11;11;7.4829999999999997;9.4019999999999992;76;40;126;1;2;10;9;5.0999999999999996;2.6000000000000001;2.5;48.75;26;30;154;32;45;21;20;143;50;46;8;111;1706
6;151301;Sines;6513;6687;6729;6474;3708;3057;3410;2707;298;350;8.0370000000000008;11.449;195;1950;3972;46;74;252;276;86.5;42.700000000000003;43.799999999999997;41.189999999999998;954;831;3750;557;421;981;664;3771;642;629;17;258;3330
6;30925;Sobradelo da Goma;387;407;376;392;115;94;95;79;20;15;17.390999999999998;15.957000000000001;8;90;76;4;5;16;10;78.5;38.299999999999997;40.200000000000003;47.049999999999997;62;37;198;45;45;30;49;207;64;57;4;60;823
6;101206;Sobral da Lagoa;206;233;200;232;111;81;96;66;15;15;13.513999999999999;18.518999999999998;34;45;83;1;6;14;9;93.5;43.899999999999999;49.600000000000001;44.920000000000002;26;18;115;26;21;31;26;120;31;25;11;160;2264
6;111410;Sobralinho;2457;2593;2317;2523;1377;1306;1224;1141;153;165;11.111000000000001;12.634;3;585;1777;20;21;133;144;1106.5999999999999;538.39999999999998;568.20000000000005;37.149999999999999;470;264;1409;215;99;475;257;1520;214;127;12;180;2529
6;50806;Sobreira Formosa;818;890;762;841;340;211;307;194;33;17;9.7059999999999995;8.0570000000000004;46;159;296;4;2;29;15;20;9.5999999999999996;10.4;54.229999999999997;71;64;393;126;164;68;53;347;174;248;6;85;1417
6;41224;Soeira;41;46;39;45;13;13;9;10;4;3;30.768999999999998;23.077000000000002;4;4;11;1;0;3;3;6.2000000000000002;2.8999999999999999;3.2999999999999998;58.57;2;1;16;12;10;3;1;16;16;10;5;77;1267
6;91024;Souro Pires;286;302;286;302;152;118;141;87;11;31;7.2370000000000001;26.271000000000001;30;81;117;1;3;10;28;37.5;18.300000000000001;19.300000000000001;44.359999999999999;42;39;151;32;22;27;39;161;37;38;10;144;2039
6;40818;Soutelo;63;66;61;60;26;12;22;9;4;3;15.385;25;6;6;19;0;1;4;2;7.7999999999999998;3.7999999999999998;4;52.950000000000003;3;9;36;6;9;3;6;28;12;17;5;73;1183
6;181509;Soutelo do Douro;225;234;222;232;107;53;104;48;3;5;2.8040000000000003;9.4339999999999993;87;17;48;0;1;3;4;25.800000000000001;12.6;13.199999999999999;42.5;34;31;124;13;23;31;25;121;28;29;20;297;4101
6;31014;Souto;239;255;225;247;113;95;101;76;12;19;10.619;20;10;29;138;1;2;11;17;122.7;59.399999999999999;63.299999999999997;42.009999999999998;39;28;130;22;20;25;45;138;21;26;4;61;841
6;181209;Souto;156;161;149;156;74;44;69;39;5;5;6.7569999999999997;11.364000000000001;30;18;60;0;0;5;5;21.699999999999999;10.699999999999999;11;45.939999999999998;14;26;78;27;11;16;18;81;31;15;20;294;4068
6;100924;Souto da Carpalhosa;1905;1958;1801;1869;985;766;912;690;73;76;7.4109999999999996;9.9220000000000006;76;688;838;12;14;61;62;131.59999999999999;64.900000000000006;66.700000000000003;41.770000000000003;295;268;1008;196;138;278;236;1028;208;208;11;157;2251
6;171013;Souto Maior;237;250;227;245;104;78;90;66;14;12;13.462;15.385;26;29;101;1;2;13;10;53;25.800000000000001;27.199999999999999;48.259999999999998;26;21;137;38;15;19;18;134;45;34;19;278;3797
6;181616;Sul;507;583;479;559;185;119;163;95;22;24;11.891999999999999;20.167999999999999;32;82;144;2;1;20;23;20.800000000000001;9.6999999999999993;11.1;54.090000000000003;37;46;246;93;85;41;39;237;127;139;20;298;4122
6;130724;Tabuado;674;701;636;689;352;233;324;182;28;51;7.9550000000000001;21.888000000000002;15;203;288;4;10;24;41;202.09999999999999;99.099999999999994;103;39.340000000000003;118;92;380;50;34;103;92;387;71;48;15;213;2842
6;91321;Tamanhos;120;130;108;129;55;33;50;31;5;2;9.0909999999999993;6.0609999999999999;12;22;47;3;2;2;0;30.100000000000001;14.4;15.6;51.850000000000001;11;12;57;18;22;6;15;61;18;30;10;147;2130
6;10311;Tamengos;755;847;713;821;388;372;355;334;33;38;8.5050000000000008;10.215;18;214;457;7;5;26;33;196.40000000000001;92.599999999999994;103.8;44.57;100;76;418;73;88;114;73;442;99;119;1;3;41
6;182007;Tarouca;1716;1840;1544;1725;890;700;799;578;91;122;10.225;17.428999999999998;67;332;978;11;42;80;80;185.90000000000001;89.700000000000003;96.200000000000003;38.649999999999999;320;215;954;121;106;332;221;969;151;167;20;302;4178
6;60327;Taveiro;923;1025;866;991;471;477;430;419;41;58;8.7050000000000001;12.159000000000001;9;166;674;13;10;28;48;202.09999999999999;95.700000000000003;106.3;42.710000000000001;126;122;524;79;72;124;97;597;98;109;7;91;1502
6;50427;Telhado;298;320;293;314;140;117;113;97;27;20;19.286000000000001;17.094000000000001;18;54;138;2;3;25;17;35;16.899999999999999;18.100000000000001;47.049999999999997;37;31;158;37;35;36;22;159;47;56;6;81;1368
6;171311;Telões;723;762;691;740;322;216;284;170;38;46;11.801;21.295999999999999;33;173;248;6;19;32;27;32.799999999999997;16;16.899999999999999;46.289999999999999;81;76;394;93;79;93;70;384;109;106;19;281;3853
6;180416;Tendais;398;409;382;397;141;95;127;73;14;22;9.9290000000000003;23.158000000000001;49;56;95;3;6;11;16;25.399999999999999;12.5;12.9;49.969999999999999;55;38;181;45;79;44;32;169;69;95;20;286;3952
6;70105;Terena (São Pedro);379;388;367;379;151;119;132;98;19;21;12.583;17.646999999999998;39;65;126;3;3;16;18;9.1999999999999993;4.5999999999999996;4.7000000000000002;48.82;48;34;177;59;61;45;29;165;84;65;8;106;1653
6;91322;Terrenho;55;58;52;58;20;20;19;18;1;2;5;10;5;10;22;0;2;1;0;12.9;6.2999999999999998;6.5999999999999996;48.07;6;8;26;9;6;3;7;29;11;8;10;147;2131
6;131312;Terroso;1217;1311;1178;1272;598;579;529;506;69;73;11.538;12.608000000000001;72;420;543;9;14;60;59;376.5;181.19999999999999;195.19999999999999;39.82;224;180;649;96;68;196;150;715;126;124;15;219;2964
6;50225;Tinalhas;290;295;280;296;141;101;125;92;16;9;11.348000000000001;8.9109999999999996;3;108;106;3;1;13;8;36.100000000000001;17.899999999999999;18.199999999999999;49.189999999999998;35;19;158;43;35;19;20;150;61;45;6;79;1308
6;171226;Tinhela;94;102;94;104;43;21;39;18;4;3;9.3019999999999996;14.286;37;9;11;1;3;3;0;12.800000000000001;6.0999999999999996;6.7000000000000002;52.229999999999997;8;9;45;18;14;7;8;48;19;20;19;280;3835
6;180117;Tões;64;83;60;73;35;23;32;15;3;8;8.5709999999999997;34.783000000000001;12;6;29;0;2;3;6;72.900000000000006;31.800000000000001;41.200000000000003;46.859999999999999;10;5;36;4;9;5;14;41;10;13;20;283;3905
6;121210;Tolosa;477;534;451;506;205;165;177;146;28;19;13.659000000000001;11.515000000000001;22;111;190;6;6;22;13;43;20.300000000000001;22.699999999999999;52.039999999999999;48;38;235;67;89;52;39;220;79;144;14;203;2651
6;100614;Tornada;1737;1824;1640;1777;873;736;748;643;125;93;14.318;12.635999999999999;27;338;1026;19;16;106;77;180.80000000000001;88.200000000000003;92.599999999999994;43.32;277;152;973;180;155;275;159;956;214;220;11;154;2214
6;130525;Torno;1246;1296;1177;1272;678;553;606;488;72;65;10.619;11.754;19;619;456;10;11;62;54;677.10000000000002;331.89999999999998;345.19999999999999;36.75;268;173;681;78;46;216;173;729;97;81;15;211;2800
6;150104;Torrão;1093;1202;1032;1140;530;417;469;349;61;68;11.509;16.306999999999999;198;180;440;7;13;54;55;6.2000000000000002;2.8999999999999999;3.2000000000000002;47.909999999999997;128;104;580;136;145;137;115;537;188;225;17;246;3254
6;30123;Torre;226;232;214;227;114;88;105;65;9;23;7.8949999999999996;26.135999999999999;21;55;94;0;4;9;19;290.30000000000001;143.19999999999999;147;39.07;42;32;117;18;17;38;35;118;21;20;4;53;487
6;100308;Torre de Vale de Todos;193;218;187;217;90;69;84;59;6;10;6.6669999999999998;14.493;4;61;78;1;2;5;8;36.899999999999999;17.300000000000001;19.600000000000001;46.590000000000003;21;17;108;26;21;30;20;109;23;36;11;151;2190
6;182331;Torredeita;715;840;666;810;327;272;277;224;50;48;15.291;17.646999999999998;9;122;370;15;16;35;32;99.299999999999997;45.700000000000003;53.700000000000003;45.869999999999997;77;105;371;89;73;107;100;373;126;134;20;305;4243
6;91324;Torres;62;75;60;75;23;18;21;14;2;4;8.6959999999999997;22.222000000000001;2;11;22;0;0;2;4;13.300000000000001;6;7.2999999999999998;51.100000000000001;9;8;25;9;11;4;14;25;7;25;10;147;2133
6;141912;Torres Novas (Salvador);1040;1187;977;1145;470;480;423;427;47;53;10;11.042;9;190;651;14;14;33;39;186.80000000000001;87.299999999999997;99.599999999999994;47.159999999999997;160;96;518;122;144;134;96;556;145;256;16;244;3239
6;141914;Torres Novas (Santiago);466;527;425;488;241;211;211;175;30;36;12.448;17.062000000000001;10;109;267;3;8;27;28;173;81.200000000000003;91.799999999999997;45.450000000000003;68;42;264;46;46;57;53;260;78;79;16;244;3241
6;141915;Torres Novas (São Pedro);2527;2939;2358;2801;1240;1294;1094;1140;146;154;11.774000000000001;11.901;14;450;1770;31;35;115;119;587.89999999999998;271.80000000000001;316.10000000000002;44.359999999999999;379;270;1366;294;218;358;291;1518;380;392;16;244;3242
6;111315;Torres Vedras (São Pedro e Santiago);8327;9638;7996;9358;4429;4533;3955;4045;474;488;10.702;10.765000000000001;136;1565;6299;89;97;385;391;573.29999999999995;265.69999999999999;307.60000000000002;41.43;1380;946;4582;794;625;1416;928;5302;976;1016;12;179;2517
6;50324;Tortosendo;2742;2882;2586;2776;1315;1254;1138;1054;177;200;13.460000000000001;15.949;32;646;1514;40;33;137;167;316.80000000000001;154.5;162.40000000000001;43.07;427;274;1540;264;237;400;254;1579;310;339;6;80;1334
6;182126;Tourigo;246;266;238;258;113;75;104;67;9;8;7.9649999999999999;10.667;21;72;78;1;2;8;6;58.600000000000001;28.199999999999999;30.5;47.049999999999997;32;25;118;33;38;34;28;118;43;43;20;303;4205
6;130726;Toutosa;270;318;237;307;152;132;138;95;14;37;9.2110000000000003;28.030000000000001;0;109;124;6;14;8;23;608.20000000000005;279.30000000000001;328.89999999999998;40.670000000000002;42;29;165;22;12;51;35;180;27;25;15;213;2844
6;160622;Touvedo (São Lourenço);98;112;96;109;33;32;29;28;4;4;12.121;12.5;2;20;35;1;0;3;4;68.299999999999997;31.899999999999999;36.399999999999999;49.420000000000002;6;16;47;16;13;10;8;58;17;19;18;264;3493
6;91317;Trancoso (Santa Maria);771;806;741;788;375;366;347;335;28;31;7.4669999999999996;8.4700000000000006;30;133;519;9;5;19;26;43.399999999999999;21.199999999999999;22.199999999999999;40.280000000000001;148;91;399;76;57;132;81;433;90;70;10;147;2134
6;91318;Trancoso (São Pedro);780;932;759;925;381;356;362;330;19;26;4.9870000000000001;7.3029999999999999;20;129;543;5;15;14;11;109.7;50;59.700000000000003;44.380000000000003;111;92;417;96;64;118;117;449;98;150;10;147;2135
6;130136;Travanca;1108;1170;1045;1148;590;412;547;299;43;113;7.2880000000000003;27.427;25;501;320;2;19;41;94;262.19999999999999;127.5;134.59999999999999;38.07;205;164;609;77;53;203;158;626;86;97;15;207;2708
6;180417;Travanca;413;416;367;414;214;107;180;77;34;30;15.888;28.036999999999999;12;134;111;1;15;33;15;166.59999999999999;83;83.599999999999994;40.75;70;57;232;22;32;52;52;223;42;47;20;286;3953
6;10117;Travassô;754;835;706;796;410;376;391;342;19;34;4.6340000000000003;9.0429999999999993;9;351;373;5;8;14;26;205.19999999999999;97.400000000000006;107.8;45.079999999999998;87;83;422;72;90;95;88;456;81;115;1;1;18
6;30733;Travassós;706;833;664;805;321;303;265;252;56;51;17.445;16.832000000000001;6;275;236;5;11;51;40;189;86.700000000000003;102.3;41.539999999999999;129;92;375;66;44;114;99;426;96;98;4;59;795
6;130218;Tresouras;182;191;156;186;75;47;64;42;11;5;14.667;10.638;8;45;53;2;1;9;4;80.299999999999997;39.200000000000003;41.100000000000001;44.439999999999998;27;24;89;24;18;20;28;88;29;26;15;208;2730
6;181510;Trevões;260;280;247;275;115;79;107;68;8;11;6.9569999999999999;13.923999999999999;66;27;82;1;2;7;9;23.800000000000001;11.5;12.300000000000001;48.829999999999998;35;30;121;37;37;27;21;136;39;57;20;297;4102
6;170340;Tronco;105;113;140;147;32;13;29;13;3;0;9.375;0;2;11;29;1;0;2;0;25.5;12.300000000000001;13.199999999999999;54.219999999999999;8;8;51;20;18;6;11;47;28;21;19;271;3697
6;160429;Troporiz;120;154;118;152;61;46;50;38;11;8;18.033000000000001;17.390999999999998;1;29;58;1;4;10;4;115;50.399999999999999;64.700000000000003;46.149999999999999;15;6;72;14;13;20;21;69;18;26;18;262;3449
6;31354;Turiz;863;883;828;860;472;390;430;326;42;64;8.8979999999999997;16.41;7;331;418;6;11;36;53;482.30000000000001;238.40000000000001;243.90000000000001;36.049999999999997;189;99;497;40;38;159;112;495;58;59;4;64;965
6;100114;Turquel;2229;2332;2108;2252;1198;962;1105;843;93;119;7.7629999999999999;12.369999999999999;140;821;987;15;16;78;103;112.40000000000001;55;57.5;39.950000000000003;394;275;1223;191;146;393;248;1242;203;246;11;149;2173
6;182008;Ucanha;194;209;167;188;90;55;79;44;11;11;12.222;20;10;42;71;1;3;10;8;74.700000000000003;36;38.799999999999997;43.520000000000003;30;29;98;19;18;31;19;104;27;28;20;302;4179
6;11317;Ul;1175;1238;1111;1194;635;522;583;461;52;61;8.1890000000000001;11.686;29;560;455;9;13;43;48;483.89999999999998;235.59999999999999;248.30000000000001;44.490000000000002;133;163;646;130;103;142;140;665;149;142;1;12;132
6;130328;Unhão;395;405;364;374;213;169;191;149;22;20;10.329000000000001;11.834;26;196;118;6;5;16;15;232.30000000000001;114.7;117.59999999999999;39.340000000000003;75;54;208;38;20;60;53;219;44;29;15;209;2758
6;131135;Urrô;566;595;545;585;299;275;275;251;24;24;8.0269999999999992;8.7270000000000003;5;259;262;3;10;21;14;512.5;249.90000000000001;262.69999999999999;37.5;106;74;332;34;20;107;67;353;41;27;15;217;2935
6;160623;Vade (São Pedro);126;138;123;132;69;54;61;49;8;5;11.593999999999999;9.2590000000000003;5;39;66;4;2;4;3;99.5;47.5;52;40.640000000000001;18;21;66;13;8;23;13;75;11;16;18;264;3494
6;160624;Vade (São Tomé);126;161;120;155;62;51;53;40;9;11;14.516;21.568999999999999;5;41;47;2;7;7;4;182.59999999999999;80.200000000000003;102.40000000000001;44.200000000000003;21;17;69;7;12;19;14;77;21;30;18;264;3495
6;131626;Vairão;590;661;565;641;332;302;297;250;35;52;10.542;17.219000000000001;35;243;269;7;7;28;45;273.80000000000001;129.09999999999999;144.69999999999999;40.380000000000003;99;54;351;56;30;104;67;371;60;59;15;223;3027
6;160432;Valadares;95;110;94;109;37;34;33;31;4;3;10.811;8.8239999999999998;9;15;40;1;1;3;2;102.2;47.399999999999999;54.899999999999999;53.799999999999997;3;9;54;15;14;7;8;56;17;22;18;262;3452
6;181617;Valadares;357;448;307;415;154;123;140;106;14;17;9.0909999999999993;13.821;28;100;118;4;1;10;16;38.799999999999997;17.199999999999999;21.600000000000001;49.390000000000001;37;47;184;41;48;35;49;211;60;93;20;298;4123
6;31351;Valbom (São Pedro);123;126;119;132;71;45;67;35;4;10;5.6340000000000003;22.222000000000001;7;35;60;1;3;3;7;148.19999999999999;73.200000000000003;75;44.710000000000001;14;20;69;9;11;12;17;66;15;16;4;64;967
6;180522;Valdigem;428;462;404;450;241;157;187;114;54;43;22.407;27.388999999999999;100;53;148;11;6;43;37;82;39.399999999999999;42.600000000000001;44.509999999999998;54;60;241;41;32;42;50;263;60;47;20;287;3975
6;31015;Valdosende;304;326;324;351;130;117;107;93;23;24;17.692;20.513000000000002;7;65;128;5;4;18;20;52;25.100000000000001;26.899999999999999;44.859999999999999;47;28;156;42;31;41;34;172;28;51;4;61;842
6;91325;Valdujo;84;101;82;100;22;12;21;10;1;2;4.5449999999999999;16.667000000000002;11;12;8;0;1;1;1;12.1;5.5;6.5999999999999996;54.740000000000002;9;6;32;24;13;5;7;40;34;15;10;147;2136
6;31241;Vale (São Martinho);1022;1059;982;1037;588;524;520;425;68;99;11.565;18.893000000000001;11;509;425;17;22;51;77;577.89999999999998;283.80000000000001;294.10000000000002;38.799999999999997;171;141;607;60;43;144;136;634;68;77;4;63;911
6;40532;Vale Benfeito;94;87;92;83;35;15;32;14;3;1;8.5709999999999997;6.6669999999999998;5;11;30;1;0;2;1;12;6.2000000000000002;5.7999999999999998;53.850000000000001;10;8;42;18;16;5;4;41;18;19;5;70;1105
6;140608;Vale da Pedra;857;898;821;866;413;368;368;316;45;52;10.896000000000001;14.130000000000001;41;146;497;3;6;42;46;124.5;60.799999999999997;63.700000000000003;44.119999999999997;130;84;461;108;74;124;81;460;114;119;16;230;3099
6;41227;Vale das Fontes;178;169;177;167;55;27;45;22;10;5;18.181999999999999;18.518999999999998;8;27;32;0;2;10;3;19.5;10;9.5;55.659999999999997;10;18;71;43;36;10;6;77;40;36;5;77;1270
6;90804;Vale de Amoreira;110;113;103;115;31;26;26;21;5;5;16.129000000000001;19.231000000000002;3;17;27;1;0;4;5;13.300000000000001;6.5999999999999996;6.7000000000000002;57.090000000000003;7;10;42;22;29;5;8;44;24;32;10;142;1999
6;181511;Vale de Figueira;236;226;232;227;109;47;105;44;4;3;3.6699999999999999;6.383;100;19;30;1;1;3;2;28.100000000000001;14.300000000000001;13.699999999999999;48;24;24;123;29;36;24;21;111;34;36;20;297;4103
6;41228;Vale de Janeiro;54;47;52;44;14;1;14;1;0;0;0;0;2;7;6;0;0;0;0;7;3.7999999999999998;3.2999999999999998;57.18;1;3;27;12;11;4;4;14;9;16;5;77;1271
6;40534;Vale de Prados;200;231;195;227;100;83;87;66;13;17;13;20.481999999999999;12;28;113;4;8;9;9;41.600000000000001;19.300000000000001;22.300000000000001;48.130000000000003;18;27;113;24;18;19;23;116;31;42;5;70;1107
6;180810;Vale de Remígio;321;357;312;338;144;113;138;100;6;13;4.1669999999999998;11.504;9;73;156;0;2;6;11;101.40000000000001;48;53.399999999999999;50.07;34;20;173;56;38;32;29;175;68;53;20;290;4025
6;40733;Vale de Salgueiro;209;215;211;216;74;38;70;30;4;8;5.4050000000000002;21.053000000000001;34;19;47;0;2;4;6;28;13.800000000000001;14.199999999999999;56.609999999999999;16;16;95;40;42;13;9;83;41;69;5;72;1161
6;50326;Vale Formoso;270;304;261;299;102;93;90;79;12;14;11.765000000000001;15.054;33;54;82;0;4;12;10;50.799999999999997;23.899999999999999;26.899999999999999;45.75;40;24;134;29;43;45;27;148;34;50;6;80;1336
6;41015;Vale Frechoso;91;98;86;95;34;25;31;19;3;6;8.8239999999999998;24;15;17;18;1;3;2;3;9.8000000000000007;4.7000000000000002;5.0999999999999996;47.890000000000001;12;10;46;14;9;9;7;51;16;15;5;75;1225
6;90228;Vale Verde;45;50;41;49;21;7;20;4;1;3;4.7620000000000005;42.856999999999999;5;8;11;0;0;1;3;4.4000000000000004;2.1000000000000001;2.2999999999999998;61.869999999999997;1;3;20;7;14;1;3;16;10;20;10;136;1862
6;171227;Vales;131;126;122;115;65;19;59;13;6;6;9.2309999999999999;31.579000000000001;41;14;17;2;2;4;4;11.4;5.7999999999999998;5.5999999999999996;54.299999999999997;6;14;64;22;25;9;9;62;22;24;19;280;3836
6;50328;Vales do Rio;333;341;321;328;162;146;150;129;12;17;7.407;11.644;1;133;145;2;5;10;12;131.69999999999999;65.099999999999994;66.599999999999994;45.07;37;40;190;34;32;35;31;190;41;44;6;80;1337
6;141704;Valhascos;194;208;184;198;81;69;73;61;8;8;9.8770000000000007;11.593999999999999;6;31;97;4;3;4;5;48;23.199999999999999;24.899999999999999;48.140000000000001;30;20;88;26;30;24;17;87;38;42;16;242;3210
6;181512;Valongo dos Azeites;115;112;112;114;45;22;44;21;1;1;2.222;4.5449999999999999;37;8;20;0;0;1;1;49.799999999999997;25.199999999999999;24.600000000000001;44.270000000000003;16;14;61;16;8;17;10;59;16;10;20;297;4104
6;50429;Valverde;669;733;620;709;368;317;314;257;54;60;14.673999999999999;18.927;21;193;357;10;7;44;53;97.200000000000003;46.399999999999999;50.799999999999997;42.479999999999997;79;85;392;67;46;115;72;407;63;76;6;81;1370
6;141626;Vaqueiros;137;148;130;140;73;49;60;43;13;6;17.808;12.244999999999999;6;36;61;3;3;10;3;80.400000000000006;38.600000000000001;41.700000000000003;45.340000000000003;16;22;68;11;20;16;17;71;25;19;16;241;3205
6;80205;Vaqueiros;256;241;244;234;98;54;84;51;14;3;14.286;5.556;17;40;78;0;0;14;3;3.5;1.8;1.7;59.030000000000001;7;13;113;43;80;17;13;88;45;78;9;121;1757
6;130137;Várzea;189;194;192;191;93;52;68;28;25;24;26.882000000000001;46.154000000000003;5;51;40;2;10;23;14;68.700000000000003;33.899999999999999;34.799999999999997;43.899999999999999;24;29;101;20;15;17;26;105;22;24;15;207;2709
6;130329;Várzea;1380;1479;1325;1444;745;706;660;619;85;87;11.409000000000001;12.323;17;731;531;13;19;72;68;1016;490.39999999999998;525.60000000000002;36.859999999999999;273;207;763;82;55;257;192;843;109;78;15;209;2759
6;180523;Várzea de Abrunhais;199;206;182;199;92;58;82;50;10;8;10.869999999999999;13.792999999999999;16;39;77;1;2;9;6;69.200000000000003;34;35.200000000000003;45.799999999999997;27;23;103;25;21;17;24;106;32;27;20;287;3976
6;181513;Várzea de Trevões;85;89;82;87;42;20;39;18;3;2;7.1429999999999998;10;27;14;16;3;0;0;2;17.199999999999999;8.4000000000000004;8.8000000000000007;43.049999999999997;13;12;45;6;9;9;15;45;7;13;20;297;4105
6;181012;Varzielas;174;185;167;183;81;69;75;58;6;11;7.407;15.942;19;69;45;2;3;4;8;32.100000000000001;15.5;16.5;46.899999999999999;29;16;90;21;18;23;11;88;30;33;20;292;4046
6;91027;Vascoveiro;91;95;89;93;36;16;33;16;3;0;8.3330000000000002;0;9;13;27;1;0;2;0;10.300000000000001;5;5.2999999999999998;51.469999999999999;9;10;43;16;13;8;5;41;19;22;10;144;2042
6;171229;Vassal;209;251;201;236;81;53;73;46;8;7;9.8770000000000007;13.208;27;22;70;3;1;5;6;35;15.9;19.100000000000001;56.490000000000002;13;17;104;39;36;11;18;102;49;71;19;280;3838
6;101207;Vau;481;471;461;454;235;169;209;147;26;22;11.064;13.018000000000001;47;77;232;8;7;18;15;29.899999999999999;15.1;14.800000000000001;45.399999999999999;71;53;252;46;59;54;31;255;73;58;11;160;2266
6;171230;Veiga de Lila;127;134;126;126;47;24;46;22;1;2;2.1280000000000001;8.3330000000000002;23;14;31;0;0;1;2;18.199999999999999;8.9000000000000004;9.3000000000000007;51.060000000000002;12;10;55;20;30;8;15;69;24;18;19;280;3839
6;90748;Vela;226;264;213;258;67;65;55;54;12;11;17.91;16.923000000000002;7;22;80;1;2;11;9;23.300000000000001;10.800000000000001;12.6;58.829999999999998;16;19;88;35;68;17;17;86;38;106;10;141;1989
6;182411;Ventosa;376;418;358;395;171;152;158;137;13;15;7.6020000000000003;9.8680000000000003;34;140;121;1;1;12;14;43.299999999999997;20.5;22.800000000000001;49.490000000000002;36;38;200;40;62;40;36;194;67;81;20;306;4259
6;50327;Verdelhos;329;335;311;326;129;81;93;66;36;15;27.907;18.518999999999998;17;54;88;3;4;33;11;18.199999999999999;9;9.1999999999999993;49.850000000000001;34;40;158;47;50;42;21;124;76;72;6;80;1338
6;110409;Vermelha;619;669;577;651;317;236;287;209;30;27;9.4640000000000004;11.441000000000001;60;143;293;4;4;26;23;107.5;51.600000000000001;55.799999999999997;45.810000000000002;85;59;330;95;50;94;59;320;92;104;12;169;2354
6;130615;Vermoim;7607;8157;7228;7918;4340;4297;3776;3625;564;672;12.994999999999999;15.638999999999999;15;1766;5620;90;117;474;555;3821;1843.9000000000001;1977.2;38.299999999999997;1426;866;4519;518;278;1246;799;5054;591;467;15;212;2817
6;160919;Viana do Castelo (Monserrate);2295;2653;2321;2720;1148;1152;953;970;195;182;16.986000000000001;15.798999999999999;45;445;1433;41;43;154;139;2050;950.89999999999998;1099.2;45;293;268;1297;251;186;249;264;1411;347;382;18;267;3599
6;160931;Viana do Castelo (Santa Maria Maior);4929;5716;4767;5696;2518;2795;2212;2491;306;304;12.153;10.877000000000001;24;866;3813;71;58;235;246;2985.6999999999998;1382.5;1603.2;42.859999999999999;739;585;2813;408;384;677;541;3194;573;731;18;267;3600
6;170342;Vidago;570;634;512;582;268;221;231;174;37;47;13.806000000000001;21.266999999999999;7;67;331;9;16;28;31;188.5;89.299999999999997;99.299999999999997;46.109999999999999;86;65;294;64;61;66;66;308;73;121;19;271;3699
6;100615;Vidais;578;581;553;568;275;210;246;187;29;23;10.545;10.952;42;116;275;5;5;24;18;53.700000000000003;26.800000000000001;26.899999999999999;46.789999999999999;76;51;306;83;62;72;49;287;84;89;11;154;2215
6;91227;Vide;283;300;274;293;86;52;77;43;9;9;10.465;17.308;10;50;60;3;5;6;4;12.199999999999999;5.9000000000000004;6.2999999999999998;56.979999999999997;23;30;115;57;58;14;14;116;68;88;10;146;2110
6;60331;Vil de Matos;423;447;407;433;209;191;183;164;26;27;12.44;14.135999999999999;8;93;246;5;4;21;23;91;44.299999999999997;46.799999999999997;42.149999999999999;72;40;233;42;36;75;33;237;48;54;7;91;1506
6;20703;Vila Alva;231;283;230;278;82;74;72;64;10;10;12.195;13.513999999999999;14;27;95;2;5;8;5;13.800000000000001;6.2000000000000002;7.5999999999999996;55.060000000000002;17;18;103;38;55;25;24;104;48;82;3;45;406
6;40736;Vila Boa;44;46;46;46;15;3;13;2;2;1;13.333;33.332999999999998;6;3;6;0;1;2;0;9.8000000000000007;4.7999999999999998;5;57.030000000000001;3;4;22;8;7;2;1;16;14;13;5;72;1164
6;41229;Vila Boa de Ousilhão;98;86;95;84;28;19;24;15;4;4;14.286;21.053000000000001;6;10;23;1;2;3;2;22.199999999999999;11.800000000000001;10.4;57.619999999999997;2;8;42;18;28;6;8;32;15;25;5;77;1272
6;130138;Vila Caiz;1452;1574;1218;1519;851;505;768;387;83;118;9.7530000000000001;23.366;28;720;407;12;38;71;80;355;170.40000000000001;184.69999999999999;38.119999999999997;240;209;831;86;86;292;204;851;106;121;15;207;2710
6;160620;Vila Chã (Santiago);69;70;66;70;28;16;21;15;7;1;25;6.25;4;15;17;0;0;7;1;57;28.300000000000001;28.699999999999999;48.229999999999997;7;9;38;7;8;6;6;35;9;14;18;264;3496
6;30735;Vila Cova;96;123;91;124;38;31;35;17;3;14;7.8949999999999996;45.161000000000001;2;25;25;1;6;2;8;45;19.699999999999999;25.300000000000001;47.490000000000002;14;9;45;15;13;15;12;56;21;19;4;59;797
6;91228;Vila Cova à Coelheira;195;209;183;201;86;63;68;49;18;14;20.93;22.222000000000001;2;55;60;2;3;16;11;52.600000000000001;25.399999999999999;27.199999999999999;46.939999999999998;27;15;115;25;13;19;25;104;27;34;10;146;2111
6;130331;Vila Cova da Lixa;1810;2040;1736;1981;965;934;869;795;96;139;9.9480000000000004;14.882;27;607;1030;19;21;77;118;673.20000000000005;316.5;356.69999999999999;38.719999999999999;334;224;1023;137;92;329;227;1174;158;152;15;209;2761
6;181817;Vila da Ponte;243;227;242;228;112;67;102;58;10;9;8.9290000000000003;13.433;20;36;104;1;3;9;6;36.799999999999997;19;17.800000000000001;42.700000000000003;39;34;125;21;24;37;16;127;22;25;20;300;4154
6;40826;Vila de Ala;119;115;109;105;50;18;41;14;9;4;18;22.222000000000001;20;16;19;0;1;9;3;8.8000000000000007;4.5;4.2999999999999998;54.869999999999997;4;7;60;21;27;7;8;50;26;24;5;73;1191
6;101303;Vila Facaia;274;305;263;300;110;84;98;64;12;20;10.909000000000001;23.809999999999999;15;49;98;3;6;9;14;33.899999999999999;16.100000000000001;17.899999999999999;52.43;16;30;150;39;39;25;22;127;58;73;11;161;2269
6;90751;Vila Fernando;245;255;238;241;101;84;89;71;12;13;11.881;15.475999999999999;23;40;97;2;1;10;12;30.800000000000001;15.1;15.699999999999999;46.789999999999999;32;30;117;34;32;26;25;118;37;49;10;141;1992
6;91327;Vila Franca das Naves;475;490;450;471;227;212;204;175;23;37;10.132;17.452999999999999;21;113;245;2;15;21;22;90;44.299999999999997;45.700000000000003;45.060000000000002;72;57;242;51;53;46;57;247;65;75;10;147;2138
6;90752;Vila Franca do Deão;76;77;77;77;35;32;30;28;5;4;14.286;12.5;9;16;33;1;0;4;4;11.800000000000001;5.9000000000000004;5.9000000000000004;50.420000000000002;7;8;36;12;13;8;3;36;12;18;10;141;1993
6;90753;Vila Garcia;153;167;145;160;85;61;74;52;11;9;12.941000000000001;14.754;7;32;87;1;2;10;7;20.899999999999999;10;10.9;45.009999999999998;17;21;85;11;19;16;18;88;18;27;10;141;1994
6;91328;Vila Garcia;61;57;59;57;15;7;11;5;4;2;26.667000000000002;28.571000000000002;2;5;9;0;0;4;2;8.6999999999999993;4.5;4.2000000000000002;61.479999999999997;4;2;23;14;18;1;2;19;17;18;10;147;2139
6;60605;Vila Nova de Ceira;440;489;438;489;185;150;160;126;25;24;13.513999999999999;16;19;104;163;5;4;20;20;47.200000000000003;22.300000000000001;24.800000000000001;49.659999999999997;59;33;217;66;65;48;28;233;71;109;7;94;1539
6;182207;Vila Nova de Paiva;606;683;584;665;295;282;263;236;32;46;10.847;16.312000000000001;15;60;424;8;7;24;39;152.80000000000001;71.900000000000006;81;41.670000000000002;110;82;313;49;52;107;81;347;47;101;20;304;4214
6;90621;Vila Nova de Tazem;811;897;743;844;348;301;316;267;32;34;9.1950000000000003;11.295999999999999;44;174;365;3;3;29;31;107.09999999999999;50.799999999999997;56.200000000000003;46.109999999999999;111;100;409;91;100;100;99;427;134;137;10;140;1939
6;160217;Vila Praia de Âncora;2271;2549;2162;2477;1106;1017;977;889;129;128;11.664;12.586;105;428;1333;22;19;107;109;575.70000000000005;271.19999999999999;304.39999999999998;43.07;308;308;1252;230;173;292;295;1347;313;302;18;260;3398
6;171423;Vila Real (São Dinis);1855;2082;1848;2202;946;1014;847;906;99;108;10.465;10.651;27;178;1548;30;25;69;83;2668.5;1257.3;1411.2;41.210000000000001;297;229;1038;157;134;259;223;1193;188;219;19;282;3886
6;20704;Vila Ruiva;229;238;226;232;104;79;78;58;26;21;25;26.582000000000001;21;30;85;6;9;20;12;23.199999999999999;11.4;11.800000000000001;49.119999999999997;21;23;111;34;40;27;25;107;35;44;3;45;407
6;90754;Vila Soeiro;18;23;17;22;4;1;3;1;1;0;25;0;2;0;2;0;0;1;0;7.2999999999999998;3.2000000000000002;4.0999999999999996;69.340000000000003;;;7;3;8;;;5;7;11;10;141;1995
6;31357;Vila Verde;2245;2402;2101;2321;1220;1153;1084;979;136;174;11.148;15.090999999999999;16;579;1468;34;38;102;136;1493.2;721.39999999999998;771.79999999999995;36.030000000000001;449;301;1259;147;89;396;321;1389;160;136;4;64;971
6;170117;Vila Verde;306;316;303;303;123;74;113;66;10;8;8.1300000000000008;10.811;28;37;114;1;2;9;6;14.800000000000001;7.2999999999999998;7.5;50.200000000000003;28;28;163;43;44;30;20;148;70;48;19;269;3637
6;41230;Vila Verde;91;95;90;90;32;20;30;16;2;4;6.25;20;5;11;30;1;3;1;1;12.5;6.0999999999999996;6.4000000000000004;56.729999999999997;4;4;45;22;16;1;6;41;22;25;5;77;1273
6;71403;Vila Viçosa (Conceição);2008;2157;1870;2055;1033;968;920;841;113;127;10.939;13.119999999999999;37;478;1246;23;32;90;95;126.3;60.899999999999999;65.400000000000006;43.340000000000003;289;222;1137;200;160;263;211;1198;239;246;8;119;1737
6;90416;Vilar de Amargo;80;78;78;74;39;20;35;17;4;3;10.256;15;17;4;31;1;1;3;2;5.5999999999999996;2.7999999999999998;2.7999999999999998;54.640000000000001;5;5;40;13;17;5;4;33;14;22;10;138;1901
6;41232;Vilar de Ossos;131;138;124;122;58;36;49;31;9;5;15.516999999999999;13.888999999999999;15;31;34;1;1;8;4;15.199999999999999;7.4000000000000004;7.7999999999999998;50.670000000000002;9;13;67;20;22;9;19;62;28;20;5;77;1275
6;170628;Vilar de Perdizes (São Miguel);240;220;237;215;96;44;77;31;19;13;19.792000000000002;29.545000000000002;31;29;48;5;3;14;10;17.899999999999999;9.4000000000000004;8.5999999999999996;54.030000000000001;23;14;120;35;48;15;14;91;46;54;19;274;3756
6;41233;Vilar de Peregrinos;79;76;77;75;25;25;23;21;2;4;8;16;11;10;23;1;1;1;3;9.6999999999999993;4.9000000000000004;4.7999999999999998;56.25;7;8;29;21;14;1;7;34;15;19;5;77;1276
6;40827;Vilar de Rei;36;36;35;35;14;6;13;6;1;0;7.1429999999999998;0;6;2;11;0;0;1;0;5;2.5;2.5;55.719999999999999;2;3;18;4;9;1;2;17;9;7;5;73;1192
6;160749;Vilar do Monte;50;56;49;54;18;13;15;12;3;1;16.667000000000002;7.6920000000000002;5;11;11;0;0;3;1;33.299999999999997;15.699999999999999;17.600000000000001;44.829999999999998;10;3;27;4;6;7;2;28;9;10;18;265;3547
6;180906;Vilar Seco;371;374;362;370;179;114;157;98;22;16;12.291;14.035;17;101;137;0;3;22;13;73.400000000000006;36.600000000000001;36.799999999999997;47.509999999999998;44;40;194;43;50;41;31;186;57;59;20;291;4034
6;40119;Vilarelhos;123;152;121;148;65;47;58;39;7;8;10.769;17.021000000000001;28;24;45;3;2;4;6;22.800000000000001;10.199999999999999;12.6;50.909999999999997;11;14;63;19;16;16;12;68;21;35;5;66;998
6;40318;Vilarinho da Castanheira;188;227;177;220;59;40;49;35;10;5;16.949000000000002;12.5;29;13;42;2;1;8;4;14.699999999999999;6.7000000000000002;8;53.909999999999997;8;15;100;32;33;20;19;91;39;58;5;68;1066
6;170346;Vilarinho das Paranheiras;104;116;103;113;35;24;32;21;3;3;8.5709999999999997;12.5;1;18;34;0;0;3;3;48.299999999999997;22.899999999999999;25.5;47.659999999999997;12;12;51;18;11;11;15;47;21;22;19;271;3703
6;170119;Vilarinho de Cotas;75;71;63;68;41;29;38;19;3;10;7.3170000000000002;34.482999999999997;21;20;16;0;2;3;8;57.799999999999997;29.699999999999999;28.100000000000001;41.009999999999998;11;11;42;5;6;10;8;37;6;10;19;269;3639
6;171430;Vilarinho de Samardã;357;383;346;378;175;125;151;100;24;25;13.714;20;5;82;164;2;13;22;12;34.100000000000001;16.399999999999999;17.600000000000001;41.18;60;42;206;23;26;55;45;200;39;44;19;282;3888
6;170810;Vilarinho dos Freires;458;492;447;490;220;145;195;125;25;20;11.364000000000001;13.792999999999999;94;77;149;1;5;24;15;120.3;58;62.299999999999997;43.609999999999999;61;64;252;46;35;57;69;256;56;54;19;276;3776
6;40828;Vilarinho dos Galegos;91;99;89;101;42;13;42;12;0;1;0;7.6920000000000002;22;18;14;0;0;0;1;7.7000000000000002;3.7000000000000002;4;52.380000000000003;12;8;42;11;18;7;5;43;21;23;5;73;1193
6;181514;Vilarouco;154;174;158;175;78;22;75;19;3;3;3.8460000000000001;13.635999999999999;57;13;24;1;1;2;2;12.1;5.7000000000000002;6.4000000000000004;49.25;18;13;78;26;19;13;19;81;33;28;20;297;4106
6;160220;Vile;145;157;143;154;75;63;64;50;11;13;14.667;20.635000000000002;13;29;72;2;3;9;10;107.90000000000001;51.799999999999997;56.100000000000001;42.340000000000003;20;20;81;17;7;17;20;82;19;19;18;260;3401
6;160151;Vilela;92;104;90;104;32;25;31;25;1;0;3.125;0;13;19;24;0;0;1;0;59.899999999999999;28.100000000000001;31.800000000000001;55.68;5;7;41;20;19;7;2;52;18;25;18;259;3381
6;70206;Vimieiro;769;820;746;798;348;274;305;237;43;37;12.356;13.504;105;113;324;2;3;41;34;6.2999999999999998;3;3.2999999999999998;50.659999999999997;90;73;364;106;136;77;63;360;133;187;8;107;1660
6;40538;Vinhas;117;119;109;110;33;15;32;12;1;3;3.0299999999999998;20;16;7;21;0;0;1;3;7.2000000000000002;3.5;3.6000000000000001;58.18;5;6;58;25;23;6;9;47;26;31;5;70;1111
6;182309;Viseu (Coração de Jesus);5094;6151;5074;6175;2702;3265;2430;2949;272;316;10.067;9.6780000000000008;31;640;4708;65;69;207;247;4813.8999999999996;2180.6999999999998;2633.1999999999998;39.18;920;569;2940;378;287;795;646;3662;539;509;20;305;4246
6;182324;Viseu (Santa Maria de Viseu);3088;3702;3298;4170;1556;1669;1362;1457;194;212;12.468;12.702;16;443;2360;43;51;151;161;1936;880.5;1055.5;43.829999999999998;500;334;1658;315;281;431;320;1960;386;605;20;305;4247
6;160750;Vitorino das Donas;494;557;448;546;267;220;243;192;24;28;8.9890000000000008;12.727;15;214;206;6;7;18;21;235.40000000000001;110.59999999999999;124.7;40.719999999999999;74;67;279;43;31;86;65;296;51;59;18;265;3548
6;60410;Zambujal;189;213;175;202;85;75;71;67;14;8;16.471;10.667;2;25;111;2;3;12;5;21.800000000000001;10.300000000000001;11.6;49.560000000000002;28;12;94;25;30;21;14;100;32;46;7;92;1516
6;50517;Zebreira;421;452;417;451;123;75;110;67;13;8;10.568999999999999;10.667;45;23;109;3;0;10;8;8.4000000000000004;4.0999999999999996;4.4000000000000004;48.93;64;46;180;55;76;56;37;182;89;88;6;82;1387
6;141916;Zibreira;508;520;467;487;251;225;239;204;12;21;4.7809999999999997;9.3330000000000002;3;187;253;0;6;12;15;97.900000000000006;48.399999999999999;49.5;45.159999999999997;66;69;273;57;43;53;54;272;65;76;16;244;3243
6;111403;Cachoeiras;383;383;372;386;195;170;183;150;12;20;6.1539999999999999;11.765000000000001;20;75;238;0;1;12;19;77.599999999999994;38.799999999999997;38.799999999999997;44.93;56;35;218;46;28;46;26;218;49;44;12;180;2522
6;111404;Calhandriz;374;427;377;432;190;186;177;163;13;23;6.8419999999999996;12.366;1;99;240;3;3;10;20;111.90000000000001;52.299999999999997;59.700000000000003;44.920000000000002;49;37;210;43;35;53;45;232;45;52;12;180;2523
6;111406;Póvoa de Santa Iria;14249;15099;13519;14716;8554;8569;7781;7736;773;833;9.0370000000000008;9.7210000000000001;54;2670;12793;148;182;625;651;6379.1000000000004;3097.1999999999998;3281.9000000000001;35.359999999999999;2880;1610;8747;651;361;2777;1639;9414;730;539;12;180;2526
6;111409;Vila Franca de Xira;8579;9618;8334;9508;4504;4499;3925;3947;579;552;12.855;12.269;120;1546;6206;92;93;487;459;85.5;40.299999999999997;45.200000000000003;42.259999999999998;1370;914;4777;875;643;1346;927;5164;1139;1042;12;180;2531
6;111505;Falagueira;6820;7711;6568;7542;3273;3348;2689;2849;584;499;17.843;14.904;4;965;4569;89;94;495;405;9843.7999999999993;4620.1000000000004;5223.6999999999998;43.310000000000002;997;814;3621;862;526;1029;762;4047;1027;846;12;166;2327
6;111509;Alfornelos;4880;5559;4614;5386;2740;3042;2367;2683;373;359;13.613;11.801;11;644;4395;95;85;278;274;12357.5;5776.8999999999996;6580.6000000000004;40.390000000000001;626;700;2992;387;175;596;711;3505;415;332;12;166;2322
6;111511;Venda Nova;3904;4455;3713;4307;1824;1836;1519;1580;305;256;16.721;13.943;6;518;2575;43;42;262;214;7059.1999999999998;3296.9000000000001;3762.1999999999998;45.240000000000002;504;412;2092;511;385;547;429;2206;670;603;12;166;2331
6;111602;Famões;5431;5664;5143;5477;2941;2906;2593;2588;348;318;11.833;10.943;8;941;4232;68;64;280;254;2427.5999999999999;1188.3;1239.3;38.380000000000003;977;675;3140;451;188;892;681;3351;456;284;12;175;2461
6;111603;Odivelas;28131;31428;26521;30275;15650;16223;13769;14463;1881;1760;12.019;10.849;38;3932;24262;388;347;1493;1413;11717.6;5534.5;6183.1000000000004;40.039999999999999;4615;2957;16541;2591;1427;4369;3019;18429;3218;2393;12;175;2462
6;111604;Olival de Basto;2767;3045;2621;2932;1488;1392;1244;1202;244;190;16.398;13.649000000000001;4;470;1972;39;37;205;153;4284.3000000000002;2039.7;2244.5999999999999;43.359999999999999;379;305;1568;325;190;378;291;1687;364;325;12;175;2463
6;111607;Ramada;9392;10265;8902;9920;5443;5574;4933;5062;510;512;9.3699999999999992;9.1859999999999999;8;1420;8567;115;105;395;407;5582.1999999999998;2667.0999999999999;2915.0999999999999;37.659999999999997;1661;998;5699;681;353;1724;1038;6212;724;567;12;175;2466
6;120101;Alter do Chão;1120;1253;982;1118;512;489;453;412;59;77;11.523;15.746;100;136;629;16;23;43;54;16.899999999999999;8;8.9000000000000004;47.25;131;127;574;104;184;159;101;595;150;248;14;192;2587
6;120203;Mosteiros;240;216;227;211;119;72;104;66;15;6;12.605;8.3330000000000002;35;25;110;3;1;12;5;8.5999999999999996;4.5;4.0999999999999996;49.340000000000003;21;29;114;36;40;22;18;89;43;44;14;193;2593
6;120303;Avis;861;979;831;956;411;381;356;326;55;55;13.382;14.436;71;118;493;10;7;45;48;20;9.4000000000000004;10.6;46.149999999999999;100;89;461;103;108;127;98;484;115;155;14;194;2596
6;120308;Valongo;133;124;132;124;56;45;50;38;6;7;10.714;15.556000000000001;22;16;50;1;0;5;7;3.1000000000000001;1.6000000000000001;1.5;55.5;10;9;65;20;29;7;5;57;17;38;14;194;2601
6;120402;Nossa Senhora da Graça dos Degolados;296;291;288;305;151;109;131;88;20;21;13.244999999999999;19.265999999999998;25;71;123;5;4;15;17;16.399999999999999;8.3000000000000007;8.0999999999999996;43.57;43;39;158;24;32;33;30;145;39;44;14;195;2603
6;120504;São João Baptista;413;452;427;467;169;174;152;156;17;18;10.058999999999999;10.345000000000001;12;51;245;4;4;13;14;11.4;5.4000000000000004;5.9000000000000004;51.229999999999997;42;34;199;57;81;37;40;217;48;110;14;196;2608
6;120701;Ajuda Salvador e Santo Ildefonso;398;588;376;569;159;163;128;133;31;30;19.497;18.405000000000001;22;28;211;6;12;25;18;10.9;4.4000000000000004;6.5;51.630000000000003;57;42;184;51;64;57;45;213;82;191;14;198;2615
6;120703;Assunção;4175;4527;3973;4316;2113;2097;1796;1725;317;372;15.002000000000001;17.739999999999998;137;386;2998;73;101;244;271;1084.2;520.20000000000005;564.10000000000002;39.719999999999999;765;531;2274;334;271;714;523;2454;424;412;14;198;2617
6;120705;Caia e São Pedro;2002;2104;1908;2032;928;861;671;626;257;235;27.693999999999999;27.294;91;211;995;63;92;194;143;43.600000000000001;21.300000000000001;22.300000000000001;39.859999999999999;400;249;1008;189;156;362;248;1056;231;207;14;198;2619
6;120711;Vila Fernando;144;172;138;173;44;56;41;53;3;3;6.8179999999999996;5.3570000000000002;15;3;76;1;0;2;3;6.0999999999999996;2.7999999999999998;3.2999999999999998;55.079999999999998;17;14;59;12;42;17;8;64;19;64;14;198;2625
6;120801;Cabeço de Vide;492;571;455;538;225;221;192;169;33;52;14.667;23.529;54;75;232;4;11;29;41;16.199999999999999;7.5;8.6999999999999993;46.240000000000002;79;46;254;41;72;82;47;257;71;114;14;199;2626
6;121001;Beirã;245;253;246;254;102;90;93;79;9;11;8.8239999999999998;12.222;14;46;112;0;4;9;7;11.1;5.5;5.7000000000000002;50.969999999999999;25;25;117;38;40;19;22;115;48;49;14;201;2634
6;121003;Santo António das Areias;546;556;531;544;240;195;213;180;27;15;11.25;7.6920000000000002;27;77;289;6;7;21;8;30.600000000000001;15.199999999999999;15.5;49.439999999999998;48;53;290;75;80;52;48;274;77;105;14;201;2636
6;121101;Assumar;247;404;241;398;96;104;85;93;11;11;11.458;10.577;15;30;133;5;4;6;7;10.199999999999999;3.8999999999999999;6.2999999999999998;45.090000000000003;34;19;115;44;35;57;52;196;40;59;14;202;2638
6;121103;Santo Aleixo;319;319;313;310;156;110;141;96;15;14;9.6150000000000002;12.727;82;28;127;2;2;13;12;10.9;5.5;5.5;49.380000000000003;34;32;161;42;50;30;28;135;63;63;14;202;2640
6;121104;Vaiamonte;310;346;304;334;119;103;99;85;20;18;16.806999999999999;17.475999999999999;28;25;131;5;2;15;16;7.9000000000000004;3.7000000000000002;4.2000000000000002;47.700000000000003;47;27;131;36;69;51;35;135;45;80;14;202;2641
6;121207;Santana;185;219;160;204;44;28;41;27;3;1;6.8179999999999996;3.5709999999999997;6;17;45;0;1;3;0;14.9;6.7999999999999998;8.0999999999999996;64.060000000000002;6;8;76;47;48;6;4;58;59;92;14;203;2648
6;121303;Ponte de Sor;4285;4673;4018;4452;2177;1988;1714;1542;463;446;21.268000000000001;22.434999999999999;212;616;2428;46;71;417;375;51.600000000000001;24.699999999999999;26.899999999999999;42.799999999999997;655;478;2372;397;383;653;472;2489;479;580;14;204;2656
6;121304;Foros de Arrão;438;481;413;456;195;160;171;120;24;40;12.308;25;80;64;147;3;4;21;36;10.9;5.2000000000000002;5.7000000000000002;50.140000000000001;51;43;214;57;73;30;38;226;90;97;14;204;2652
6;121306;Vale de Açor;346;352;328;333;187;140;157;108;30;32;16.042999999999999;22.856999999999999;71;72;122;1;3;29;29;10.6;5.2999999999999998;5.2999999999999998;47.700000000000003;41;39;181;37;48;35;33;171;51;62;14;204;2658
6;121402;Alegrete;862;884;826;864;404;323;351;268;53;55;13.119;17.027999999999999;75;121;423;12;11;41;44;20.100000000000001;9.9000000000000004;10.199999999999999;49.640000000000001;79;74;445;130;134;92;62;436;137;157;14;205;2660
6;121409;Sé;5074;5581;4833;5485;2591;2724;2225;2326;366;398;14.125999999999999;14.611000000000001;56;749;3746;88;80;278;318;948.10000000000002;451.5;496.60000000000002;41.359999999999999;766;589;2932;467;320;771;497;3237;562;514;14;205;2667
6;121504;Sousel;899;1033;828;973;403;388;374;336;29;52;7.1959999999999997;13.401999999999999;53;133;524;5;9;24;43;21.600000000000001;10.1;11.6;45.289999999999999;149;86;438;97;129;143;91;482;142;175;14;206;2672
6;130101;Aboadela;353;430;317;410;169;97;156;75;13;22;7.6920000000000002;22.68;13;104;114;1;2;12;20;36.799999999999997;16.600000000000001;20.199999999999999;41.560000000000002;54;49;182;36;32;75;57;198;38;62;15;207;2673
6;130103;Ansiães;295;328;213;268;137;63;130;56;7;7;5.109;11.111000000000001;18;89;79;1;1;6;6;22.899999999999999;10.9;12.1;47.950000000000003;29;25;175;28;38;34;27;165;50;52;15;207;2676
6;130106;Canadelo;55;66;54;64;22;9;22;7;0;2;0;22.222000000000001;9;8;12;0;0;0;2;9.4000000000000004;4.2999999999999998;5.0999999999999996;53.950000000000003;5;6;28;12;4;3;1;33;14;15;15;207;2679
6;130109;Carvalho de Rei;87;100;84;99;37;32;29;23;8;9;21.622;28.125;12;20;20;0;1;8;8;25.699999999999999;12;13.800000000000001;46.600000000000001;9;9;48;13;8;13;8;52;11;16;15;207;2682
6;130110;Cepelos;860;898;821;883;466;438;419;378;47;60;10.086;13.699;15;185;597;12;18;35;42;481.19999999999999;235.40000000000001;245.80000000000001;38.960000000000001;163;100;485;68;44;156;89;512;84;57;15;207;2683
6;130113;Freixo de Baixo;695;739;658;720;347;286;316;225;31;61;8.9339999999999993;21.329000000000001;15;254;272;3;14;28;47;246;119.2;126.8;39.289999999999999;121;87;389;60;38;118;95;412;68;46;15;207;2688
6;130114;Freixo de Cima;1076;1127;1004;1067;574;470;524;399;50;71;8.7110000000000003;15.106;14;398;511;9;20;41;51;745.10000000000002;363.89999999999998;381.19999999999999;38.539999999999999;181;146;632;66;51;161;147;655;93;71;15;207;2689
6;130115;Fridão;418;445;407;435;236;153;223;113;13;40;5.508;26.143999999999998;14;167;155;2;19;11;21;109.7;53.100000000000001;56.600000000000001;40.060000000000002;62;57;248;31;20;63;58;246;32;46;15;207;2690
6;130121;Lufrei;852;925;786;878;452;346;418;295;34;51;7.5220000000000002;14.74;19;287;407;6;14;28;37;275.39999999999998;132;143.40000000000001;40.539999999999999;131;128;471;65;57;129;118;497;90;91;15;207;2697
6;130140;Vila Garcia;384;419;360;406;194;174;177;142;17;32;8.7629999999999999;18.390999999999998;8;135;176;4;10;13;22;224.80000000000001;107.5;117.3;37.799999999999997;75;44;220;26;19;77;44;239;34;25;15;207;2712
6;130204;Frende;324;332;268;318;167;117;134;76;33;41;19.760000000000002;35.042999999999999;15;74;121;5;21;28;20;226.19999999999999;111.7;114.5;42.829999999999998;43;44;187;31;19;37;32;199;35;29;15;208;2716
6;130206;Gove;985;1007;874;981;525;313;450;207;75;106;14.286;33.866;25;380;252;7;31;68;75;174.09999999999999;86.099999999999994;88;38.960000000000001;184;129;552;57;63;150;126;556;88;87;15;208;2718
6;130207;Grilo;293;297;230;279;159;87;135;53;24;34;15.093999999999999;39.079999999999998;10;119;59;3;19;21;15;99.299999999999997;49.299999999999997;50;37.689999999999998;50;55;149;23;16;47;54;146;25;25;15;208;2719
6;130212;Ribadouro;141;168;119;157;72;42;62;34;10;8;13.888999999999999;19.047999999999998;3;27;66;1;2;9;6;106.7;48.700000000000003;58;50.130000000000003;8;17;76;24;16;16;12;87;26;27;15;208;2724
6;130214;Baião (Santa Leocádia);272;282;225;268;137;81;121;55;16;26;11.679;32.098999999999997;6;89;81;2;10;14;16;128.40000000000001;63;65.400000000000006;40.909999999999997;36;39;154;21;22;40;43;146;27;26;15;208;2714
6;130215;Santa Marinha do Zêzere;1313;1483;1153;1429;710;442;617;314;93;128;13.099;28.959;38;395;498;20;66;73;62;259.30000000000001;121.8;137.5;40.509999999999998;205;159;741;120;88;233;193;763;152;142;15;208;2726
6;130216;Teixeira;276;319;249;306;94;44;81;37;13;7;13.83;15.909000000000001;11;46;61;1;4;12;3;27.600000000000001;12.800000000000001;14.800000000000001;46.960000000000001;34;35;130;43;34;36;31;158;54;40;15;208;2728
6;130217;Teixeiró;179;172;160;165;70;34;60;29;10;5;14.286;14.706;11;40;38;1;5;9;0;77.599999999999994;39.600000000000001;38;38.439999999999998;39;27;85;16;12;30;22;83;21;16;15;208;2729
6;130302;Airães;1170;1316;1107;1274;648;525;560;452;88;73;13.58;13.904999999999999;19;589;404;14;9;74;64;619.89999999999998;291.69999999999999;328.10000000000002;38.57;215;151;649;97;58;216;183;717;108;92;15;209;2734
6;130303;Borba de Godim;1097;1244;1023;1192;572;517;515;446;57;71;9.9649999999999999;13.733000000000001;23;425;513;12;13;45;58;302.19999999999999;141.59999999999999;160.59999999999999;40.009999999999998;194;141;608;84;70;177;160;663;127;117;15;209;2735
6;130307;Jugueiros;649;654;627;629;341;294;313;269;28;25;8.2110000000000003;8.5030000000000001;13;407;162;1;2;27;23;174.90000000000001;87.099999999999994;87.799999999999997;38.439999999999998;114;102;341;47;45;121;86;339;60;48;15;209;2739
6;130309;Lordelo;171;186;165;188;94;86;86;77;8;9;8.5109999999999992;10.465;6;108;49;1;2;7;7;236.09999999999999;113.09999999999999;123;37.759999999999998;35;23;90;14;9;30;22;105;15;14;15;209;2741
6;130317;Refontoura;1038;1043;967;1005;571;472;503;420;68;52;11.909000000000001;11.016999999999999;19;564;340;10;9;58;43;605.10000000000002;301.80000000000001;303.30000000000001;36.979999999999997;192;162;576;60;48;179;149;584;77;54;15;209;2750
6;130319;Revinhade;405;406;381;392;246;226;227;207;19;19;7.7240000000000002;8.407;3;325;106;1;4;18;15;243.90000000000001;121.8;122.09999999999999;35.530000000000001;66;80;228;18;13;64;74;226;23;19;15;209;2752
6;130320;Margaride (Santa Eulália);4633;5020;4568;5006;2567;2516;2298;2222;269;294;10.478999999999999;11.685;34;2240;2246;48;54;221;240;1647.7;790.79999999999995;856.89999999999998;37.539999999999999;842;705;2606;275;205;765;672;2896;363;324;15;209;2743
6;130326;Sousa;532;563;523;547;291;271;262;233;29;38;9.9659999999999993;14.022;3;243;249;3;9;26;29;603;293;310.10000000000002;37.350000000000001;97;94;283;36;22;83;90;308;44;38;15;209;2756
6;130332;Vila Fria;310;319;298;339;168;151;149;141;19;10;11.31;6.6230000000000002;5;236;49;0;2;19;8;325.10000000000002;160.19999999999999;164.90000000000001;38.109999999999999;55;45;171;15;24;57;43;175;23;21;15;209;2762
6;130403;Foz do Sousa;2969;3085;2824;3024;1582;1301;1401;1100;181;201;11.441000000000001;15.449999999999999;23;805;1673;29;54;152;147;317.5;155.69999999999999;161.80000000000001;42.600000000000001;404;336;1771;253;205;403;356;1723;290;313;15;210;2768
6;130408;Rio Tinto;23921;26792;22775;26073;12870;12936;10842;10648;2028;2288;15.757999999999999;17.687000000000001;62;4147;17281;359;402;1669;1886;5404.1999999999998;2549.0999999999999;2855.0999999999999;40.710000000000001;3901;2684;13953;2083;1300;3698;2707;15731;2427;2229;15;210;2774
6;130503;Boim;1546;1556;1451;1509;880;783;789;668;91;115;10.340999999999999;14.686999999999999;10;724;723;18;26;73;89;905.29999999999995;451.19999999999999;454.10000000000002;32.829999999999998;349;231;889;48;29;327;210;912;47;60;15;211;2780
6;130504;Caíde de Rei;1232;1297;1131;1260;645;516;559;432;86;84;13.333;16.279;15;533;443;18;21;68;63;375.60000000000002;183;192.59999999999999;38.75;221;187;691;74;59;199;151;726;110;111;15;211;2781
6;130505;Casais;691;710;670;703;409;352;346;309;63;43;15.403;12.215999999999999;2;427;226;4;14;59;29;569.29999999999995;280.80000000000001;288.5;36.770000000000003;125;115;393;30;28;111;111;400;43;45;15;211;2782
6;130511;Lustosa;2358;2434;2288;2401;1357;1238;1178;976;179;262;13.191000000000001;21.163;9;1536;609;15;19;164;243;412.10000000000002;202.80000000000001;209.30000000000001;35.189999999999998;459;378;1329;117;75;465;343;1366;144;116;15;211;2790
6;130521;Barrosas (Santo Estêvão);504;479;492;477;311;251;287;231;24;20;7.7169999999999996;7.968;9;412;97;2;2;22;18;229.90000000000001;117.90000000000001;112;34.68;102;81;273;27;21;94;76;251;36;22;15;211;2779
6;130522;Lousada (São Miguel);420;459;358;402;225;196;196;181;29;15;12.888999999999999;7.6530000000000005;11;246;120;8;2;21;13;345.80000000000001;165.19999999999999;180.59999999999999;38.159999999999997;70;64;230;38;18;81;61;252;42;23;15;211;2789
6;130523;Silvares;1534;1673;1461;1629;846;807;746;691;100;116;11.82;14.374000000000001;24;533;880;23;25;77;91;768;367.39999999999998;400.60000000000002;36.469999999999999;322;191;872;72;77;291;209;945;99;129;15;211;2798
6;130524;Sousela;869;928;832;904;492;420;436;343;56;77;11.382;18.332999999999998;13;514;252;9;13;47;64;267.19999999999999;129.19999999999999;138;35.740000000000002;193;122;472;52;30;174;130;507;63;54;15;211;2799
6;130604;Gemunde;2529;2686;2440;2650;1428;1314;1281;1103;147;211;10.294;16.058;28;865;1491;24;36;123;175;956.79999999999995;464;492.80000000000001;38.200000000000003;448;288;1534;165;94;422;292;1591;206;175;15;212;2807
6;130608;Milheirós;2350;2511;2247;2460;1308;1187;1150;999;158;188;12.08;15.837999999999999;10;642;1497;26;31;132;157;1348.7;652;696.70000000000005;38.969999999999999;417;263;1393;186;91;415;271;1459;198;168;15;212;2811
6;130609;Moreira;6248;6642;5966;6471;3554;3394;3138;2898;416;496;11.705;14.614000000000001;42;1410;4584;61;77;355;419;1486.3;720.39999999999998;765.89999999999998;38.149999999999999;1161;620;3730;477;260;1116;550;4037;522;417;15;212;2812
6;130611;Avioso (Santa Maria);2196;2317;2108;2256;1290;1197;1154;1001;136;196;10.542999999999999;16.373999999999999;31;588;1536;24;28;112;168;924.60000000000002;449.89999999999998;474.69999999999999;36.850000000000001;410;241;1339;135;71;390;225;1420;149;133;15;212;2803
6;130613;São Pedro Fins;901;936;891;937;481;420;432;342;49;78;10.186999999999999;18.571000000000002;33;258;483;2;3;47;75;390.30000000000001;191.40000000000001;198.90000000000001;39.590000000000003;173;99;510;76;43;144;101;545;80;66;15;212;2815
6;130704;Banho e Carvalhosa;619;657;494;639;321;205;286;159;35;46;10.903;22.439;23;267;155;5;17;30;29;259.69999999999999;126;133.69999999999999;40.710000000000001;102;82;349;47;39;100;69;354;63;71;15;213;2822
6;130705;Constance;802;824;690;779;443;336;394;250;49;86;11.061;25.594999999999999;18;374;252;6;13;43;73;339;167.19999999999999;171.80000000000001;37.75;144;125;437;48;48;134;121;453;53;63;15;213;2823
6;130711;Manhuncelos;238;248;222;247;124;66;104;55;20;11;16.129000000000001;16.667000000000002;1;78;80;1;2;19;9;112.3;55;57.299999999999997;36.030000000000001;49;38;131;10;10;56;29;119;18;26;15;213;2829
6;130723;Sobretâmega;556;576;502;562;285;232;241;164;44;68;15.439;29.309999999999999;7;213;185;4;13;40;55;398.69999999999999;195.80000000000001;202.90000000000001;38.310000000000002;109;80;305;36;26;91;56;337;58;34;15;213;2841
6;130729;Várzea da Ovelha e Aliviada;1081;1088;964;1045;579;341;521;266;58;75;10.016999999999999;21.994;21;317;449;7;19;51;56;151.40000000000001;75.400000000000006;75.900000000000006;39.829999999999998;183;159;606;71;62;166;128;584;106;104;15;213;2846
6;130808;Santa Cruz do Bispo;2846;2921;2718;2820;1365;1146;1123;941;242;205;17.728999999999999;17.888000000000002;10;552;1502;41;40;201;165;1571.5;775.5;796;42.43;344;357;1710;272;163;347;281;1721;298;274;15;214;2857
6;130904;Eiriz;1170;1133;1141;1114;675;539;589;481;86;58;12.741;10.760999999999999;4;741;325;9;8;77;50;382.30000000000001;194.19999999999999;188.09999999999999;35.450000000000003;258;177;648;51;36;215;143;653;61;61;15;215;2863
6;130905;Ferreira;2155;2186;2051;2121;1232;953;1070;829;162;124;13.148999999999999;13.012;12;1125;762;30;34;132;90;643.5;319.5;324.10000000000002;35.549999999999997;434;324;1206;103;88;402;333;1212;142;97;15;215;2864
6;130912;Paços de Ferreira;3615;3876;3491;3792;1971;1918;1694;1649;277;269;14.054;14.025;9;1299;2035;41;43;236;226;1903;918.39999999999998;984.70000000000005;35.979999999999997;764;489;2010;219;133;686;466;2245;281;198;15;215;2871
6;130916;Seroa;2209;1437;2137;1395;1214;636;1097;533;117;103;9.6379999999999999;16.195;5;617;1008;28;18;89;85;579.39999999999998;351;228.40000000000001;38.369999999999997;223;267;1540;122;57;235;173;820;119;90;15;215;2875
6;131002;Astromil;539;547;512;529;284;235;258;211;26;24;9.1549999999999994;10.212999999999999;1;180;288;3;4;23;20;563.20000000000005;279.5;283.69999999999999;36.149999999999999;108;70;307;31;23;115;46;323;30;33;15;216;2877
6;131003;Baltar;2352;2466;2234;2445;1346;1116;1182;936;164;180;12.183999999999999;16.129000000000001;33;917;1168;23;31;141;149;649.89999999999998;317.19999999999999;332.60000000000002;38;433;297;1378;143;101;388;268;1480;165;165;15;216;2878
6;131016;Mouriz;1452;1574;1389;1554;807;711;694;553;113;158;14.002000000000001;22.222000000000001;30;489;728;22;33;91;125;558.20000000000005;267.89999999999998;290.39999999999998;36.68;286;171;848;94;53;291;185;902;119;77;15;216;2891
6;131020;Sobreira;2106;2194;2032;2188;1215;952;1053;749;162;203;13.333;21.324000000000002;16;685;1101;22;47;140;156;195.80000000000001;95.900000000000006;99.900000000000006;37.270000000000003;354;290;1239;130;93;386;282;1249;169;108;15;216;2895
6;131108;Croca;887;880;942;970;465;398;409;368;56;30;12.042999999999999;7.5380000000000003;16;464;297;10;5;46;25;268.60000000000002;134.80000000000001;133.69999999999999;36.130000000000003;200;117;483;53;34;140;125;499;69;47;15;217;2907
6;131111;Figueira;190;216;184;206;94;83;80;66;14;17;14.894;20.481999999999999;3;65;78;0;5;14;12;71.200000000000003;33.299999999999997;37.899999999999999;35.560000000000002;48;24;94;16;8;46;26;113;15;16;15;217;2910
6;131113;Galegos;1334;1339;1285;1321;761;561;685;463;76;98;9.9870000000000001;17.469000000000001;9;588;551;7;11;69;87;585.5;292.19999999999999;293.30000000000001;36.490000000000002;261;196;746;78;53;237;161;770;94;77;15;217;2912
6;131115;Irivo;1077;1105;1028;1102;571;481;518;392;53;89;9.282;18.503;12;415;483;8;24;45;65;688.29999999999995;339.69999999999999;348.60000000000002;38.490000000000002;192;156;605;69;55;154;164;621;90;76;15;217;2914
6;131117;Luzim;394;423;350;407;222;128;190;107;32;21;14.414;16.405999999999999;9;206;82;3;4;29;17;127.8;61.600000000000001;66.200000000000003;36.490000000000002;81;63;198;29;23;87;62;201;29;44;15;217;2916
6;131119;Milhundos;854;939;794;920;468;456;415;404;53;52;11.324999999999999;11.404;7;341;471;10;13;43;39;388.69999999999999;185.09999999999999;203.59999999999999;38;162;129;485;46;32;140;132;524;58;85;15;217;2918
6;131120;Novelas;857;937;812;917;463;415;418;352;45;63;9.7189999999999994;15.180999999999999;10;312;448;9;12;36;51;738;352.60000000000002;385.5;38.789999999999999;160;110;478;62;47;144;121;531;76;65;15;217;2919
6;131122;Paço de Sousa;1906;1963;1810;1915;1038;849;923;708;115;141;11.079000000000001;16.608000000000001;21;557;1053;17;38;98;103;457.80000000000001;225.5;232.30000000000001;38.729999999999997;295;288;1099;149;75;296;242;1145;164;116;15;217;2921
6;131124;Penafiel;4064;4697;3793;4499;2186;2233;1931;1971;255;262;11.664999999999999;11.733000000000001;24;958;2920;58;53;197;209;1530.5;710;820.60000000000002;39.68;673;511;2368;292;220;673;565;2668;359;432;15;217;2923
6;131126;Pinheiro;1193;1238;1131;1257;671;498;584;402;87;96;12.965999999999999;19.277000000000001;17;570;399;14;23;73;73;507.19999999999999;248.90000000000001;258.30000000000001;36.549999999999997;243;154;672;72;52;226;172;696;78;66;15;217;2925
6;131131;Santiago de Subarrifana;481;525;450;511;274;232;248;197;26;35;9.4890000000000008;15.086;9;200;236;5;12;21;23;629.10000000000002;300.80000000000001;328.30000000000001;39.630000000000003;81;52;287;40;21;86;66;295;40;38;15;217;2933
6;131132;Recezinhos (São Mamede);718;721;665;696;362;283;321;228;41;55;11.326000000000001;19.434999999999999;10;311;228;10;12;31;43;338.5;168.90000000000001;169.59999999999999;37.200000000000003;144;109;379;53;33;128;86;403;64;40;15;217;2928
6;131134;Sebolido;458;454;429;452;243;166;226;143;17;23;6.9960000000000004;13.855;6;172;191;2;6;15;17;175.5;88.099999999999994;87.400000000000006;38.890000000000001;65;56;287;28;22;81;45;263;35;30;15;217;2934
6;131137;Vila Cova;397;422;371;409;201;164;181;145;20;19;9.9499999999999993;11.585000000000001;8;187;131;3;9;17;10;190;92.099999999999994;97.900000000000006;39.399999999999999;82;42;220;28;25;62;49;231;37;43;15;217;2937
6;131138;Rio Mau;699;715;669;703;368;278;322;242;46;36;12.5;12.949999999999999;8;230;326;5;10;41;26;230.30000000000001;113.8;116.40000000000001;40.609999999999999;114;68;430;51;36;106;60;431;55;63;15;217;2931
6;131203;Campanhã;15130;17529;14582;17264;6978;6633;5219;5100;1759;1533;25.207999999999998;23.111999999999998;24;1844;8451;316;302;1443;1231;4060.8000000000002;1881.2;2179.5;44.829999999999998;2035;1885;8341;1609;1260;1974;1850;9050;2233;2422;15;218;2940
6;131205;Foz do Douro;5098;5899;4824;5745;2528;2449;2259;2170;269;279;10.641;11.391999999999999;27;621;3781;50;45;219;234;5449.8000000000002;2526.4000000000001;2923.4000000000001;45.299999999999997;728;604;2700;655;411;680;571;3064;811;773;15;218;2942
6;131211;Ramalde;17311;20701;16636;20202;8789;9331;7336;7945;1453;1386;16.532;14.853999999999999;42;2164;13075;277;233;1176;1153;6525.6999999999998;2971.9000000000001;3553.8000000000002;42.729999999999997;2694;2048;9761;1517;1291;2726;1926;11440;2147;2462;15;218;2948
6;131213;São Nicolau;842;1064;922;1095;413;408;286;315;127;93;30.751000000000001;22.794;1;73;527;25;22;102;71;7613;3363.0999999999999;4249.8999999999996;46.329999999999998;108;94;484;74;82;113;106;521;139;185;15;218;2950
6;131214;Sé;1609;1851;1725;1980;746;653;549;485;197;168;26.408000000000001;25.727;2;175;857;38;37;159;131;7129.6000000000004;3315.5;3814.0999999999999;46.549999999999997;183;161;929;177;159;199;180;900;221;351;15;218;2951
6;131215;Vitória;837;1064;1019;1249;393;385;289;278;104;107;26.463000000000001;27.792000000000002;0;67;500;17;19;87;88;5788.8999999999996;2548.8000000000002;3240.0999999999999;48.310000000000002;95;84;481;92;85;77;102;495;150;240;15;218;2952
6;131419;Roriz;1791;1874;1722;1844;972;892;828;734;144;158;14.815;17.713000000000001;17;1034;511;11;16;133;142;594;290.30000000000001;303.69999999999999;41.210000000000001;259;240;1056;130;106;263;197;1079;159;176;15;220;2984
6;131420;Couto (Santa Cristina);1944;2120;1889;2101;1029;975;877;783;152;192;14.772;19.692;10;615;1035;18;23;134;169;531.79999999999995;254.40000000000001;277.39999999999998;42.479999999999997;273;219;1140;198;114;270;213;1227;223;187;15;220;2972
6;131422;Santo Tirso;6599;7508;6378;7379;3513;3530;2947;2964;566;566;16.111999999999998;16.033999999999999;31;1971;3909;97;89;469;477;1589;743.29999999999995;845.70000000000005;42.939999999999998;930;791;3806;618;454;919;704;4257;764;864;15;220;2985
6;131431;Sequeiró;797;830;761;803;394;346;302;246;92;100;23.350000000000001;28.902000000000001;4;286;258;20;15;72;85;689.29999999999995;337.69999999999999;351.69999999999999;43.130000000000003;110;80;487;71;49;104;78;477;94;77;15;220;2987
6;131432;Vilarinho;1874;1914;1792;1864;1015;974;854;776;161;198;15.862;20.329000000000001;4;1237;389;14;21;147;177;719.29999999999995;355.80000000000001;363.39999999999998;37.969999999999999;343;266;1064;134;67;284;282;1097;149;102;15;220;2988
6;131504;Sobrado;3262;3465;3157;3432;1779;1534;1467;1214;312;320;17.538;20.859999999999999;29;1278;1374;58;68;254;252;316.30000000000001;153.40000000000001;162.90000000000001;38.490000000000002;599;421;1867;246;129;546;438;1960;290;231;15;222;3000
6;131606;Canidelo;435;471;418;468;242;219;215;185;27;34;11.157;15.525;19;209;172;4;6;23;28;270.69999999999999;130;140.80000000000001;38.270000000000003;87;52;236;41;19;80;56;262;43;30;15;223;3007
6;131609;Fornelo;671;721;644;714;376;306;327;242;49;64;13.032;20.914999999999999;18;315;236;6;6;43;58;221.5;106.8;114.7;40.240000000000002;99;92;388;53;39;120;72;405;65;59;15;223;3010
6;131610;Gião;877;879;824;847;497;441;440;372;57;69;11.468999999999999;15.646000000000001;33;341;438;4;13;53;56;310.39999999999998;155;155.40000000000001;39.289999999999999;147;98;516;68;48;131;87;516;88;57;15;223;3011
6;131620;Parada;156;144;151;141;81;65;73;57;8;8;9.8770000000000007;12.308;16;59;55;3;2;5;6;101.2;52.600000000000001;48.600000000000001;40.560000000000002;32;19;83;14;8;16;18;80;17;13;15;223;3021
6;131621;Retorta;574;591;537;585;322;256;291;213;31;43;9.6270000000000007;16.797000000000001;38;176;290;4;9;27;34;363.30000000000001;179;184.30000000000001;38.149999999999999;95;83;337;33;26;108;60;335;53;35;15;223;3022
6;131623;Tougues;426;461;385;448;245;241;218;189;27;52;11.02;21.576999999999998;27;188;192;7;1;20;51;265.30000000000001;127.40000000000001;137.90000000000001;38.960000000000001;81;44;255;31;15;69;50;275;37;30;15;223;3024
6;131625;Touguinhó;663;723;600;692;370;327;336;272;34;55;9.1890000000000001;16.82;22;245;341;7;7;27;48;307.60000000000002;147.09999999999999;160.5;40.079999999999998;102;90;390;48;33;127;64;410;60;62;15;223;3026
6;131701;Arcozelo;6937;7415;6610;7216;3846;3642;3290;2995;556;647;14.457000000000001;17.765000000000001;48;1775;4462;88;110;468;537;1689.4000000000001;816.60000000000002;872.79999999999995;39.990000000000002;1215;707;4063;558;394;1126;660;4397;655;577;15;224;3032
6;131702;Avintes;5603;5894;5479;5781;2995;2656;2400;2046;595;610;19.866;22.966999999999999;17;1558;2871;82;99;513;511;1303.3;635.20000000000005;668.20000000000005;41.079999999999998;892;678;3241;438;354;836;647;3347;543;521;15;224;3033
6;131704;Canidelo;13362;14407;12606;13985;7367;7175;6207;5863;1160;1312;15.746;18.286000000000001;91;2405;9574;202;194;958;1118;3109.3000000000002;1496.2;1613.2;39.030000000000001;2334;1396;8056;1033;543;2171;1459;8787;1081;909;15;224;3035
6;131706;Grijó;5115;5463;4941;5376;2718;2321;2308;1812;410;509;15.085000000000001;21.93;33;1521;2566;59;82;351;427;933.60000000000002;451.39999999999998;482.10000000000002;39.770000000000003;866;592;2934;436;287;916;543;3096;493;415;15;224;3037
6;131710;Mafamude;17734;20810;16955;20316;9429;9988;7899;8252;1530;1736;16.227;17.381;25;2506;13620;291;307;1239;1429;7302;3359.5999999999999;3942.4000000000001;42.82;2587;2009;10183;1689;1266;2445;2081;11973;2072;2239;15;224;3041
6;131712;Oliveira do Douro;10651;11732;10122;11396;5744;5449;4686;4307;1058;1142;18.419;20.957999999999998;17;2047;6929;173;171;885;971;2970.0999999999999;1413.3;1556.8;40.990000000000002;1649;1270;6169;926;637;1690;1216;6752;1099;975;15;224;3043
6;131722;Valadares;5072;5606;4830;5436;2725;2570;2320;2106;405;464;14.862;18.053999999999998;21;1145;3260;69;84;336;380;2078.1999999999998;987.20000000000005;1091.0999999999999;40.799999999999997;858;500;2955;464;295;850;519;3195;550;492;15;224;3052
6;131723;Vilar de Andorinho;8820;9335;8818;10046;4593;4407;3686;3406;907;1001;19.747;22.713999999999999;17;1722;5353;162;194;745;807;2569.6999999999998;1248.4000000000001;1321.3;37.810000000000002;1627;1232;5063;570;328;1536;1153;5485;673;488;15;224;3054
6;131802;Bougado (Santiago);3133;3289;3034;3227;1727;1551;1521;1214;206;337;11.928000000000001;21.728000000000002;81;1391;1263;22;36;184;301;443.19999999999999;216.19999999999999;227;40.289999999999999;476;405;1841;266;145;439;431;1883;293;243;15;221;2990
6;131806;Covelas;753;783;729;779;429;362;371;286;58;76;13.52;20.994;54;326;277;10;11;48;65;103.7;50.799999999999997;52.899999999999999;40.280000000000001;114;105;429;68;37;114;94;443;68;64;15;221;2994
6;140102;Alferrarede;1857;2027;1767;1951;915;821;810;709;105;112;11.475;13.641999999999999;19;432;1068;15;20;90;92;161.5;77.200000000000003;84.299999999999997;43.869999999999997;295;178;1020;189;175;260;193;1051;252;271;16;225;3059
6;140106;Mouriscas;878;954;919;954;320;260;268;226;52;34;16.25;13.077;16;132;346;5;6;47;28;52.299999999999997;25.100000000000001;27.199999999999999;54.18;81;97;376;142;182;66;68;382;142;296;16;225;3066
6;140107;Pego;1189;1242;1139;1209;572;484;486;411;86;73;15.035;15.083;24;287;586;8;10;78;63;67.400000000000006;33;34.5;47.359999999999999;160;88;649;168;124;141;74;641;192;194;16;225;3067
6;140109;Rossio ao Sul do Tejo;955;1057;951;1067;468;413;416;344;52;69;11.111000000000001;16.707000000000001;8;224;528;10;8;42;61;306.80000000000001;145.59999999999999;161.19999999999999;45.240000000000002;137;99;514;96;109;146;92;511;144;164;16;225;3069
6;140111;Abrantes (São João);767;932;717;905;354;364;307;319;47;45;13.276999999999999;12.363;9;127;490;13;10;34;35;769.20000000000005;347.30000000000001;422;47.789999999999999;96;77;411;84;99;101;87;451;110;183;16;225;3056
6;140112;São Miguel do Rio Torto;1371;1498;1296;1447;608;494;511;415;97;79;15.954000000000001;15.992000000000001;47;317;562;20;15;77;64;54.799999999999997;26.199999999999999;28.600000000000001;50.490000000000002;142;145;687;209;188;122;113;732;237;294;16;225;3071
6;140113;Abrantes (São Vicente);5594;6028;5208;5756;2925;2952;2634;2580;291;372;9.9489999999999998;12.602;58;1235;3921;67;84;224;288;304.19999999999999;146.40000000000001;157.80000000000001;39.670000000000002;1017;599;3236;391;351;948;594;3463;490;533;16;225;3057
6;140114;Souto;200;218;197;208;87;49;76;42;11;7;12.644;14.286;2;59;57;3;0;8;7;31.899999999999999;15.300000000000001;16.699999999999999;53.68;15;13;111;36;25;11;16;82;50;59;16;225;3072
6;140116;Vale das Mós;300;288;282;277;147;104;115;77;32;27;21.768999999999998;25.962;52;54;86;0;0;32;27;24;12.300000000000001;11.800000000000001;51.840000000000003;28;18;173;32;49;19;21;143;35;70;16;225;3074
6;140118;Fontes;299;328;293;318;90;58;77;46;13;12;14.444000000000001;20.690000000000001;11;45;67;3;7;10;5;22;10.5;11.5;51.880000000000003;25;27;154;51;42;26;23;149;64;66;16;225;3064
6;140202;Bugalhos;537;547;515;533;279;224;244;195;35;29;12.545;12.946;4;171;264;6;6;29;23;65.900000000000006;32.600000000000001;33.200000000000003;43.990000000000002;65;62;309;54;47;75;52;294;62;64;16;226;3076
6;140208;Monsanto;436;450;415;437;225;172;212;157;13;15;5.7780000000000005;8.7210000000000001;9;192;168;1;3;12;12;48;23.600000000000001;24.399999999999999;47.920000000000002;55;31;238;57;55;44;34;225;62;85;16;226;3082
6;140302;Benfica do Ribatejo;1490;1577;1421;1533;760;637;634;521;126;116;16.579000000000001;18.210000000000001;312;267;576;10;8;116;108;104.8;50.899999999999999;53.899999999999999;45.549999999999997;230;134;790;188;148;185;124;795;247;226;16;227;3086
6;140503;Santo Estêvão;992;1005;944;990;495;429;438;382;57;47;11.515000000000001;10.956;60;147;613;5;12;52;35;32;15.9;16.100000000000001;40.590000000000003;194;116;519;93;70;167;99;544;103;92;16;229;3093
6;140601;Cartaxo;5422;5948;5087;5734;2920;2864;2564;2545;356;319;12.192;11.138;162;1067;3880;51;61;305;258;596.60000000000002;284.5;312.10000000000002;40.810000000000002;937;603;3018;500;364;872;567;3330;573;606;16;230;3094
6;140607;Vila Chã de Ourique;1353;1418;1266;1377;709;639;622;555;87;84;12.271000000000001;13.146000000000001;48;312;817;12;14;75;70;83.400000000000006;40.700000000000003;42.700000000000003;43.049999999999997;208;150;741;167;87;183;137;765;201;132;16;230;3101
6;140705;Vale de Cavalos;485;547;459;525;234;180;199;147;35;33;14.957000000000001;18.332999999999998;63;97;186;7;4;28;29;8.5999999999999996;4;4.5999999999999996;50.719999999999999;39;54;247;75;70;48;36;255;107;101;16;231;3108
6;140903;São José da Lamarosa;833;894;793;870;423;344;380;277;43;67;10.164999999999999;19.477;218;168;271;3;3;40;64;15.6;7.5;8.0999999999999996;50.859999999999999;80;67;442;116;128;77;54;438;156;169;16;233;3119
6;140908;Santana do Mato;575;573;565;576;292;211;262;193;30;18;10.274000000000001;8.5310000000000006;105;116;234;1;1;29;17;11.1;5.5999999999999996;5.5999999999999996;48.579999999999998;67;47;300;77;84;55;43;284;95;96;16;233;3118
6;141001;São João Baptista;3552;4024;3363;3946;1745;1703;1586;1488;159;215;9.1120000000000001;12.625;24;490;2560;35;40;124;175;1661.2;778.89999999999998;882.39999999999998;44.579999999999998;487;378;1907;469;311;485;357;2160;568;454;16;234;3121
6;141102;Areias;693;791;664;770;278;176;249;156;29;20;10.432;11.364000000000001;34;148;223;1;3;28;17;36.799999999999997;17.199999999999999;19.600000000000001;51.880000000000003;68;69;325;104;127;65;60;341;130;195;16;235;3123
6;141103;Beco;416;490;406;472;183;145;176;132;7;13;3.8250000000000002;8.9659999999999993;23;117;168;1;6;6;7;55.899999999999999;25.699999999999999;30.199999999999999;47.710000000000001;48;41;219;61;47;51;54;227;91;67;16;235;3124
6;141106;Ferreira do Zêzere;1136;1217;1097;1187;592;530;556;483;36;47;6.0810000000000004;8.8680000000000003;55;254;730;2;9;34;38;62;30;32.100000000000001;41.310000000000002;199;127;637;81;92;176;124;623;124;170;16;235;3127
6;141202;Golegã;1770;2075;1668;2000;890;841;810;755;80;86;8.9890000000000008;10.226000000000001;112;296;1157;14;15;66;71;100.09999999999999;46.100000000000001;54;45.289999999999999;254;199;939;197;181;273;164;1047;248;343;16;236;3132
6;141301;Aboboreira;251;262;247;257;101;69;88;61;13;8;12.871;11.593999999999999;8;56;85;1;4;12;4;18.800000000000001;9.1999999999999993;9.5999999999999996;53.579999999999998;27;17;124;32;51;15;22;104;51;70;16;237;3133
6;141303;Cardigos;499;587;491;598;177;130;159;111;18;19;10.169;14.615;13;95;162;5;6;13;13;15.300000000000001;7;8.3000000000000007;58.020000000000003;40;42;209;63;145;38;41;189;92;227;16;237;3135
6;141306;Mação;1055;1173;1012;1139;479;424;442;391;37;33;7.7240000000000002;7.7830000000000004;14;200;619;7;6;30;27;33.100000000000001;15.699999999999999;17.399999999999999;46.810000000000002;151;105;543;119;137;134;103;561;159;216;16;237;3138
6;141307;Ortiga;278;312;271;308;99;85;85;79;14;6;14.141;7.0590000000000002;5;37;122;5;1;9;5;36;17;19.100000000000001;52.950000000000003;28;26;123;53;48;28;22;124;51;87;16;237;3139
6;141402;Arrouquelas;285;306;272;294;130;97;107;90;23;7;17.692;7.2160000000000002;17;42;138;6;4;17;3;21.199999999999999;10.199999999999999;11;50.189999999999998;25;32;152;47;29;28;22;134;67;55;16;239;3160
6;141404;Azambujeira;230;228;232;225;116;86;109;76;7;10;6.0339999999999998;11.628;31;54;100;0;0;7;10;51.5;25.899999999999999;25.600000000000001;45.450000000000003;37;25;112;38;18;30;14;115;27;42;16;239;3164
6;141409;São João da Ribeira;439;453;409;440;220;184;197;165;23;19;10.455;10.326000000000001;39;96;227;2;2;21;17;72.700000000000003;35.799999999999997;36.899999999999999;45.450000000000003;59;47;241;52;40;55;39;231;65;63;16;239;3171
6;141413;Malaqueijo;209;229;203;224;105;83;92;75;13;8;12.381;9.6389999999999993;35;55;77;1;0;12;8;73.599999999999994;35.100000000000001;38.5;44.420000000000002;34;16;117;22;20;31;14;121;34;29;16;239;3166
6;141501;Glória do Ribatejo;1586;1638;1524;1610;811;666;653;468;158;198;19.481999999999999;29.73;108;434;579;15;7;143;191;60.200000000000003;29.600000000000001;30.600000000000001;46.280000000000001;172;130;953;189;142;178;122;904;243;191;16;240;3174
6;141506;Granho;435;448;410;438;241;186;213;142;28;44;11.618;23.655999999999999;29;131;195;2;1;26;43;28.399999999999999;14;14.4;44.450000000000003;54;38;246;61;36;66;43;226;63;50;16;240;3175
6;141602;Abrã;550;572;516;558;288;242;261;224;27;18;9.375;7.4379999999999997;11;237;237;4;4;23;14;50;24.5;25.5;43.539999999999999;91;54;299;57;49;79;40;310;61;82;16;241;3180
6;141605;Alcanhões;704;765;679;742;317;280;277;253;40;27;12.618;9.6430000000000007;30;124;376;5;6;35;21;128.30000000000001;61.5;66.799999999999997;46.43;95;54;394;74;87;108;62;383;84;128;16;241;3183
6;141614;Pernes;688;758;661;731;348;281;296;258;52;23;14.943;8.1850000000000005;30;141;383;6;4;46;19;102.90000000000001;48.899999999999999;53.899999999999999;48.909999999999997;79;75;373;64;97;70;58;360;99;171;16;241;3192
6;141615;Pombalinho;213;235;209;230;91;67;79;58;12;9;13.186999999999999;13.433;22;26;89;3;1;9;8;58.200000000000003;27.699999999999999;30.5;51.649999999999999;22;20;103;27;41;18;15;97;50;55;16;241;3193
6;141616;Póvoa da Isenta;553;574;539;576;258;217;229;187;29;30;11.24;13.824999999999999;28;87;301;3;3;26;27;81.099999999999994;39.799999999999997;41.299999999999997;45.189999999999998;76;41;322;73;41;74;58;279;75;88;16;241;3194
6;141622;São Vicente do Paul;880;955;834;930;410;351;369;317;41;34;10;9.6869999999999994;69;143;474;6;5;35;29;36.5;17.5;19;47.259999999999998;103;86;463;111;117;117;76;461;143;158;16;241;3201
6;141627;Várzea;897;920;859;899;448;403;399;356;49;47;10.938000000000001;11.663;33;162;560;6;6;43;41;85.299999999999997;42.100000000000001;43.200000000000003;43.939999999999998;145;90;492;95;75;130;71;486;117;116;16;241;3206
6;141807;Madalena;1626;1613;1520;1524;766;625;682;539;84;86;10.965999999999999;13.76;27;298;896;15;15;69;71;105.7;53.100000000000001;52.700000000000003;44.299999999999997;250;198;851;184;143;186;170;837;198;222;16;243;3218
6;141901;Alcorochel;391;419;358;396;191;151;165;142;26;9;13.613;5.96;8;100;199;4;0;22;9;94.299999999999997;45.5;48.799999999999997;49.530000000000001;32;40;209;52;58;52;31;204;47;85;16;244;3227
6;141907;Paço;353;331;333;315;171;120;157;113;14;7;8.1869999999999994;5.8330000000000002;1;85;184;1;0;13;7;90;46.399999999999999;43.5;46.649999999999999;42;45;185;40;41;27;28;176;55;45;16;244;3234
6;141911;Ribeira Branca;292;326;283;319;144;135;130;125;14;10;9.7219999999999995;7.407;4;90;161;2;5;12;5;79.900000000000006;37.799999999999997;42.200000000000003;47.18;40;19;160;35;38;31;34;168;41;52;16;244;3238
6;142002;Praia do Ribatejo;819;883;844;872;326;281;299;248;27;33;8.282;11.744;20;131;396;2;9;25;24;84;40.399999999999999;43.600000000000001;47.950000000000003;103;85;418;105;108;94;81;406;145;157;16;245;3246
6;142104;Caxarias;1029;1137;992;1123;533;435;503;388;30;47;5.6289999999999996;10.805;16;360;515;7;10;23;37;120.09999999999999;57.100000000000001;63.100000000000001;44.140000000000001;135;101;565;117;111;162;123;553;153;146;16;238;3144
6;142108;Freixianda;1168;1306;1135;1294;553;411;512;348;41;63;7.4139999999999997;15.327999999999999;24;392;444;11;15;30;48;79;37.299999999999997;41.700000000000003;45.030000000000001;180;154;572;143;119;143;156;595;202;210;16;238;3149
6;142111;Nossa Senhora das Misericórdias;2481;2596;2303;2485;1287;1103;1156;956;131;147;10.179;13.327;34;823;1255;18;28;113;119;124.8;61;63.799999999999997;42.07;400;313;1331;235;202;394;298;1341;256;307;16;238;3153
6;142116;Matas;446;498;428;469;217;183;210;174;7;9;3.226;4.9180000000000001;8;192;184;1;2;6;7;72.700000000000003;34.399999999999999;38.399999999999999;43.579999999999998;57;53;243;55;38;66;56;254;64;58;16;238;3151
6;150101;Alcácer do Sal (Santa Maria do Castelo);1972;2076;1925;2022;1047;903;946;798;101;105;9.6470000000000002;11.628;290;324;1130;11;14;90;91;9.3000000000000007;4.5;4.7999999999999998;43.759999999999998;286;222;1115;200;149;251;210;1108;257;250;17;246;3249
6;150302;Caparica;9846;10608;9649;10553;5035;4987;4004;4177;1031;810;20.477;16.242000000000001;63;1494;6624;191;157;840;653;1857.5;894.10000000000002;963.29999999999995;39.719999999999999;1734;1247;5513;832;520;1636;1147;5957;983;885;17;248;3260
6;150311;Feijó;8977;9907;8483;9549;4614;4867;4041;4248;573;619;12.419;12.718;24;1237;7028;108;120;465;499;4785.6000000000004;2275;2510.6999999999998;40.630000000000003;1543;951;5017;883;583;1502;976;5592;986;851;17;248;3264
6;150402;Lavradio;6854;7574;6505;7344;3460;3499;2974;2997;486;502;14.045999999999999;14.347;9;1198;4764;79;94;407;408;3581.5999999999999;1701.4000000000001;1880.2;41.189999999999998;1170;651;3829;757;447;1192;686;4168;863;665;17;249;3272
6;150404;Santo André;5538;5942;5238;5774;2776;2715;2386;2343;390;372;14.048999999999999;13.702;9;947;3773;70;56;320;316;2744.9000000000001;1324.2;1420.8;42.990000000000002;844;545;3097;688;364;789;516;3397;700;540;17;249;3274
6;150704;Sarilhos Grandes;1666;1758;1600;1724;901;717;766;633;135;84;14.983000000000001;11.715;156;348;895;15;14;120;70;291;141.59999999999999;149.40000000000001;43.590000000000003;228;163;942;177;156;259;169;906;212;212;17;252;3295
6;182109;Lajeosa;942;998;901;976;388;255;349;225;39;30;10.052;11.765000000000001;98;165;311;7;8;32;22;78.900000000000006;38.299999999999997;40.600000000000001;48.590000000000003;122;109;442;160;109;87;81;478;178;174;20;303;4190
6;182110;Lobão da Beira;547;577;518;561;275;185;240;165;35;20;12.727;10.811;39;141;225;6;3;29;17;79.799999999999997;38.799999999999997;41;47.270000000000003;61;68;290;71;57;62;46;284;89;96;20;303;4191
6;182111;Molelos;1098;1248;1039;1183;520;490;452;435;68;55;13.077;11.224;19;316;552;12;10;56;45;151.40000000000001;70.900000000000006;80.5;46.270000000000003;137;117;605;126;113;112;130;654;174;178;20;303;4192
6;182114;Mouraz;408;470;394;468;211;166;187;140;24;26;11.374000000000001;15.663;16;118;193;3;6;21;20;93.900000000000006;43.600000000000001;50.299999999999997;47.299999999999997;48;34;224;52;50;51;44;235;65;75;20;303;4195
6;182116;Parada de Gonta;358;396;336;375;164;117;151;102;13;15;7.9269999999999996;12.821;26;80;147;2;5;11;10;112.09999999999999;53.200000000000003;58.899999999999999;47.020000000000003;32;37;187;70;32;48;39;193;65;51;20;303;4197
6;182119;São João do Monte;429;433;395;410;226;167;213;137;13;30;5.7519999999999998;17.963999999999999;76;161;113;0;1;13;29;18.100000000000001;9;9.0999999999999996;49.299999999999997;36;45;234;63;51;28;52;222;67;64;20;303;4200
6;182121;Silvares;63;73;61;70;26;19;23;16;3;3;11.538;15.789;1;17;21;0;0;3;3;16.899999999999999;7.7999999999999998;9.0999999999999996;53.149999999999999;10;6;26;13;8;2;5;32;16;18;20;303;4202
6;182122;Tonda;459;525;426;500;213;174;188;151;25;23;11.737;13.218;13;103;223;2;6;23;17;131.09999999999999;61.200000000000003;70;44.719999999999999;63;58;239;54;45;66;52;253;72;82;20;303;4203
6;182202;Fráguas;105;112;111;121;28;23;28;23;0;0;0;0;1;23;27;0;0;0;0;12.6;6.0999999999999996;6.5;53.740000000000002;9;12;41;17;26;8;9;36;30;29;20;304;4209
6;182305;Calde;699;770;672;766;260;225;223;196;37;29;14.231;12.888999999999999;40;126;253;7;6;30;23;41.899999999999999;19.899999999999999;22;48.719999999999999;73;85;346;104;91;63;82;389;119;117;20;305;4219
6;182307;Cavernães;650;698;625;678;327;264;289;215;38;49;11.621;18.561;23;158;323;6;11;32;38;102.59999999999999;49.5;53.100000000000001;43.82;90;78;358;68;56;84;77;369;91;77;20;305;4221
6;182310;Cota;447;527;443;520;155;83;134;67;21;16;13.548;19.277000000000001;17;83;101;9;7;12;9;23.399999999999999;10.800000000000001;12.699999999999999;54.170000000000002;36;42;194;81;94;31;44;226;101;125;20;305;4223
6;182311;Couto de Baixo;347;409;332;395;166;144;132;118;34;26;20.481999999999999;18.056000000000001;5;56;189;3;10;31;16;67.099999999999994;30.800000000000001;36.299999999999997;44.600000000000001;57;31;182;47;30;58;41;194;59;57;20;305;4224
6;182312;Couto de Cima;420;431;386;407;201;174;173;146;28;28;13.93;16.091999999999999;9;73;237;0;4;28;24;64.799999999999997;32;32.799999999999997;44.57;61;39;245;46;29;46;41;240;51;53;20;305;4225
6;182319;Orgens;1675;1814;1571;1737;836;787;741;697;95;90;11.364000000000001;11.436;9;311;1118;13;21;82;69;392;188.19999999999999;203.80000000000001;41.049999999999997;279;181;938;173;104;268;207;1011;193;135;20;305;4231
6;182320;Povolide;836;911;807;885;399;320;373;264;26;56;6.516;17.5;31;274;332;5;10;21;46;84;40.200000000000003;43.799999999999997;45.039999999999999;104;99;439;111;83;118;94;467;122;110;20;305;4232
6;182321;Ranhados;2332;2617;2328;2710;1334;1370;1206;1252;128;118;9.5950000000000006;8.6129999999999995;17;349;2092;30;22;98;96;793.89999999999998;374.10000000000002;419.80000000000001;38.340000000000003;392;308;1368;152;112;407;281;1528;184;217;20;305;4233
6;182327;São João de Lourosa;2281;2421;2162;2332;1158;1035;1031;928;127;107;10.967000000000001;10.337999999999999;71;544;1344;21;24;106;83;180.80000000000001;87.700000000000003;93.099999999999994;39.159999999999997;428;277;1248;206;122;410;284;1334;222;171;20;305;4239
6;182334;Repeses;1202;1307;1335;1406;638;666;572;600;66;66;10.345000000000001;9.9100000000000001;5;164;1003;17;19;49;47;707.70000000000005;339.10000000000002;368.69999999999999;39.450000000000003;224;116;697;95;70;197;135;770;94;111;20;305;4234
6;182402;Cambra;588;656;545;625;266;238;248;210;18;28;6.7670000000000003;11.765000000000001;47;182;229;1;8;17;20;50.399999999999999;23.800000000000001;26.600000000000001;45.119999999999997;88;73;291;68;68;82;77;296;88;113;20;306;4250
6;182408;Paços de Vilharigues;315;332;292;311;161;135;150;122;11;13;6.8319999999999999;9.6300000000000008;28;95;149;1;4;10;9;74.099999999999994;36.100000000000001;38;43.759999999999998;44;33;172;37;29;41;40;173;43;35;20;306;4256
6;182410;São Miguel do Mato;457;467;428;452;181;156;150;132;31;24;17.126999999999999;15.385;8;127;147;2;5;29;19;102.59999999999999;50.799999999999997;51.899999999999999;46.509999999999998;59;53;230;59;56;53;47;237;65;65;20;306;4258
6;182412;Vouzela;603;747;591;755;303;333;275;303;28;30;9.2409999999999997;9.0090000000000003;5;149;424;6;5;22;25;258.89999999999998;115.59999999999999;143.19999999999999;44.049999999999997;96;60;321;70;56;105;91;355;84;112;20;306;4260
6;70603;Nossa Senhora do Bispo;2340;2591;2240;2503;1146;1110;1050;992;96;118;8.3770000000000007;10.631;213;368;1461;21;26;75;92;40.5;19.199999999999999;21.300000000000001;46.130000000000003;317;249;1193;258;323;288;241;1300;349;413;8;111;1703
6;70605;Santiago do Escoural;641;694;606;655;307;225;293;211;14;14;4.5600000000000005;6.2220000000000004;94;103;307;3;6;11;8;9.5999999999999996;4.5999999999999996;5;51.560000000000002;58;60;311;95;117;58;49;309;131;147;8;111;1704
6;70610;Foros de Vale de Figueira;525;545;507;535;253;206;234;191;19;15;7.5099999999999998;7.282;74;114;237;4;4;15;11;15.9;7.7999999999999998;8.0999999999999996;48.409999999999997;64;42;255;76;88;65;39;254;86;101;8;111;1700
6;70904;Oriola;183;217;175;209;94;87;91;75;3;12;3.1909999999999998;13.792999999999999;38;57;71;0;1;3;11;11;5.0999999999999996;6;45.210000000000001;30;18;92;19;24;25;25;105;27;35;8;114;1717
6;70905;Portel;1298;1363;1255;1368;616;534;540;471;76;63;12.337999999999999;11.798;130;119;762;15;11;61;52;17;8.3000000000000007;8.6999999999999993;45.039999999999999;192;144;673;141;148;170;120;664;185;224;8;114;1718
6;70906;Santana;259;283;246;264;113;102;98;82;15;20;13.274000000000001;19.608000000000001;76;38;66;0;2;15;18;12.9;6.2000000000000002;6.7999999999999998;48.079999999999998;34;23;125;29;48;30;23;146;45;39;8;114;1719
6;70908;Vera Cruz;230;228;222;228;122;84;92;57;30;27;24.59;32.143000000000001;46;36;67;1;3;29;24;10.300000000000001;5.2000000000000002;5.0999999999999996;44.969999999999999;37;17;129;22;25;30;25;110;24;39;8;114;1721
6;71002;Redondo;2798;2935;2693;2842;1468;1229;1317;1085;151;144;10.286;11.717000000000001;465;492;1445;14;33;137;111;18.600000000000001;9.0999999999999996;9.5;44.240000000000002;399;279;1547;280;293;348;308;1494;371;414;8;115;1723
6;71101;Campo;328;360;319;352;169;108;152;94;17;14;10.058999999999999;12.962999999999999;85;53;108;1;1;16;13;5.5999999999999996;2.7000000000000002;2.8999999999999999;49.509999999999998;39;30;175;33;51;39;27;144;52;98;8;116;1725
6;71202;Landeira;354;369;340;360;173;144;156;131;17;13;9.827;9.0280000000000005;34;96;157;3;2;14;11;11.199999999999999;5.5;5.7000000000000002;45.399999999999999;39;36;200;55;24;45;31;201;54;38;8;117;1729
6;71303;Aguiar;441;449;414;432;252;220;236;195;16;25;6.3490000000000002;11.364000000000001;31;84;316;0;5;16;20;28.699999999999999;14.199999999999999;14.5;39.380000000000003;73;50;255;25;38;75;54;238;40;42;8;118;1731
6;71402;Ciladas;525;546;502;539;259;201;232;171;27;30;10.425000000000001;14.925000000000001;67;136;200;0;2;27;28;10;4.9000000000000004;5.0999999999999996;46.780000000000001;60;60;258;67;80;68;46;264;85;83;8;119;1735
6;71405;Vila Viçosa (São Bartolomeu);385;473;364;462;171;172;150;148;21;24;12.281000000000001;13.952999999999999;11;73;214;5;5;16;19;4282.3999999999996;1921.5999999999999;2360.8000000000002;49.350000000000001;41;41;196;48;59;53;44;209;60;107;8;119;1738
6;80202;Giões;128;128;124;124;40;27;33;24;7;3;17.5;11.111000000000001;9;7;41;0;0;7;3;3.6000000000000001;1.8;1.8;58.109999999999999;16;4;44;29;35;7;6;45;30;40;9;121;1748
6;80204;Pereiro;108;105;110;104;44;19;40;17;4;2;9.0909999999999993;10.526;11;11;35;0;1;4;1;2.1000000000000001;1.1000000000000001;1.1000000000000001;60.039999999999999;4;5;50;24;25;2;6;44;23;30;9;121;1751
6;80303;Odeceixe;470;491;455;476;228;178;195;144;33;34;14.474;19.100999999999999;50;66;223;3;4;30;30;22.899999999999999;11.199999999999999;11.699999999999999;46.840000000000003;51;28;273;66;52;64;41;230;73;83;9;122;1760
6;80502;Estoi;1800;1852;1806;1895;879;764;746;696;133;68;15.131;8.9009999999999998;79;309;1054;17;5;116;63;78.400000000000006;38.600000000000001;39.799999999999997;44.579999999999998;229;190;1009;191;181;241;177;979;192;263;9;124;1767
6;80503;Santa Bárbara de Nexe;2034;2082;1965;2016;944;756;771;651;173;105;18.326000000000001;13.888999999999999;50;329;1043;32;25;141;80;108.40000000000001;53.600000000000001;54.899999999999999;47.409999999999997;263;185;1077;265;244;228;166;1063;292;333;9;124;1771
6;80706;Lagos (São Sebastião);6864;7185;6708;7083;3642;3444;3015;2903;627;541;17.216000000000001;15.708;112;1013;4793;79;68;548;473;709.29999999999995;346.5;362.69999999999999;40.25;1198;761;3864;558;483;1124;739;3974;706;642;9;126;1781
6;80804;Boliqueime;2422;2551;2373;2505;1179;1047;1004;895;175;152;14.843;14.518000000000001;56;305;1538;26;24;149;128;107.59999999999999;52.399999999999999;55.200000000000003;45.090000000000003;346;235;1295;283;263;340;218;1327;314;352;9;127;1788
6;80810;Benafim;516;553;443;492;224;180;189;163;35;17;15.625;9.4440000000000008;25;81;246;3;2;32;15;20.300000000000001;9.8000000000000007;10.5;51.710000000000001;55;29;248;87;97;49;32;248;119;105;9;127;1787
6;80902;Marmelete;406;381;398;374;155;89;139;79;16;10;10.323;11.236000000000001;42;46;130;2;2;14;8;5.5999999999999996;2.8999999999999999;2.7000000000000002;52.460000000000001;33;25;199;86;63;32;33;167;75;74;9;128;1796
6;81201;São Brás de Alportel;5232;5430;5043;5279;2650;2391;2289;2139;361;252;13.622999999999999;10.539999999999999;67;972;3389;49;39;312;213;69.5;34.100000000000001;35.399999999999999;43.5;812;530;2848;559;483;723;471;2895;608;733;9;131;1805
6;81307;Silves;5506;5508;5527;5482;2793;2475;2354;2118;439;357;15.718;14.423999999999999;280;689;3503;59;44;380;313;62.899999999999999;31.5;31.5;44.119999999999997;745;639;3048;523;551;694;503;2957;614;740;9;132;1812
6;81308;Tunes;1337;1323;1269;1267;733;628;611;520;122;108;16.643999999999998;17.196999999999999;14;168;949;13;16;109;92;220.19999999999999;110.7;109.5;38.310000000000002;257;126;770;106;78;249;127;729;111;107;9;132;1813
6;81403;Luz;1645;1710;1617;1704;796;663;633;543;163;120;20.477;18.100000000000001;142;265;769;16;11;147;109;107.2;52.600000000000001;54.600000000000001;47.100000000000001;209;161;856;229;190;205;118;889;226;272;9;121;1749
6;81404;Santa Catarina da Fonte do Bispo;911;898;923;903;413;279;363;253;50;26;12.106999999999999;9.3190000000000008;45;219;352;1;6;49;20;15.4;7.7999999999999998;7.5999999999999996;50.950000000000003;76;65;475;138;157;87;70;419;140;182;9;121;1752
6;81406;Tavira (Santiago);3054;3243;3076;3159;1544;1474;1297;1274;247;200;15.997;13.568999999999999;103;371;2097;40;33;207;167;292.19999999999999;141.69999999999999;150.5;42.950000000000003;505;335;1669;263;282;428;310;1800;289;416;9;121;1756
6;81407;Santo Estêvão;594;586;589;585;297;204;235;179;62;25;20.875;12.255000000000001;49;96;269;5;5;57;20;41.200000000000003;20.800000000000001;20.5;46.950000000000003;65;53;332;87;57;67;48;308;88;75;9;121;1754
6;81501;Barão de São Miguel;231;220;244;241;85;92;72;76;13;16;15.294;17.390999999999998;6;34;108;1;0;12;16;30.300000000000001;15.5;14.800000000000001;43.460000000000001;37;28;115;30;21;30;16;132;24;18;9;133;1814
6;81503;Raposeira;232;228;255;241;115;83;111;75;4;8;3.4779999999999998;9.6389999999999993;12;30;144;1;1;3;7;17.899999999999999;9;8.9000000000000004;49.240000000000002;19;16;132;28;37;25;18;103;39;43;9;133;1816
6;90104;Coruche;74;84;72;84;27;15;27;13;0;2;0;13.333;1;19;20;0;0;0;2;20.699999999999999;9.6999999999999993;11;54.219999999999999;8;4;31;17;14;9;6;30;17;22;10;135;1825
6;90107;Forninhos;101;121;101;122;31;20;28;16;3;4;9.6769999999999996;20;2;14;28;1;0;2;4;23.100000000000001;10.5;12.6;53.770000000000003;7;9;46;25;14;9;10;47;33;22;10;135;1828
6;90201;Ade;33;40;31;41;12;14;11;10;1;4;8.3330000000000002;28.571000000000002;7;4;10;0;0;1;4;9.6999999999999993;4.4000000000000004;5.2999999999999998;61.030000000000001;1;;16;7;9;;2;20;5;13;10;136;1835
6;90206;Cabreira;41;50;41;53;7;11;7;11;0;0;0;0;2;2;14;0;0;0;0;17;7.7000000000000002;9.4000000000000004;51.759999999999998;2;5;20;9;5;1;1;30;10;8;10;136;1840
6;90209;Freineda;110;128;109;125;39;25;31;25;8;0;20.513000000000002;0;12;9;35;1;0;7;0;8.0999999999999996;3.7999999999999998;4.4000000000000004;58.299999999999997;3;12;46;25;24;7;11;40;30;40;10;136;1843
6;90210;Freixo;88;94;86;94;34;32;31;27;3;5;8.8239999999999998;15.625;10;15;33;2;0;1;5;10.6;5.0999999999999996;5.5;45.939999999999998;14;8;40;13;13;15;7;44;17;11;10;136;1844
6;90212;Leomil;52;52;52;51;14;8;13;8;1;0;7.1429999999999998;0;8;5;8;0;0;1;0;7.7999999999999998;3.8999999999999999;3.8999999999999999;63.299999999999997;2;3;16;17;14;1;2;14;17;18;10;136;1846
6;90213;Malhada Sorda;138;196;136;198;49;46;46;42;3;4;6.1219999999999999;8.6959999999999997;7;19;62;0;2;3;2;7.2999999999999998;3;4.2999999999999998;57.57;11;7;64;20;36;12;12;65;44;63;10;136;1847
6;90216;Mido;20;26;23;29;5;0;5;0;0;0;0;0;1;3;1;0;0;0;0;4.9000000000000004;2.1000000000000001;2.7999999999999998;68.370000000000005;;1;7;1;11;;1;4;8;13;10;136;1850
6;90220;Naves;36;32;37;32;15;8;14;8;1;0;6.6669999999999998;0;3;7;12;0;0;1;0;4.9000000000000004;2.6000000000000001;2.2999999999999998;56.659999999999997;1;2;20;6;7;1;2;11;6;12;10;136;1854
6;90222;Peva;69;99;66;91;24;16;19;13;5;3;20.832999999999998;18.75;10;6;16;1;1;4;2;11.300000000000001;4.7000000000000002;6.7000000000000002;63.960000000000001;1;5;26;9;28;3;10;25;11;50;10;136;1856
6;90225;Senouras;18;20;18;20;6;3;6;2;0;1;0;33.332999999999998;4;2;2;0;0;0;1;4;1.8999999999999999;2.1000000000000001;65.129999999999995;;1;5;5;7;;1;6;7;6;10;136;1859
6;90229;Vilar Formoso;1053;1166;956;1104;505;485;463;424;42;61;8.3170000000000002;12.577;15;120;752;12;13;30;48;146.59999999999999;69.599999999999994;77;46.280000000000001;117;113;578;144;101;129;99;627;164;147;10;136;1863
6;90301;Açores;151;201;143;194;79;54;69;45;10;9;12.657999999999999;16.667000000000002;9;46;59;1;3;9;6;34.5;14.800000000000001;19.699999999999999;45.710000000000001;19;11;84;18;19;30;27;78;28;38;10;137;1864
6;90303;Cadafaz;65;75;63;73;25;16;22;16;3;0;12;0;8;11;19;0;0;3;0;16.399999999999999;7.5999999999999996;8.8000000000000007;53.82;5;9;28;12;11;8;5;24;17;21;10;137;1866
6;90305;Cortiçô da Serra;73;98;69;91;29;31;27;29;2;2;6.8970000000000002;6.452;4;15;37;0;1;2;1;35.700000000000003;15.300000000000001;20.5;50.880000000000003;6;8;36;9;14;8;8;42;22;18;10;137;1871
6;90307;Lajeosa do Mondego;327;371;303;362;160;158;142;134;18;24;11.25;15.19;11;61;204;2;0;16;24;56.399999999999999;26.399999999999999;30;46.530000000000001;42;26;189;36;34;45;23;201;33;69;10;137;1873
6;90310;Mesquitela;111;127;110;128;54;34;49;30;5;4;9.2590000000000003;11.765000000000001;22;22;35;1;0;4;4;14;6.5;7.5;49.140000000000001;14;12;50;19;16;13;11;53;25;25;10;137;1876
6;90317;Celorico (São Pedro);645;738;632;713;283;267;260;250;23;17;8.1270000000000007;6.367;17;98;395;3;4;20;13;97.599999999999994;45.5;52.100000000000001;45.049999999999997;90;64;336;81;74;109;77;340;94;118;10;137;1870
6;90321;Vila Boa do Mondego;47;60;49;60;17;19;17;17;0;2;0;10.526;2;9;23;0;0;0;2;9.3000000000000007;4.0999999999999996;5.2000000000000002;54.43;3;2;22;6;14;8;3;25;10;14;10;137;1885
6;90410;Mata de Lobos;174;209;164;197;65;42;60;41;5;1;7.6920000000000002;2.3810000000000002;47;7;47;1;0;4;1;10.4;4.7000000000000002;5.7000000000000002;56.439999999999998;15;19;70;31;39;13;17;65;41;73;10;138;1895
6;90412;Quintã de Pêro Martins;70;75;72;73;28;16;26;14;2;2;7.1429999999999998;12.5;11;13;16;0;1;2;1;7.7999999999999998;3.7999999999999998;4.0999999999999996;56.57;6;2;36;12;14;3;2;35;13;22;10;138;1897
6;90415;Vermiosa;189;205;180;191;81;54;70;42;11;12;13.58;22.222000000000001;75;9;28;1;0;10;12;9.8000000000000007;4.7000000000000002;5.0999999999999996;47.170000000000002;32;19;79;31;28;28;18;84;37;38;10;138;1900
6;90505;Fornos de Algodres;742;885;697;844;377;360;341;299;36;61;9.5489999999999995;16.943999999999999;9;105;526;11;14;25;47;105.3;48;57.299999999999997;45.229999999999997;90;90;389;84;89;106;102;432;109;136;10;139;1907
6;90506;Fuinhas;46;46;43;45;17;12;14;10;3;2;17.646999999999998;16.667000000000002;5;7;12;0;0;3;2;14.9;7.4000000000000004;7.4000000000000004;55.07;2;5;19;10;10;;7;21;8;10;10;139;1908
6;90507;Infias;119;123;111;117;62;50;56;40;6;10;9.6769999999999996;20;5;30;61;1;3;5;7;87;42.799999999999997;44.200000000000003;39.18;22;19;63;7;8;20;17;65;13;8;10;139;1909
6;90516;Vila Soeiro do Chão;85;94;80;92;31;20;29;14;2;6;6.452;30;2;17;24;0;1;2;5;40;19;21;52.850000000000001;8;11;33;20;13;8;6;41;20;19;10;139;1918
6;90602;Arcozelo;316;401;308;400;138;129;118;103;20;26;14.493;20.155000000000001;25;56;140;3;4;17;22;29.899999999999999;13.199999999999999;16.699999999999999;52.07;27;29;160;46;54;33;33;162;65;108;10;140;1920
6;90619;Vila Cortês da Serra;125;142;114;130;44;32;34;23;10;9;22.727;28.125;13;11;33;2;2;8;7;24.100000000000001;11.300000000000001;12.800000000000001;51.479999999999997;10;14;56;16;29;14;14;54;31;29;10;140;1937
6;90704;Aldeia Viçosa;166;175;159;171;69;59;61;54;8;5;11.593999999999999;8.4749999999999996;11;34;70;2;0;6;5;45.799999999999997;22.300000000000001;23.5;52.380000000000003;17;13;83;26;27;14;11;74;32;44;10;141;1944
6;90706;Arrifana;326;335;325;329;130;146;118;127;12;19;9.2309999999999999;13.013999999999999;5;52;188;3;2;9;17;41.799999999999997;20.600000000000001;21.199999999999999;41.850000000000001;74;45;158;31;18;40;23;192;32;48;10;141;1946
6;90714;Codesseiro;95;110;90;98;38;38;35;29;3;9;7.8949999999999996;23.684000000000001;6;17;41;0;1;3;8;21.300000000000001;9.9000000000000004;11.4;46.149999999999999;17;6;53;8;11;9;17;53;12;19;10;141;1954
6;90715;Corujeira;59;59;59;58;28;24;23;15;5;9;17.856999999999999;37.5;1;21;16;1;0;4;9;24.399999999999999;12.199999999999999;12.199999999999999;49.619999999999997;9;10;30;4;6;2;3;34;7;13;10;141;1955
6;90723;Maçainhas;531;550;498;530;275;249;238;207;37;42;13.455;16.867000000000001;11;124;310;5;5;32;37;88.599999999999994;43.5;45.100000000000001;44.600000000000001;64;55;316;49;47;56;59;310;68;57;10;141;1967
6;90732;Porto da Carne;175;210;157;196;74;71;66;52;8;19;10.811;26.760999999999999;2;28;88;0;1;8;18;194.09999999999999;88.200000000000003;105.90000000000001;51.170000000000002;19;19;82;16;39;19;22;88;16;65;10;141;1976
6;90739;Jarmelo (São Miguel);86;101;100;104;37;32;33;27;4;5;10.811;15.625;3;16;41;0;1;4;4;23.5;10.800000000000001;12.699999999999999;47.719999999999999;6;14;41;15;10;12;9;52;16;12;10;141;1964
6;90747;Valhelhas;201;195;179;187;104;80;94;67;10;13;9.6150000000000002;16.25;19;67;75;1;1;9;12;19.600000000000001;10;9.6999999999999993;48.329999999999998;15;27;113;15;31;14;20;103;23;35;10;141;1988
6;90755;São Miguel da Guarda;3843;4085;3611;3953;2098;2151;1850;1778;248;373;11.821;17.341000000000001;37;632;2959;38;43;210;330;855.79999999999995;414.80000000000001;441;37.399999999999999;765;446;2249;232;151;685;418;2457;245;280;10;141;1983
6;90801;Sameiro;162;181;156;179;75;51;66;36;9;15;12;29.411999999999999;7;32;63;0;1;9;14;15.6;7.4000000000000004;8.1999999999999993;49.93;11;18;85;31;17;14;20;86;34;27;10;142;1998
6;90901;Aveloso;107;100;103;97;50;26;46;24;4;2;8;7.6920000000000002;18;25;27;2;1;2;1;27.800000000000001;14.4;13.4;42.43;18;16;52;9;12;12;9;56;10;13;10;143;2000
6;90905;Coriscada;95;113;88;115;36;24;33;24;3;0;8.3330000000000002;0;13;14;30;0;0;3;0;8.3000000000000007;3.7999999999999998;4.5;60.270000000000003;3;6;47;18;21;5;5;38;22;43;10;143;2004
6;90910;Outeiro de Gatos;174;173;166;167;81;57;76;52;5;5;6.173;8.7720000000000002;11;35;82;0;0;5;5;25.300000000000001;12.699999999999999;12.6;43.710000000000001;25;21;90;27;11;25;15;88;29;16;10;143;2009
6;91010;Freixedas;421;484;413;478;164;106;156;101;8;5;4.8780000000000001;4.7169999999999996;24;82;151;1;3;7;2;27.300000000000001;12.699999999999999;14.6;51.840000000000003;35;36;205;65;80;42;46;197;95;104;10;144;2025
6;91016;Pereiro;74;76;74;77;27;23;23;21;4;2;14.815;8.6959999999999997;14;6;24;0;0;4;2;5.2000000000000002;2.6000000000000001;2.6000000000000001;57.899999999999999;5;3;30;12;24;7;3;26;18;22;10;144;2031
6;91026;Vale de Madeira;47;45;46;45;15;12;15;8;0;4;0;33.332999999999998;4;11;8;0;1;0;3;5;2.6000000000000001;2.5;49.840000000000003;6;2;25;9;5;5;5;20;7;8;10;144;2041
6;91101;Águas Belas;81;94;82;93;29;30;28;22;1;8;3.448;26.667000000000002;3;19;28;0;2;1;6;8.5;3.8999999999999999;4.5999999999999996;52.979999999999997;8;3;42;15;13;6;7;45;13;23;10;145;2043
6;91102;Aldeia do Bispo;125;161;124;162;36;27;36;23;0;4;0;14.815;4;20;35;0;2;0;2;21.800000000000001;9.5;12.300000000000001;64.239999999999995;4;8;47;25;41;6;4;44;28;79;10;145;2047
6;91107;Alfaiates;163;168;158;168;49;32;47;32;2;0;4.0819999999999999;0;4;30;45;2;0;0;0;10.5;5.2000000000000002;5.2999999999999998;57.350000000000001;11;14;68;33;37;15;5;60;37;51;10;145;2049
6;91113;Cerdeira;105;124;99;132;49;43;45;42;4;1;8.1630000000000003;2.3260000000000001;3;17;67;0;0;4;1;9.8000000000000007;4.5;5.2999999999999998;51.659999999999997;6;9;61;13;16;14;9;53;20;28;10;145;2055
6;91119;Moita;54;49;55;48;19;11;17;9;2;2;10.526;18.181999999999999;2;6;18;0;0;2;2;12.199999999999999;6.4000000000000004;5.7999999999999998;58.590000000000003;;3;23;13;15;2;4;18;11;14;10;145;2061
6;91123;Quadrazais;220;237;220;238;41;29;36;24;5;5;12.195;17.241;7;15;38;0;1;5;4;11.300000000000001;5.4000000000000004;5.7999999999999998;59.460000000000001;22;13;78;45;62;16;6;72;46;97;10;145;2065
6;91125;Rapoula do Côa;101;94;104;89;43;25;35;24;8;1;18.605;4;4;23;32;1;0;7;1;24.600000000000001;12.699999999999999;11.800000000000001;50.939999999999998;11;14;47;10;19;10;4;37;16;27;10;145;2067
6;91130;Sabugal;908;1035;843;969;464;450;429;404;35;46;7.5430000000000001;10.222;23;159;651;9;10;26;36;64.799999999999997;30.300000000000001;34.5;45;126;90;503;110;79;117;107;535;135;141;10;145;2072
6;91131;Santo Estêvão;147;163;146;157;47;34;38;31;9;3;19.149000000000001;8.8239999999999998;6;16;47;1;2;8;1;15.1;7.2000000000000002;7.9000000000000004;59.210000000000001;12;8;56;28;43;12;5;53;35;58;10;145;2073
6;91134;Souto;577;647;541;618;243;239;224;208;19;31;7.819;12.971;45;155;232;6;16;13;15;43.600000000000001;20.5;23;50.18;61;57;302;61;96;51;76;283;77;160;10;145;2076
6;91203;Carragozela;172;208;155;198;87;73;74;65;13;8;14.943;10.959;2;45;92;4;0;9;8;96.299999999999997;43.600000000000001;52.700000000000003;42.450000000000003;17;14;106;22;13;38;23;103;29;15;10;146;2085
6;91205;Girabolhos;151;166;143;164;39;24;35;24;4;0;10.256;0;6;22;31;1;0;3;0;17.899999999999999;8.5;9.4000000000000004;55.960000000000001;9;17;62;30;33;11;10;66;42;37;10;146;2087
6;91208;Paranhos;706;797;696;808;268;223;252;202;16;21;5.9699999999999998;9.4169999999999998;13;175;266;2;8;14;13;70.799999999999997;33.299999999999997;37.5;48.159999999999997;91;62;342;127;84;93;67;368;116;153;10;146;2091
6;91209;Pinhanços;352;364;345;351;172;143;154;119;18;24;10.465;16.783000000000001;15;75;183;7;4;11;20;86;42.299999999999997;43.700000000000003;45.390000000000001;40;46;192;30;44;48;25;197;46;48;10;146;2092
6;91211;Sameice;176;191;168;182;86;70;76;57;10;13;11.628;18.571000000000002;7;66;60;0;7;10;6;36;17.300000000000001;18.699999999999999;48.490000000000002;21;19;97;23;16;12;13;104;26;36;10;146;2094
6;91217;São Martinho;311;327;294;315;144;115;123;99;21;16;14.583;13.913;6;71;145;5;3;16;13;95.799999999999997;46.700000000000003;49.100000000000001;47.420000000000002;31;49;169;40;22;20;32;175;55;45;10;146;2100
6;91221;Teixeira;90;97;84;93;31;14;28;12;3;2;9.6769999999999996;14.286;5;12;23;0;1;3;1;11.800000000000001;5.7000000000000002;6.0999999999999996;55.780000000000001;5;11;35;22;17;5;8;34;18;32;10;146;2104
6;91229;Lapa dos Dinheiros;135;159;128;153;51;46;45;39;6;7;11.765000000000001;15.217000000000001;2;39;43;2;3;4;4;38.899999999999999;17.800000000000001;21;53.850000000000001;6;14;73;24;18;4;12;85;28;30;10;146;2089
6;91308;Freches;213;243;209;230;82;66;78;62;4;4;4.8780000000000001;6.0609999999999999;15;49;76;1;0;3;4;33.700000000000003;15.800000000000001;18;49.130000000000003;21;23;101;29;39;25;26;114;43;35;10;147;2119
6;91311;Moimentinha;106;123;96;113;37;29;30;24;7;5;18.919;17.241;3;20;31;2;2;5;3;34.299999999999997;15.9;18.399999999999999;49.479999999999997;14;10;52;15;15;13;7;55;26;22;10;147;2122
6;91312;Moreira de Rei;233;275;231;270;81;37;75;34;6;3;7.407;8.1080000000000005;4;48;57;0;1;6;2;15.4;7.0999999999999996;8.4000000000000004;53.189999999999998;18;27;109;38;41;19;17;116;57;66;10;147;2123
6;91319;Sebadelhe da Serra;66;64;66;64;15;13;14;13;1;0;6.6669999999999998;0;4;7;16;0;0;1;0;12.6;6.4000000000000004;6.2000000000000002;58.409999999999997;4;7;27;13;15;2;1;27;18;16;10;147;2128
6;91401;Almendra;194;192;191;189;79;52;78;46;1;6;1.266;11.538;45;23;56;0;1;1;5;7.0999999999999996;3.6000000000000001;3.5;52.590000000000003;17;23;92;31;31;12;17;80;29;54;10;148;2141
6;91402;Castelo Melhor;106;122;103;123;44;33;44;31;0;2;0;6.0609999999999999;16;13;46;0;2;0;0;6.2000000000000002;2.8999999999999999;3.2999999999999998;58.119999999999997;2;8;58;16;22;4;8;51;27;32;10;148;2142
6;91405;Custóias;93;109;88;103;30;21;30;20;0;1;0;4.7620000000000005;18;9;23;0;1;0;0;18.600000000000001;8.5999999999999996;10;59.149999999999999;6;6;34;32;15;3;4;43;36;23;10;148;2145
6;91407;Horta;118;124;111;121;58;34;54;31;4;3;6.8970000000000002;8.8239999999999998;35;10;40;2;2;2;1;24;11.699999999999999;12.300000000000001;48.490000000000002;10;12;63;14;19;12;13;57;26;16;10;148;2147
6;91409;Murça;46;61;42;56;15;10;14;6;1;4;6.6669999999999998;40;11;4;5;0;1;1;3;12.6;5.4000000000000004;7.2000000000000002;60.5;3;;18;13;12;3;2;20;25;11;10;148;2149
6;91411;Numão;106;134;102;136;57;26;54;24;3;2;5.2629999999999999;7.6920000000000002;38;18;22;1;0;2;2;10.4;4.5999999999999996;5.7999999999999998;49.770000000000003;13;6;54;19;14;13;16;56;20;29;10;148;2151
6;100101;Alcobaça;2624;3127;2429;2965;1278;1403;1135;1252;143;151;11.189;10.763;35;552;1800;34;31;109;120;1875.4000000000001;855.70000000000005;1019.7;42.740000000000002;458;303;1383;263;217;411;280;1695;331;410;11;149;2158
6;100107;Coz;910;985;868;943;466;419;422;369;44;50;9.4420000000000002;11.933;29;398;364;5;4;39;46;119.5;57.399999999999999;62.100000000000001;44.670000000000002;121;93;510;101;85;130;83;526;105;141;11;149;2166
6;100110;Pataias;2692;2759;2554;2660;1356;1154;1213;957;143;197;10.545999999999999;17.071000000000002;22;1067;1081;19;18;124;179;69;34.100000000000001;34.899999999999999;44.009999999999998;347;261;1543;316;225;344;247;1564;309;295;11;149;2171
6;100111;Aljubarrota (Prazeres);2055;2180;1932;2081;1043;957;948;833;95;124;9.1080000000000005;12.957000000000001;46;620;1115;19;32;76;92;156.59999999999999;76;80.599999999999994;41.82;351;205;1145;217;137;324;213;1195;220;228;11;149;2160
6;100115;Vestiaria;612;646;585;626;308;272;272;235;36;37;11.688000000000001;13.603;19;150;338;5;4;31;33;186.69999999999999;90.799999999999997;95.900000000000006;43.170000000000002;86;73;346;59;48;79;63;359;74;71;11;149;2174
6;100116;Vimeiro;980;968;934;952;492;373;450;344;42;29;8.5370000000000008;7.7750000000000004;92;275;427;9;5;33;24;96.599999999999994;48.600000000000001;48;44.530000000000001;137;119;507;121;96;114;106;500;121;127;11;149;2175
6;100203;Maçãs de Caminho;176;180;169;173;78;47;68;39;10;8;12.821;17.021000000000001;3;41;63;0;2;10;6;52.399999999999999;25.899999999999999;26.5;48.149999999999999;22;20;83;24;27;21;14;82;27;36;11;150;2178
6;100402;Reguengo do Fetal;1018;1151;961;1101;509;481;476;433;33;48;6.4829999999999997;9.9789999999999992;15;329;565;0;7;33;41;77;36.100000000000001;40.899999999999999;45.490000000000002;135;116;541;119;107;131;122;597;137;164;11;152;2193
6;100601;A dos Francos;815;886;791;870;376;319;334;289;42;30;11.17;9.4039999999999999;75;177;371;7;10;35;20;89.900000000000006;43.100000000000001;46.799999999999997;46.5;104;80;421;102;108;108;77;442;102;157;11;154;2200
6;100605;Coto;645;699;609;665;332;311;299;266;33;45;9.9399999999999995;14.468999999999999;12;122;431;5;10;28;35;238.40000000000001;114.40000000000001;124;40.890000000000001;116;77;350;52;50;121;68;381;62;67;11;154;2205
6;100606;Foz do Arelho;643;696;640;707;311;282;260;241;51;41;16.399000000000001;14.539;13;99;389;8;10;43;31;139.09999999999999;66.799999999999997;72.299999999999997;45.229999999999997;84;72;343;77;67;85;58;373;79;101;11;154;2206
6;100611;Santa Catarina;1481;1548;1384;1476;750;646;670;584;80;62;10.667;9.5980000000000008;68;569;617;17;11;63;51;151.59999999999999;74.099999999999994;77.5;43.090000000000003;227;168;802;160;124;216;177;792;178;185;11;154;2211
6;100702;Coentral;53;47;51;47;20;14;19;6;1;8;5;57.143000000000001;6;7;12;0;0;1;8;6.0999999999999996;3.2000000000000002;2.8999999999999999;52.420000000000002;5;4;25;11;8;2;4;25;10;6;11;155;2217
6;100803;Campelo;128;150;120;147;43;27;42;22;1;5;2.3260000000000001;18.518999999999998;2;20;42;0;1;1;4;5.4000000000000004;2.5;2.8999999999999999;54.32;11;12;55;20;30;12;11;56;31;40;11;156;2221
6;100904;Barosa;1066;1090;1018;1053;557;508;509;467;48;41;8.6180000000000003;8.0709999999999997;5;306;665;5;11;43;30;157.69999999999999;78;79.700000000000003;41.859999999999999;177;106;605;97;81;157;102;612;115;104;11;157;2227
6;100910;Colmeias;1556;1722;1458;1660;730;616;681;574;49;42;6.7119999999999997;6.8179999999999996;48;527;680;3;12;46;30;92.599999999999994;44;48.700000000000003;45.399999999999999;216;183;806;192;159;198;194;861;240;229;11;157;2236
6;100915;Milagres;1522;1549;1437;1478;831;681;778;612;53;69;6.3780000000000001;10.132;52;506;832;10;10;43;59;177;87.700000000000003;89.299999999999997;41.109999999999999;242;192;865;130;93;221;184;837;170;137;11;157;2242
6;100917;Monte Redondo;2178;2220;2065;2145;1163;946;1076;830;87;116;7.4809999999999999;12.262;100;849;957;21;33;66;83;96.900000000000006;48;48.899999999999999;40.560000000000002;353;280;1209;215;121;311;277;1234;209;189;11;157;2244
6;100920;Pousos;4724;5039;4565;4970;2663;2646;2454;2409;209;237;7.8479999999999999;8.9570000000000007;18;1256;3589;47;51;162;186;566.60000000000002;274.19999999999999;292.39999999999998;37.490000000000002;889;512;2785;337;201;862;527;2999;370;281;11;157;2247
6;100923;Santa Eufémia;1148;1179;1081;1110;615;539;584;492;31;47;5.0410000000000004;8.7200000000000006;11;409;656;12;13;19;34;224.40000000000001;110.7;113.7;41.630000000000003;182;153;622;103;88;163;151;637;110;118;11;157;2250
6;100926;Bidoeira de Cima;1113;1137;1042;1097;555;472;518;436;37;36;6.6669999999999998;7.6269999999999998;80;384;490;4;7;33;29;144.09999999999999;71.299999999999997;72.799999999999997;42.310000000000002;196;113;583;138;83;164;113;594;139;127;11;157;2229
6;101001;Marinha Grande;15147;16266;14359;15648;7838;7431;7119;6466;719;965;9.173;12.986000000000001;48;6683;6854;120;140;599;825;231.40000000000001;111.59999999999999;119.8;41.509999999999998;2385;1556;8755;1444;1007;2376;1441;9290;1667;1492;11;158;2252
6;101003;Moita;702;721;667;701;329;325;304;271;25;54;7.5990000000000002;16.614999999999998;6;332;237;4;10;21;44;168.09999999999999;82.900000000000006;85.200000000000003;41.25;121;97;378;63;43;99;71;408;74;69;11;158;2253
6;101102;Nazaré;4906;5403;4694;5332;2383;2277;2043;1870;340;407;14.268000000000001;17.873999999999999;180;754;2979;65;67;275;340;244.19999999999999;116.2;128;42.850000000000001;728;550;2769;538;321;681;542;2978;648;554;11;159;2256
6;101203;Olho Marinho;642;637;619;626;306;244;271;211;35;33;11.438000000000001;13.525;107;83;292;3;5;32;28;70.599999999999994;35.399999999999999;35.200000000000003;44.409999999999997;110;58;348;71;55;84;45;335;85;88;11;160;2263
6;101205;Óbidos (São Pedro);618;690;604;689;328;305;304;272;24;33;7.3170000000000002;10.82;65;94;417;6;10;18;23;127.59999999999999;60.299999999999997;67.299999999999997;42.719999999999999;94;62;344;66;52;116;53;375;84;62;11;160;2262
6;101209;Usseira;463;490;484;486;233;178;226;161;7;17;3.004;9.5510000000000002;83;55;249;2;3;5;14;131.59999999999999;64;67.700000000000003;43.420000000000002;72;57;245;52;37;64;49;247;70;60;11;160;2265
6;101503;Almagreira;1467;1609;1389;1551;681;545;639;502;42;43;6.1669999999999998;7.8899999999999997;59;521;561;8;4;34;39;72.200000000000003;34.399999999999999;37.799999999999997;46.090000000000003;205;138;762;195;167;198;133;807;248;223;11;163;2278
6;101506;Louriçal;2264;2456;2106;2347;1165;934;1066;842;99;92;8.4979999999999993;9.8499999999999996;107;847;954;15;26;84;66;98.400000000000006;47.200000000000003;51.200000000000003;44.390000000000001;280;277;1255;242;210;293;256;1303;304;300;11;163;2283
6;101507;Mata Mourisca;920;915;868;895;451;320;420;298;31;22;6.8739999999999997;6.875;57;336;325;6;7;25;15;68.799999999999997;34.5;34.299999999999997;45.119999999999997;122;118;481;110;89;104;82;480;140;109;11;163;2284
6;101514;Vila Cã;758;901;740;894;305;261;276;236;29;25;9.5079999999999991;9.5790000000000006;17;181;314;2;5;27;20;54.600000000000001;25;29.699999999999999;49.210000000000001;91;66;352;119;130;118;73;383;161;166;11;163;2292
6;101517;Ilha;950;981;900;949;464;343;427;296;37;47;7.9740000000000002;13.702999999999999;39;330;354;3;13;34;34;116.7;57.399999999999999;59.299999999999997;42.329999999999998;129;169;470;97;85;146;113;494;96;132;11;163;2282
6;101608;Mira de Aire;1802;1973;1671;1893;901;879;816;768;85;111;9.4339999999999993;12.628;5;696;883;7;11;78;100;241.59999999999999;115.3;126.3;44.270000000000003;264;176;997;194;171;256;191;1046;232;248;11;164;2300
6;101611;Porto de Mós (São João Baptista);1536;1608;1435;1544;768;737;710;655;58;82;7.5519999999999996;11.125999999999999;39;443;883;11;13;47;69;214.90000000000001;105;109.90000000000001;41.990000000000002;252;193;830;133;128;212;174;883;173;166;11;164;2302
6;110111;Alenquer (Santo Estêvão);3217;3470;3087;3392;1766;1652;1614;1456;152;196;8.6069999999999993;11.864000000000001;36;789;2245;26;39;126;157;416.19999999999999;200.19999999999999;216;39.350000000000001;595;321;1818;282;201;596;313;1945;311;305;12;165;2309
6;110113;Ventosa;1039;1134;993;1094;518;422;455;379;63;43;12.162000000000001;10.19;66;242;526;6;3;57;40;97.900000000000006;46.799999999999997;51.100000000000001;46.590000000000003;149;77;561;128;124;128;94;571;160;181;12;165;2320
6;110202;Arruda dos Vinhos;4258;4398;4076;4309;2305;2173;2160;1979;145;194;6.2910000000000004;8.9280000000000008;93;876;3170;24;33;121;161;251.80000000000001;123.90000000000001;127.90000000000001;38.240000000000002;904;422;2369;327;236;783;375;2474;367;399;12;167;2334
6;110302;Aveiras de Baixo;632;685;615;672;336;311;297;271;39;40;11.606999999999999;12.862;35;110;423;9;7;30;33;69.700000000000003;33.5;36.299999999999997;45.060000000000002;78;53;377;69;55;76;71;370;84;84;12;168;2338
6;110306;Vale do Paraíso;420;460;406;446;206;181;181;165;25;16;12.135999999999999;8.8399999999999999;14;95;237;1;4;24;12;198;94.5;103.5;47.740000000000002;44;39;235;54;48;50;36;225;80;69;12;168;2343
6;110309;Maçussa;178;210;172;204;62;54;52;52;10;2;16.129000000000001;3.7039999999999997;6;23;75;0;0;10;2;50.100000000000001;23;27.100000000000001;54.119999999999997;16;11;76;43;32;19;5;96;49;41;12;168;2341
6;110502;Carcavelos;10780;12567;10145;12034;5637;6193;5024;5575;613;618;10.875;9.9789999999999992;30;1204;9365;115;115;498;503;5177;2390.4000000000001;2786.6999999999998;41.539999999999999;1833;1105;6097;1031;714;1770;1079;7290;1282;1146;12;170;2357
6;110503;Cascais;16224;19185;15544;18479;8281;8521;7305;7471;976;1050;11.786;12.321999999999999;112;1524;13140;214;194;762;856;1742.4000000000001;798.29999999999995;944;42.880000000000003;2626;1905;8763;1697;1233;2487;1870;10527;2161;2140;12;170;2358
6;110505;Parede;9829;11831;9295;11447;4903;5268;4358;4709;545;559;11.116;10.611000000000001;23;1018;8026;109;112;436;447;6016.3999999999996;2730.1999999999998;3286.3000000000002;43.990000000000002;1678;976;5306;1022;847;1462;986;6388;1334;1661;12;170;2360
6;110603;Alto do Pina;4687;5646;4488;5487;2530;2552;2222;2316;308;236;12.173999999999999;9.2479999999999993;17;479;4042;56;43;252;193;12319.6;5588.1000000000004;6731.5;44.289999999999999;630;557;2660;434;406;621;535;3007;618;865;12;171;2364
6;110605;Ameixoeira;5568;6295;5270;6029;2866;2982;2295;2574;571;408;19.923000000000002;13.682;13;632;4224;118;102;453;306;7391.6000000000004;3469.3000000000002;3922.3000000000002;38.030000000000001;1024;697;3115;475;257;1060;673;3538;572;452;12;171;2366
6;110607;Beato;5763;6666;5567;6480;2833;2798;2317;2390;516;408;18.213999999999999;14.582000000000001;5;599;4103;76;94;440;314;7670.8999999999996;3556.8000000000002;4114.1000000000004;45.520000000000003;769;541;3160;747;546;738;602;3348;979;999;12;171;2368
6;110612;Castelo;158;197;157;196;83;77;64;64;19;13;22.891999999999999;16.882999999999999;0;16;112;0;2;19;11;6440.6999999999998;2866.5999999999999;3574.0999999999999;49.18;9;16;101;17;15;17;11;99;30;40;12;171;2373
6;110613;Charneca;4753;5182;4481;4988;2377;2427;1860;2076;517;351;21.75;14.462;4;588;3344;94;77;423;274;5866.6000000000004;2806.6999999999998;3060;36.880000000000003;1017;628;2559;335;214;909;657;2799;464;353;12;171;2374
6;110617;Lapa;3553;4447;3445;4335;1754;1870;1584;1723;170;147;9.6920000000000002;7.8609999999999998;24;246;3037;46;22;124;125;10806.299999999999;4799.3000000000002;6006.8999999999996;45;580;391;1822;374;386;562;368;2198;565;754;12;171;2378
6;110618;Lumiar;19140;22023;18182;21460;10417;11255;9521;10397;896;858;8.6009999999999991;7.6230000000000002;58;2022;17838;177;200;719;658;6705.6000000000004;3118;3587.5999999999999;40.369999999999997;3207;2250;10948;1612;1123;3122;2285;12693;1996;1927;12;171;2379
6;110623;Nossa Senhora de Fátima;6692;8591;7069;9045;3495;3733;3136;3407;359;326;10.272;8.7330000000000005;34;575;5934;78;74;281;252;8011.1000000000004;3507.8000000000002;4503.3000000000002;45.450000000000003;882;765;3622;699;724;946;801;4289;1054;1501;12;171;2384
6;110624;Pena;2166;2320;2299;2301;1204;1067;1000;943;204;124;16.943999999999999;11.621;7;204;1732;32;27;172;97;8971.2999999999993;4331.6999999999998;4639.6999999999998;45.369999999999997;246;244;1285;196;195;203;192;1209;292;424;12;171;2385
6;110627;Sacramento;357;385;383;419;210;189;188;166;22;23;10.475999999999999;12.169;0;29;325;3;2;19;21;8714.7000000000007;4192.8999999999996;4521.8000000000002;42.780000000000001;48;30;230;28;21;37;42;208;46;52;12;171;2388
6;110632;Santa Maria de Belém;3868;4673;3755;4547;1822;1906;1630;1742;192;164;10.538;8.6039999999999992;22;314;3036;38;20;154;144;2488.9000000000001;1127.0999999999999;1361.7;47.020000000000003;611;387;1939;471;460;483;349;2295;624;922;12;171;2393
6;110633;Santa Maria dos Olivais;24026;27010;23224;26419;11990;11668;10378;10413;1612;1255;13.445;10.756;31;2417;18343;307;284;1305;971;4548.5;2141.3000000000002;2407.1999999999998;43.899999999999999;3764;2549;12956;2254;2503;3582;2394;13676;3290;4068;12;171;2394
6;110637;Santos-o-Velho;1865;2155;1819;2147;1036;1002;891;881;145;121;13.996;12.076000000000001;12;173;1587;35;28;110;93;7569.1999999999998;3511.5999999999999;4057.5999999999999;43.780000000000001;244;219;1092;164;146;235;194;1127;238;361;12;171;2398
6;110639;São Domingos de Benfica;15194;18551;14938;18427;7780;8378;7066;7680;714;698;9.1769999999999996;8.3309999999999995;45;1491;13210;158;154;556;544;7831.6000000000004;3526.3000000000002;4305.3999999999996;45.039999999999999;2115;1618;8148;1838;1475;2063;1659;9832;2446;2551;12;171;2400
6;110641;São João;6790;8397;6618;8234;3495;3647;2902;3190;593;457;16.966999999999999;12.531000000000001;11;649;5432;90;84;503;373;10087.200000000001;4509.8999999999996;5577.3000000000002;46.380000000000003;787;725;3802;755;721;828;651;4290;1116;1512;12;171;2404
6;110649;São Paulo;1354;1374;1380;1380;758;664;666;577;92;87;12.137;13.102;5;100;1138;13;14;79;73;6212.1999999999998;3083.3000000000002;3128.9000000000001;44.079999999999998;160;125;847;119;103;124;113;755;172;210;12;171;2410
6;110650;São Sebastião da Pedreira;2877;3465;4415;4809;1552;1547;1419;1419;133;128;8.5700000000000003;8.2740000000000009;19;188;2631;29;31;104;97;5855.1000000000004;2656.0999999999999;3199;45.030000000000001;420;353;1565;249;290;380;321;1768;402;594;12;171;2411
6;110653;Socorro;1625;1440;1620;1442;963;562;783;475;180;87;18.692;15.48;1;168;1089;30;16;150;71;27646.200000000001;14657.5;12988.799999999999;43.659999999999997;176;172;1016;152;109;168;124;743;180;225;12;171;2414
6;110703;Camarate;9513;10276;9084;9887;4833;4790;3908;4041;925;749;19.138999999999999;15.637;10;1668;6271;153;125;772;624;3496.5;1680.8;1815.5999999999999;39.549999999999997;1705;1182;5241;921;464;1640;1274;5581;1024;757;12;172;2418
6;110707;Loures;13071;14291;12374;13868;7120;7228;6416;6474;704;754;9.8879999999999999;10.432;201;2254;10435;168;155;536;599;829.10000000000002;396.10000000000002;433;40.420000000000002;2146;1601;7436;1177;711;2068;1481;8211;1333;1198;12;172;2421
6;110712;Sacavém;8708;9761;8244;9368;4532;4652;3796;4002;736;650;16.239999999999998;13.972;5;1204;6589;136;148;600;502;4522.8999999999996;2132.5;2390.4000000000001;40.420000000000002;1481;911;4860;968;488;1450;991;5430;1110;780;12;172;2426
6;110724;Santo António dos Cavaleiros;12258;13623;11451;13010;6704;7225;5733;6281;971;944;14.484;13.066000000000001;18;1797;10199;222;203;749;741;7124.8999999999996;3374.5999999999999;3750.3000000000002;37.060000000000002;2394;1666;6912;855;431;2201;1617;8029;1060;716;12;172;2428
6;110808;Vimeiro;742;728;705;705;388;321;338;285;50;36;12.887;11.215;57;159;407;12;7;38;29;207.69999999999999;104.8;102.90000000000001;42.57;119;84;401;71;67;104;64;394;84;82;12;173;2442
6;110811;Atalaia;906;952;851;914;467;359;425;321;42;38;8.9939999999999998;10.585000000000001;79;185;482;10;7;32;31;249.5;121.7;127.8;41.789999999999999;134;104;492;93;83;153;103;480;110;106;12;173;2432
6;110905;Enxara do Bispo;847;893;830;875;454;365;421;334;33;31;7.2690000000000001;8.4930000000000003;105;202;448;6;5;27;26;96.400000000000006;46.899999999999999;49.5;41.100000000000001;146;102;453;94;52;135;89;482;93;94;12;174;2447
6;110906;Ericeira;4968;5292;4723;5108;2734;2543;2446;2249;288;294;10.534000000000001;11.561;62;888;3745;46;47;242;247;851.39999999999998;412.30000000000001;439.19999999999999;38.490000000000002;951;492;2878;416;231;918;498;3027;417;432;12;174;2448
6;110910;Malveira;3097;3396;2931;3277;1795;1741;1652;1566;143;175;7.9669999999999996;10.052;22;644;2552;27;31;116;144;664.20000000000005;316.80000000000001;347.39999999999998;37.219999999999999;626;302;1807;224;138;611;304;1970;248;263;12;174;2452
6;110914;Sobral da Abelheira;563;589;542;569;299;263;283;238;16;25;5.351;9.5060000000000002;58;147;316;3;4;13;21;74.599999999999994;36.399999999999999;38.100000000000001;41.850000000000001;98;58;292;73;42;76;65;317;64;67;12;174;2457
6;110917;São Miguel de Alcainça;877;887;842;858;484;443;446;398;38;45;7.851;10.157999999999999;8;203;633;9;12;29;33;249.5;124.09999999999999;125.5;36.960000000000001;191;81;510;54;41;171;87;508;63;58;12;174;2456
6;111006;Algés;10317;11956;9720;11449;5160;5519;4669;5014;491;505;9.516;9.1500000000000004;28;988;8667;102;93;389;412;11254.700000000001;5213.3000000000002;6041.5;42.920000000000002;1868;986;5438;1123;902;1686;951;6353;1470;1496;12;176;2467
6;111007;Cruz Quebrada-Dafundo;2896;3497;2836;3472;1484;1559;1309;1411;175;148;11.792;9.4930000000000003;13;329;2378;36;35;139;113;2192.5;993.20000000000005;1199.3;44.579999999999998;435;265;1570;366;260;464;279;1805;451;498;12;176;2471
6;111009;Porto Salvo;7250;7907;6894;7676;3715;3870;3135;3378;580;492;15.612;12.712999999999999;12;1025;5476;127;103;453;389;2064.1999999999998;987.29999999999995;1076.8;39.630000000000003;1299;915;4034;618;384;1257;827;4509;685;629;12;176;2475
6;111011;Caxias;4462;4545;4449;4401;2257;2247;1999;2030;258;217;11.430999999999999;9.657;13;526;3490;51;34;207;183;2640.5999999999999;1308.0999999999999;1332.5;40.350000000000001;767;561;2520;382;232;698;440;2606;385;416;12;176;2470
6;111103;Almargem do Bispo;4401;4582;4182;4463;2329;2075;2078;1838;251;237;10.776999999999999;11.422000000000001;212;966;2738;33;49;218;188;225.69999999999999;110.59999999999999;115.09999999999999;42.240000000000002;710;470;2432;475;314;675;450;2473;509;475;12;177;2479
6;111106;Montelavar;1740;1819;1660;1769;948;817;835;692;113;125;11.92;15.300000000000001;12;609;906;14;30;99;95;412.89999999999998;201.90000000000001;211;41.93;273;195;951;186;135;261;185;980;200;193;12;177;2487
6;111107;Queluz;12178;14070;11954;13650;6230;6472;5116;5464;1114;1008;17.881;15.574999999999999;13;1870;8697;186;181;928;827;7229.3000000000002;3354.0999999999999;3875.1999999999998;42.490000000000002;2000;1479;6490;1250;959;1865;1406;7406;1677;1716;12;177;2489
6;111114;Pêro Pinheiro;2083;2163;2102;2088;1109;955;950;828;159;127;14.337;13.298;20;678;1080;19;21;140;106;271.30000000000001;133.09999999999999;138.19999999999999;43.100000000000001;305;238;1143;213;184;294;216;1151;253;249;12;177;2488
6;111119;Cacém;10112;11177;9473;10766;5365;5652;4588;4897;777;755;14.483000000000001;13.358000000000001;19;1870;7596;141;148;636;607;9819.5;4664.1000000000004;5155.3999999999996;38.219999999999999;1933;1271;5687;791;430;1815;1353;6423;914;672;12;177;2481
6;111120;Mira-Sintra;2522;2758;2415;2672;999;967;784;805;215;162;21.521999999999998;16.753;3;317;1269;37;37;178;125;4573.1999999999998;2184.4000000000001;2388.8000000000002;45.600000000000001;361;261;1175;549;176;342;270;1289;646;211;12;177;2485
6;111301;A dos Cunhados;4190;4269;3907;4094;2282;1962;2079;1778;203;184;8.8960000000000008;9.3780000000000001;434;864;2559;36;30;167;154;190.80000000000001;94.5;96.299999999999997;40.93;677;467;2355;405;286;640;444;2374;419;392;12;179;2500
6;111303;Carmões;398;433;387;422;186;152;170;137;16;15;8.6020000000000003;9.8680000000000003;32;83;192;1;2;15;13;123.40000000000001;59.100000000000001;64.299999999999997;48.399999999999999;55;44;201;51;47;35;36;198;69;95;12;179;2502
6;111307;Matacães;513;574;497;550;237;202;215;183;22;19;9.2829999999999995;9.4060000000000006;22;109;267;3;1;19;18;80.799999999999997;38.100000000000001;42.700000000000003;47.630000000000003;75;41;273;67;57;70;42;262;83;117;12;179;2507
6;111310;Ponte do Rol;1163;1281;1120;1259;620;599;564;541;56;58;9.032;9.6829999999999998;82;283;740;15;7;41;51;252.69999999999999;120.2;132.40000000000001;40.68;173;147;642;113;88;203;139;704;126;109;12;179;2511
6;111311;Ramalhal;1725;1747;1650;1703;920;786;841;691;79;95;8.5869999999999997;12.087;109;469;954;18;10;61;85;94.299999999999997;46.799999999999997;47.399999999999999;42.039999999999999;280;200;932;178;135;252;162;953;183;197;12;179;2512
6;111318;Ventosa;2639;2637;2544;2573;1479;1086;1370;991;109;95;7.3700000000000001;8.7479999999999993;203;920;1238;16;26;93;69;203.09999999999999;101.59999999999999;101.5;42.009999999999998;388;333;1465;242;211;368;298;1398;292;281;12;179;2519
6;10105;Barrô;873;963;851;941;481;438;430;378;51;60;10.603;13.699;8;445;355;9;11;42;49;281.69999999999999;134;147.80000000000001;43.509999999999998;118;100;487;97;71;117;101;536;106;103;1;1;5
6;10106;Belazaima do Chão;277;322;270;317;160;132;150;123;10;9;6.25;6.8179999999999996;22;147;104;0;2;10;7;31.600000000000001;14.6;17;46.329999999999998;34;24;163;25;31;47;16;160;39;60;1;1;6
6;10107;Castanheira do Vouga;292;347;283;338;152;127;145;117;7;10;4.6050000000000004;7.8739999999999997;20;124;118;0;1;7;9;21.5;9.8000000000000007;11.699999999999999;44.140000000000001;43;30;164;29;26;50;31;174;44;48;1;1;8
6;10118;Trofa;1314;1418;1263;1415;699;626;662;537;37;89;5.2930000000000001;14.217000000000001;16;566;617;3;13;34;76;440.10000000000002;211.69999999999999;228.40000000000001;42.299999999999997;188;143;742;133;108;204;141;781;145;147;1;1;19
6;10119;Valongo do Vouga;2351;2526;2208;2407;1220;1063;1110;932;110;131;9.016;12.324;19;1015;1008;27;32;83;99;112.90000000000001;54.399999999999999;58.5;42.850000000000001;329;275;1324;234;189;355;278;1359;278;256;1;1;20
6;10207;São João de Loure;973;1036;941;1023;463;413;423;365;40;48;8.6389999999999993;11.622;35;358;395;7;7;33;41;184.30000000000001;89.299999999999997;95;42.469999999999999;150;115;521;104;83;154;110;543;110;119;1;2;27
6;10301;Amoreira da Gândara;513;544;494;529;238;199;203;166;35;33;14.706;16.582999999999998;25;198;146;2;8;33;25;116.8;56.700000000000003;60.100000000000001;47.649999999999999;64;56;267;57;69;48;56;281;75;84;1;3;30
6;10306;Mogofores;398;422;393;415;197;186;180;166;17;20;8.6289999999999996;10.753;4;128;214;0;3;17;17;385.30000000000001;187;198.30000000000001;45.119999999999997;56;41;215;46;40;44;48;221;54;55;1;3;35
6;10309;Sangalhos;1928;2140;1835;2074;990;905;890;794;100;111;10.101000000000001;12.265000000000001;25;751;908;18;14;82;97;240.69999999999999;114.09999999999999;126.59999999999999;44.159999999999997;265;231;1051;197;184;285;199;1144;226;286;1;3;39
6;10312;Vila Nova de Monsarros;827;886;776;867;435;342;401;303;34;39;7.8159999999999998;11.404;27;306;371;6;5;28;34;72.200000000000003;34.899999999999999;37.399999999999999;45.009999999999998;99;99;457;97;75;107;81;462;122;114;1;3;42
6;10314;Paredes do Bairro;466;528;449;517;237;209;217;199;20;10;8.4390000000000001;4.7850000000000001;37;190;189;1;1;19;9;151.5;71;80.5;45.869999999999997;53;45;267;56;45;59;55;277;72;65;1;3;38
6;10401;Albergaria da Serra;49;56;47;54;19;11;19;11;0;0;0;0;7;13;10;0;0;0;0;8.8000000000000007;4.0999999999999996;4.7000000000000002;51.780000000000001;4;3;27;6;9;6;4;26;7;13;1;4;44
6;10402;Alvarenga;621;602;587;593;270;146;256;126;14;20;5.1849999999999996;13.699;68;116;198;2;6;12;14;31.600000000000001;16;15.5;47.990000000000002;66;81;305;83;86;56;59;296;86;105;1;4;45
6;10404;Burgo;981;1012;905;984;517;398;480;362;37;36;7.157;9.0449999999999999;37;365;440;7;9;30;27;294.89999999999998;145.19999999999999;149.80000000000001;40.5;162;132;544;78;65;136;127;565;82;102;1;4;47
6;10406;Canelas;407;394;367;379;204;138;183;118;21;20;10.294;14.493;18;185;98;2;11;19;9;37.299999999999997;18.899999999999999;18.300000000000001;37.549999999999997;80;49;219;36;23;75;54;203;36;26;1;4;49
6;10414;Moldes;602;655;567;632;325;186;311;160;14;26;4.3079999999999998;13.978;43;233;195;3;5;11;21;44.899999999999999;21.5;23.399999999999999;41.509999999999998;85;80;346;39;52;107;76;336;70;66;1;4;57
6;10415;Rossas;788;811;749;783;390;312;365;284;25;28;6.4100000000000001;8.9740000000000002;19;299;331;5;8;20;20;143.90000000000001;70.900000000000006;73;40.469999999999999;128;113;442;60;45;108;105;437;81;80;1;4;58
6;10501;Aradas;4359;4798;4540;4981;2406;2425;2206;2169;200;256;8.3130000000000006;10.557;46;1220;3109;38;38;162;218;1025.7;488.30000000000001;537.39999999999998;40.850000000000001;677;453;2548;380;301;633;471;2816;464;414;1;5;64
6;10505;Esgueira;6405;7026;6023;6749;3636;3606;3227;3199;409;407;11.249000000000001;11.287000000000001;33;1712;4681;77;79;332;328;783.20000000000005;373.5;409.69999999999999;38.920000000000002;1121;755;3797;438;294;1032;807;4175;537;475;1;5;68
6;10508;Oliveirinha;2247;2570;2137;2496;1190;1070;1075;957;115;113;9.6639999999999997;10.561;54;729;1249;17;18;98;95;399.10000000000002;186.19999999999999;212.90000000000001;42.920000000000002;352;238;1269;193;195;356;275;1340;227;372;1;5;72
6;10513;Santa Joana;3863;4231;3679;4077;2003;1948;1781;1734;222;214;11.083;10.986000000000001;30;1007;2478;45;41;177;173;1384.7;660.89999999999998;723.79999999999995;41.140000000000001;599;455;2220;344;245;583;483;2407;413;345;1;5;74
6;10514;Nossa Senhora de Fátima;896;1028;853;991;491;446;445;389;46;57;9.3689999999999998;12.779999999999999;22;337;475;12;7;34;50;152.30000000000001;70.900000000000006;81.400000000000006;40.630000000000003;144;106;502;77;67;167;121;540;115;85;1;5;71
6;10608;São Martinho de Sardoura;954;977;864;943;537;366;475;260;62;106;11.545999999999999;28.962;11;427;297;7;36;55;70;447.80000000000001;221.19999999999999;226.59999999999999;36.969999999999999;171;133;553;49;48;182;141;529;64;61;1;6;85
6;10702;Espinho;4535;5297;4459;5248;2238;2232;1907;1843;331;389;14.789999999999999;17.428000000000001;16;738;2996;54;82;277;307;5566.6000000000004;2567.5999999999999;2999;46.719999999999999;593;434;2486;563;459;519;422;2844;754;758;1;7;88
6;10703;Guetim;665;738;642;721;334;286;271;226;63;60;18.861999999999998;20.978999999999999;5;220;272;6;6;57;54;721;341.80000000000001;379.30000000000001;43.299999999999997;89;85;367;75;49;95;79;414;84;66;1;7;89
6;10802;Beduído;3605;3939;3399;3780;1885;1766;1673;1502;212;264;11.247;14.949;30;1188;1957;56;54;156;210;367;175.40000000000001;191.59999999999999;41.090000000000003;619;423;1979;344;240;558;449;2169;405;358;1;8;93
6;10804;Fermelã;651;681;607;663;334;264;297;235;37;29;11.077999999999999;10.984999999999999;9;234;289;4;3;33;26;107.90000000000001;52.700000000000003;55.100000000000001;44;94;69;356;81;51;81;66;369;90;75;1;8;95
6;10806;Salreu;1820;1995;1752;1957;904;698;825;616;79;82;8.7390000000000008;11.747999999999999;52;545;844;8;8;71;74;230.69999999999999;110;120.59999999999999;45.789999999999999;255;203;946;205;211;234;181;997;269;314;1;8;97
6;10807;Veiros;1224;1279;1155;1247;652;507;574;425;78;82;11.962999999999999;16.173999999999999;50;475;474;15;17;63;65;221.80000000000001;108.5;113.3;40.009999999999998;215;157;682;99;71;197;171;675;105;131;1;8;98
6;10905;Espargo;752;807;729;792;410;375;352;312;58;63;14.146000000000001;16.800000000000001;3;236;425;8;6;50;57;338.39999999999998;163.19999999999999;175.19999999999999;39.170000000000002;135;66;445;65;41;146;74;463;71;53;1;15;153
6;10912;Louredo;626;699;591;683;334;284;302;252;32;32;9.5809999999999995;11.268000000000001;12;284;258;5;9;27;23;164.40000000000001;77.700000000000003;86.700000000000003;39.659999999999997;105;93;347;40;41;109;78;385;55;72;1;15;160
6;10913;Lourosa;4167;4469;3986;4372;2311;2072;1943;1591;368;481;15.923999999999999;23.213999999999999;28;1825;1681;40;41;328;440;1495.7;721.70000000000005;774;40.93;623;530;2445;367;202;612;497;2567;456;337;1;15;161
6;10914;Milheirós de Poiares;1870;1921;1800;1870;1032;939;949;854;83;85;8.0429999999999993;9.0519999999999996;12;979;812;12;19;71;66;482;237.80000000000001;244.30000000000001;39.490000000000002;303;267;1077;133;90;294;216;1100;165;146;1;15;162
6;10916;Mozelos;3476;3666;3376;3604;2001;1874;1764;1551;237;323;11.843999999999999;17.236000000000001;13;1686;1616;41;52;196;271;1229.4000000000001;598.29999999999995;631;38.310000000000002;634;383;2087;239;133;574;412;2179;278;223;1;15;164
6;10923;Sanfins;926;956;892;922;511;444;458;393;53;51;10.372;11.486000000000001;2;385;464;9;11;44;40;493;242.59999999999999;250.5;40.920000000000002;138;122;536;76;54;126;102;563;87;78;1;15;170
6;10925;Santa Maria de Lamas;2440;2633;2358;2586;1360;1254;1155;986;205;268;15.074;21.372;11;1200;930;37;42;168;226;1351.2;649.89999999999998;701.29999999999995;40.729999999999997;355;331;1452;179;123;347;287;1519;247;233;1;15;172
6;10926;São João de Ver;5190;5389;4947;5220;2932;2720;2531;2191;401;529;13.677;19.449000000000002;33;1961;2728;56;74;345;455;688.10000000000002;337.60000000000002;350.5;37.549999999999997;962;581;3108;337;202;902;539;3254;390;304;1;15;173
6;10930;Vale;879;1024;862;1003;465;386;421;345;44;41;9.4619999999999997;10.622;27;444;295;16;17;28;24;204.09999999999999;94.299999999999997;109.8;42.060000000000002;144;108;494;68;65;139;123;537;108;117;1;15;177
6;11002;Gafanha da Encarnação;2654;2833;2503;2764;1421;1236;1253;1071;168;165;11.823;13.35;190;735;1399;24;34;144;131;565.89999999999998;273.69999999999999;292.19999999999999;38.75;462;330;1531;226;105;449;324;1636;247;177;1;9;99
6;11108;Ventosa do Bairro;500;502;470;488;220;185;199;175;21;10;9.5449999999999999;5.4050000000000002;27;154;193;3;2;18;8;141.30000000000001;70.5;70.799999999999997;47.719999999999999;51;62;252;70;65;49;48;250;91;64;1;10;110
6;11201;Bunheiro;1287;1395;1216;1355;674;522;613;465;61;57;9.0500000000000007;10.92;135;387;556;7;6;54;51;108.2;51.899999999999999;56.299999999999997;43.359999999999999;184;152;688;156;107;192;148;696;186;173;1;11;111
6;11303;Fajões;1493;1594;1447;1567;804;683;743;625;61;58;7.5869999999999997;8.4920000000000009;16;854;498;11;14;50;44;380.69999999999999;184.09999999999999;196.59999999999999;40.229999999999997;246;192;837;114;104;255;183;873;149;134;1;12;117
6;11305;Macieira de Sarnes;924;1001;869;948;474;449;431;399;43;50;9.0719999999999992;11.135999999999999;4;500;326;3;9;40;41;497.60000000000002;238.80000000000001;258.69999999999999;42.539999999999999;114;125;534;95;56;135;124;561;96;85;1;12;121
6;11310;Ossela;1088;1120;1035;1079;581;433;539;393;42;40;7.2290000000000001;9.2379999999999995;15;570;347;11;9;31;31;123.5;60.799999999999997;62.600000000000001;43.240000000000002;138;140;622;94;94;145;130;599;125;121;1;12;124
6;11312;Pindelo;1264;1331;1217;1289;682;615;641;544;41;71;6.0119999999999996;11.545;7;798;380;7;16;34;55;339.60000000000002;165.40000000000001;174.19999999999999;41.509999999999998;196;161;721;110;76;178;139;766;125;123;1;12;126
6;11313;Pinheiro da Bemposta;1616;1708;1557;1660;892;730;823;632;69;98;7.7350000000000003;13.425000000000001;14;757;684;11;23;58;75;274.39999999999998;133.40000000000001;141;41.829999999999998;236;201;925;141;113;241;192;916;179;180;1;12;127
6;11405;Palhaça;1251;1376;1204;1344;658;583;590;510;68;73;10.334;12.521000000000001;26;424;650;12;15;56;58;262;124.8;137.30000000000001;42.119999999999997;203;141;654;132;121;203;140;712;160;161;1;13;138
6;11502;Cortegaça;1841;1996;1756;1957;1004;923;873;764;131;159;13.048;17.225999999999999;7;702;928;18;18;113;141;415.80000000000001;199.5;216.30000000000001;41.840000000000003;290;226;1026;189;110;255;212;1131;210;188;1;14;141
6;11503;Esmoriz;5544;5904;5303;5720;3119;2874;2664;2328;455;546;14.587999999999999;18.998000000000001;33;1999;2960;57;68;398;478;1248.8;604.79999999999995;644;39.270000000000003;986;591;3322;404;241;889;609;3508;497;401;1;14;142
6;11505;Ovar;8519;9336;8057;9027;4561;4445;3989;3782;572;663;12.541;14.916;54;2693;5024;94;112;478;551;371.39999999999998;177.19999999999999;194.19999999999999;40.490000000000002;1415;1023;4904;669;508;1358;934;5371;838;835;1;14;144
6;11506;São Vicente de Pereira Jusã;1114;1202;1066;1167;592;551;539;483;53;68;8.9529999999999994;12.340999999999999;46;553;423;7;18;46;50;269.5;129.59999999999999;139.90000000000001;42.130000000000003;186;139;611;109;69;156;135;652;129;130;1;14;146
6;11507;Válega;3302;3525;3191;3443;1806;1590;1574;1322;232;268;12.846;16.855;100;1270;1526;58;90;174;178;254.5;123.09999999999999;131.40000000000001;40.020000000000003;554;405;1876;256;211;540;407;1964;300;314;1;14;147
6;11601;São João da Madeira;10222;11491;9743;11091;5553;5617;5017;4923;536;694;9.6519999999999992;12.355;20;4478;5442;79;104;457;590;2733.5999999999999;1286.9000000000001;1446.7;41;1577;1237;5866;887;655;1549;1277;6632;1059;974;1;16;179
6;11704;Pessegueiro do Vouga;917;935;867;924;471;369;432;321;39;48;8.2799999999999994;13.007999999999999;17;372;364;3;9;36;39;116.8;57.799999999999997;59;44.32;135;103;489;105;85;114;96;497;101;127;1;17;184
6;11708;Talhadas;591;596;549;561;311;246;286;200;25;46;8.0389999999999997;18.699000000000002;21;259;206;6;10;19;36;41.399999999999999;20.600000000000001;20.800000000000001;44.990000000000002;77;54;337;50;73;63;71;306;79;77;1;17;188
6;11802;Covão do Lobo;454;532;432;512;241;210;226;189;15;21;6.2240000000000002;10;30;165;220;3;8;12;13;138.59999999999999;63.799999999999997;74.799999999999997;44.409999999999997;54;58;248;56;38;64;60;275;70;63;1;18;190
6;11805;Ouca;861;944;820;923;427;361;380;329;47;32;11.007;8.8640000000000008;75;223;411;14;4;33;28;110.90000000000001;52.899999999999999;58;46.560000000000002;104;100;448;101;108;114;79;453;119;179;1;18;193
6;11810;Santo André de Vagos;978;1055;952;1023;518;428;464;373;54;55;10.425000000000001;12.85;33;361;443;8;14;46;41;160.19999999999999;77;83.099999999999994;41.609999999999999;159;111;542;98;68;144;119;547;135;110;1;18;196
6;11811;Santa Catarina;478;513;455;503;238;209;220;192;18;17;7.5629999999999997;8.1340000000000003;17;164;231;3;6;15;11;142.69999999999999;68.900000000000006;73.900000000000006;43.719999999999999;53;66;268;55;36;64;60;265;71;53;1;18;195
6;20103;Messejana;431;461;422;454;218;138;182;114;36;24;16.513999999999999;17.390999999999998;41;74;181;0;2;36;22;7.7999999999999998;3.7999999999999998;4.0999999999999996;50.490000000000002;31;43;241;61;55;46;34;207;84;90;3;39;367
6;20201;Almodôvar;1857;1931;1805;1842;947;859;877;720;70;139;7.3920000000000003;16.181999999999999;73;435;1089;17;38;53;101;17.100000000000001;8.4000000000000004;8.6999999999999993;43.859999999999999;280;174;1010;202;191;261;193;1018;212;247;3;40;371
6;20202;Gomes Aires;196;159;202;157;59;32;54;28;5;4;8.4749999999999996;12.5;18;18;46;0;0;5;4;5.4000000000000004;3;2.3999999999999999;52.850000000000001;20;24;80;36;36;10;11;72;26;40;3;40;372
6;20203;Rosário;298;310;296;311;138;88;131;80;7;8;5.0720000000000001;9.0909999999999993;14;109;88;0;0;7;8;10;4.9000000000000004;5.0999999999999996;46.039999999999999;41;35;157;34;31;40;23;157;38;52;3;40;373
6;20204;Santa Clara-a-Nova;305;295;296;292;122;80;109;64;13;16;10.656000000000001;20;21;54;98;0;0;13;16;5.5;2.7999999999999998;2.7000000000000002;51.969999999999999;28;25;136;58;58;31;21;122;52;69;3;40;374
6;20301;Alvito;610;649;593;641;268;250;248;221;20;29;7.4630000000000001;11.6;53;71;345;6;8;14;21;9.1999999999999993;4.5;4.7999999999999998;46.399999999999999;97;67;282;87;77;69;78;291;99;112;3;41;378
6;20302;Vila Nova da Baronia;589;656;545;623;290;253;256;229;34;24;11.724;9.4860000000000007;82;98;305;3;1;31;23;9.6999999999999993;4.5999999999999996;5.0999999999999996;46.18;76;62;325;60;66;83;54;314;71;134;3;41;379
6;20401;Barrancos;890;944;868;924;447;337;396;259;51;78;11.409000000000001;23.145;67;141;447;4;13;47;65;10.9;5.2999999999999998;5.5999999999999996;44.649999999999999;118;81;507;96;88;128;83;461;124;148;3;42;380
6;20508;Salvada;540;557;510;548;269;196;230;167;39;29;14.497999999999999;14.795999999999999;55;40;302;8;11;31;18;18.399999999999999;9.0999999999999996;9.3000000000000007;45.07;72;44;300;64;60;80;68;233;89;87;3;43;392
6;20509;Beja (Salvador);3159;3431;2990;3294;1662;1671;1493;1491;169;180;10.167999999999999;10.772;101;323;2560;31;49;138;131;1016.6;487.30000000000001;529.29999999999995;40.920000000000002;559;361;1791;235;213;486;328;1907;283;427;3;43;383
6;20512;Santa Vitória;302;293;299;289;129;100;115;93;14;7;10.853;7;38;22;148;5;2;9;5;5.2999999999999998;2.7000000000000002;2.6000000000000001;48.590000000000003;43;31;153;39;36;23;18;137;45;70;3;43;394
6;20513;Beja (Santiago Maior);3737;3883;3722;3824;1920;1845;1656;1627;264;218;13.75;11.816000000000001;101;417;2765;66;48;198;170;177;86.799999999999997;90.200000000000003;41.539999999999999;602;401;2169;336;229;530;367;2141;416;429;3;43;385
6;20514;São Brissos;51;57;74;62;30;24;26;24;4;0;13.333;0;15;6;29;0;0;4;0;2.1000000000000001;1;1.1000000000000001;37.520000000000003;10;3;34;1;3;14;4;29;1;9;3;43;395
6;20515;Beja (São João Baptista);3037;3358;2833;3226;1468;1563;1335;1424;133;139;9.0600000000000005;8.8930000000000007;137;256;2366;40;23;93;116;778.79999999999995;369.89999999999998;409;43.200000000000003;462;347;1638;288;302;447;310;1854;358;389;3;43;386
6;20601;Casével;222;226;213;217;88;68;75;59;13;9;14.773;13.234999999999999;28;28;78;1;1;12;8;13.300000000000001;6.5999999999999996;6.7000000000000002;53.960000000000001;18;14;97;40;53;28;10;94;44;50;3;44;399
6;20702;Faro do Alentejo;308;283;299;277;161;114;139;79;22;35;13.664999999999999;30.701999999999998;62;58;98;1;5;21;30;13.199999999999999;6.9000000000000004;6.2999999999999998;43.32;42;37;165;37;27;32;37;145;36;33;3;45;405
6;20801;Alfundão;449;414;439;405;231;163;198;131;33;32;14.286;19.632000000000001;130;54;145;1;2;32;30;16.600000000000001;8.5999999999999996;8;45;58;36;256;47;52;51;38;213;61;51;3;46;408
6;20802;Ferreira do Alentejo;2222;2474;2133;2422;1144;964;977;797;167;167;14.598000000000001;17.324000000000002;323;275;1176;25;23;142;144;21;9.9000000000000004;11.1;45.780000000000001;303;236;1197;227;259;311;224;1192;295;452;3;46;410
6;20805;Peroguarda;184;180;175;174;93;76;73;62;20;14;21.504999999999999;18.420999999999999;34;27;74;1;2;19;12;10;5.0999999999999996;5;44.549999999999997;26;19;98;17;24;26;18;85;24;27;3;46;413
6;20901;Alcaria Ruiva;417;432;400;420;190;124;177;105;13;19;6.8419999999999996;15.323;93;44;145;2;3;11;16;3.8999999999999999;1.8999999999999999;2;48.840000000000003;46;45;207;47;72;52;38;185;61;96;3;47;414
6;20908;São Pedro de Solis;109;120;109;116;41;19;41;18;0;1;0;5.2629999999999999;11;26;22;0;0;0;1;3.6000000000000001;1.7;1.8999999999999999;57.68;10;5;52;20;22;3;6;46;29;36;3;47;421
6;21006;Santo Amador;190;222;192;226;76;52;56;43;20;9;26.315999999999999;17.308;35;20;44;0;1;20;8;5.7000000000000002;2.6000000000000001;3.1000000000000001;51.759999999999998;26;11;90;35;28;23;15;86;52;46;3;48;429
6;21008;Sobral da Adiça;515;498;508;497;234;156;180;109;54;47;23.077000000000002;30.128;85;40;164;6;7;48;40;7.2999999999999998;3.7000000000000002;3.6000000000000001;44.520000000000003;74;60;274;67;40;71;46;236;64;81;3;48;430
6;21107;São Martinho das Amoreiras;515;491;505;484;190;140;163;116;27;24;14.211;17.143000000000001;43;67;169;1;6;26;18;7;3.6000000000000001;3.3999999999999999;53.759999999999998;42;33;245;79;116;39;36;209;89;118;3;49;443
6;21109;São Teotónio;2911;2616;2852;2597;1657;1139;1467;971;190;168;11.467000000000001;14.75;1072;312;1054;7;13;183;155;18;9.5;8.5;44.439999999999998;311;353;1637;290;320;313;251;1383;336;333;3;49;444
6;21110;Vale de Santiago;278;276;262;263;135;93;118;66;17;27;12.593;29.032;53;57;74;0;3;17;24;8.4000000000000004;4.2000000000000002;4.2000000000000002;50.119999999999997;21;28;156;37;36;22;19;134;55;46;3;49;445
6;21111;Vila Nova de Milfontes;2480;2551;2429;2518;1237;1042;1098;846;139;196;11.237;18.809999999999999;139;499;1306;13;11;126;185;65.799999999999997;32.399999999999999;33.399999999999999;41.130000000000003;421;251;1376;247;185;409;227;1413;260;242;3;49;446
6;21301;Aldeia Nova de São Bento;1499;1573;1415;1496;701;537;572;402;129;135;18.402000000000001;25.140000000000001;170;236;568;16;19;113;116;12.699999999999999;6.2000000000000002;6.5;46.43;195;170;799;159;176;169;165;758;207;274;3;51;454
6;21306;Vale de Vargo;477;491;460;471;233;161;148;80;85;81;36.481000000000002;50.311;61;58;109;0;5;85;76;16.699999999999999;8.1999999999999993;8.5;46.520000000000003;47;51;267;52;60;68;42;240;68;73;3;51;459
6;21307;Vila Verde de Ficalho;738;721;693;693;331;242;255;182;76;60;22.960999999999999;24.792999999999999;102;72;263;7;13;69;47;13.800000000000001;7;6.7999999999999998;47;91;74;381;115;77;72;74;366;100;109;3;51;460
6;21401;Pedrógão;586;565;576;552;249;178;206;154;43;24;17.268999999999998;13.483000000000001;168;55;137;2;4;41;20;9.1999999999999993;4.7000000000000002;4.5;46.829999999999998;81;61;298;60;86;60;66;258;86;95;3;52;461
6;21404;Vila de Frades;448;480;442;468;219;186;190;156;29;30;13.242000000000001;16.129000000000001;62;60;224;4;3;25;27;36.200000000000003;17.5;18.699999999999999;43.619999999999997;56;58;246;48;40;73;49;232;62;64;3;52;464
6;30102;Barreiros;363;397;349;381;180;144;160;127;20;17;11.111000000000001;11.806000000000001;16;94;177;4;7;16;10;254.5;121.59999999999999;132.90000000000001;41.039999999999999;59;50;192;28;34;58;52;209;33;45;4;53;466
6;30103;Besteiros;281;295;276;294;146;111;131;98;15;13;10.274000000000001;11.712;14;75;140;3;5;12;8;285.80000000000001;139.40000000000001;146.40000000000001;40.880000000000003;48;36;158;19;20;37;41;157;28;32;4;53;467
6;30112;Goães;269;288;258;279;134;90;117;77;17;13;12.686999999999999;14.444000000000001;10;70;114;3;2;14;11;184;88.799999999999997;95.099999999999994;42.640000000000001;45;37;135;28;24;31;42;152;27;36;4;53;478
6;30114;Paranhos;55;56;56;53;24;10;23;9;1;1;4.1669999999999998;10;4;12;16;0;0;1;1;27.699999999999999;13.699999999999999;14;46.259999999999998;9;4;28;8;6;8;5;25;9;9;4;53;480
6;30116;Portela;82;86;81;81;30;28;28;24;2;4;6.6669999999999998;14.286;2;20;30;0;1;2;3;83.299999999999997;40.700000000000003;42.600000000000001;45.829999999999998;11;7;37;10;17;10;10;46;11;9;4;53;482
6;30119;Bouro (Santa Maria);351;409;348;399;170;122;135;106;35;16;20.588000000000001;13.115;15;51;175;2;5;33;11;109.8;50.700000000000003;59.100000000000001;47.5;28;39;189;40;55;44;55;183;58;69;4;53;469
6;30122;Seramil;97;85;96;85;45;14;43;12;2;2;4.444;14.286;9;21;25;1;0;1;2;45.200000000000003;24.100000000000001;21.100000000000001;43.579999999999998;17;9;49;12;10;11;8;43;13;10;4;53;486
6;30124;Vilela;146;151;135;148;61;45;54;37;7;8;11.475;17.777999999999999;12;31;48;1;2;6;6;105.5;51.899999999999999;53.600000000000001;41.670000000000002;31;18;75;8;14;21;17;73;14;26;4;53;488
6;30207;Alheira;512;560;501;553;248;231;228;208;20;23;8.0649999999999995;9.9570000000000007;14;216;206;3;6;17;17;143.90000000000001;68.700000000000003;75.200000000000003;43.780000000000001;77;57;267;63;48;79;51;285;77;68;4;54;495
6;30217;Campo;471;512;431;486;255;235;213;198;42;37;16.471;15.744999999999999;10;261;140;2;9;40;28;437.39999999999998;209.59999999999999;227.80000000000001;39.380000000000003;79;57;276;29;30;79;69;285;43;36;4;54;509
6;30218;Carapeços;1076;1201;1013;1179;588;547;531;481;57;66;9.6939999999999991;12.066000000000001;19;657;336;4;18;53;48;280.60000000000002;132.59999999999999;148;37.009999999999998;218;140;601;68;49;213;163;659;85;81;4;54;510
6;30223;Chorente;363;390;318;351;186;163;176;144;10;19;5.3760000000000003;11.656000000000001;49;170;101;3;5;7;14;163.30000000000001;78.700000000000003;84.599999999999994;38.93;69;43;193;40;18;67;47;213;35;28;4;54;515
6;30236;Gamil;458;466;437;459;238;214;202;183;36;31;15.125999999999999;14.486000000000001;5;193;187;7;7;29;24;280.5;139.09999999999999;141.5;37.359999999999999;91;68;256;26;17;78;54;253;52;29;4;54;530
6;30237;Gilmonde;756;760;700;740;420;361;377;325;43;36;10.238;9.9719999999999995;25;419;258;4;8;39;28;271.80000000000001;135.5;136.30000000000001;39.75;120;114;422;52;48;100;90;454;65;51;4;54;531
6;30247;Martim;1151;1224;1031;1174;663;564;613;485;50;79;7.5410000000000004;14.007;18;710;370;10;14;40;65;446.69999999999999;216.5;230.19999999999999;35.189999999999998;225;179;659;46;42;232;185;679;69;59;4;54;541
6;30259;Pereira;648;670;629;664;383;326;335;293;48;33;12.532999999999999;10.122999999999999;17;389;222;5;3;43;30;342.5;168.40000000000001;174.09999999999999;37.5;108;96;385;34;25;103;87;396;42;42;4;54;553
6;30260;Perelhal;872;877;820;848;473;419;435;356;38;63;8.0340000000000007;15.036;24;511;256;3;10;35;53;257.10000000000002;128.19999999999999;128.90000000000001;37.850000000000001;178;97;505;55;37;141;100;521;65;50;4;54;554
6;30265;Rio Covo (Santa Eugénia);714;769;665;757;399;358;360;298;39;60;9.7740000000000009;16.760000000000002;19;355;284;9;13;30;47;473.19999999999999;227.80000000000001;245.40000000000001;38.119999999999997;123;94;413;49;35;122;107;433;46;61;4;54;558
6;30267;Tamel (Santa Leocádia);359;394;335;385;198;181;187;160;11;21;5.556;11.602;12;252;83;1;3;10;18;122.09999999999999;58.200000000000003;63.899999999999999;37.259999999999998;70;42;200;26;21;67;53;215;28;31;4;54;564
6;30268;Galegos (Santa Maria);1480;1507;1365;1443;806;733;708;626;98;107;12.159000000000001;14.598000000000001;13;816;505;20;22;78;85;651;322.60000000000002;328.5;36.640000000000001;281;230;833;81;55;242;215;860;107;83;4;54;528
6;30269;Bastuço (Santo Estêvão);224;236;218;235;112;110;98;96;14;14;12.5;12.727;5;118;71;3;2;11;12;218.59999999999999;106.40000000000001;112.09999999999999;40.140000000000001;42;19;129;13;21;33;29;129;18;27;4;54;506
6;30276;Tamel (São Pedro Fins);249;289;235;290;151;120;135;102;16;18;10.596;15;3;147;87;3;2;13;16;210.30000000000001;97.299999999999997;112.90000000000001;39.119999999999997;41;35;145;18;10;52;29;152;30;26;4;54;565
6;30280;Silveiros;565;616;555;625;299;278;272;251;27;27;9.0299999999999994;9.7119999999999997;16;276;231;3;5;24;22;309.39999999999998;148;161.40000000000001;38.43;108;66;330;34;27;107;58;344;50;57;4;54;563
6;30281;Tregosa;332;354;304;342;177;147;161;126;16;21;9.0399999999999991;14.286;4;172;111;2;9;14;12;162.19999999999999;78.5;83.700000000000003;40.079999999999998;65;34;192;20;21;53;38;196;28;39;4;54;567
6;30288;Vilar de Figos;278;326;273;321;150;132;140;124;10;8;6.6669999999999998;6.0609999999999999;31;121;112;2;1;8;7;125.09999999999999;57.600000000000001;67.5;40.450000000000003;49;35;157;19;18;39;43;181;32;31;4;54;576
6;30301;Adaúfe;1801;1910;1810;1901;1006;870;896;754;110;116;10.933999999999999;13.333;32;730;888;26;32;84;84;343.5;166.69999999999999;176.80000000000001;41.479999999999997;220;275;1046;148;112;246;257;1060;182;165;4;55;579
6;30304;Aveleda;1056;1093;1033;1080;592;500;536;413;56;87;9.4589999999999996;17.399999999999999;3;411;535;11;15;45;72;1135.5;558;577.5;41.149999999999999;158;139;621;83;55;146;132;646;73;96;4;55;587
6;30306;Celeirós;1648;1641;1591;1636;945;842;856;704;89;138;9.4179999999999993;16.390000000000001;3;809;748;14;20;75;118;1173.4000000000001;588;585.5;37.700000000000003;310;202;971;102;63;264;189;967;118;103;4;55;608
6;30307;Braga (Cividade);609;813;613;793;306;343;269;290;37;53;12.092000000000001;15.452;1;96;462;7;9;30;44;4679.5;2004.0999999999999;2675.4000000000001;46.219999999999999;74;62;336;77;60;76;81;431;122;103;4;55;591
6;30310;Dume;1579;1672;1529;1636;824;728;732;612;92;116;11.164999999999999;15.933999999999999;26;443;875;15;21;77;95;826.60000000000002;401.5;425.10000000000002;41.710000000000001;249;193;879;161;97;238;177;930;170;157;4;55;616
6;30311;Escudeiros;558;557;528;544;307;249;270;206;37;43;12.052;17.268999999999998;3;246;227;10;3;27;40;264.30000000000001;132.30000000000001;132;37.990000000000002;108;61;313;38;38;104;62;306;44;41;4;55;617
6;30315;Figueiredo;573;625;555;613;337;297;298;251;39;46;11.573;15.488;8;294;247;0;10;39;36;591.10000000000002;282.69999999999999;308.39999999999998;37.899999999999999;100;72;346;35;20;101;85;357;39;43;4;55;624
6;30320;Guisande;276;262;273;260;148;129;135;110;13;19;8.7840000000000007;14.728999999999999;1;123;121;0;2;13;17;218.19999999999999;111.90000000000001;106.3;35.100000000000001;74;37;140;11;14;45;31;152;11;23;4;55;641
6;30323;Lomar;2950;3091;2841;3019;1631;1670;1424;1393;207;277;12.692;16.587;8;1021;1788;31;39;176;238;1927.2;941.10000000000002;986.10000000000002;36.850000000000001;573;401;1723;158;95;525;345;1894;195;132;4;55;646
6;30324;Braga (Maximinos);4671;5121;4414;4975;2457;2475;2081;2036;376;439;15.303000000000001;17.736999999999998;13;1108;2996;70;75;306;364;5165.3999999999996;2464;2701.4000000000001;38.200000000000003;869;665;2612;297;228;780;626;2975;364;376;4;55;592
6;30330;Padim da Graça;720;801;713;805;401;374;348;281;53;93;13.217000000000001;24.866;3;361;265;9;20;44;73;448.19999999999999;212.19999999999999;236;37.810000000000002;120;103;418;55;24;140;116;440;56;49;4;55;662
6;30342;Braga (São José de São Lázaro);6237;7339;5888;7106;3252;3329;2751;2748;501;581;15.406000000000001;17.452999999999999;19;1160;4320;107;125;394;456;6242.1999999999998;2867.6999999999998;3374.4000000000001;42.200000000000003;861;868;3551;531;426;908;849;4090;733;759;4;55;594
6;30348;Oliveira (São Pedro);245;270;241;269;134;115;118;94;16;21;11.94;18.260999999999999;3;114;95;3;3;13;18;229.59999999999999;109.2;120.40000000000001;38.899999999999999;39;34;135;17;20;54;26;145;20;25;4;55;661
6;30359;Trandeiras;340;360;329;356;191;162;174;135;17;27;8.9009999999999998;16.667000000000002;5;120;184;1;4;16;23;744.5;361.60000000000002;382.89999999999998;39.93;52;36;203;22;27;58;49;200;26;27;4;55;704
6;30401;Abadim;268;303;259;297;122;87;119;72;3;15;2.4590000000000001;17.241;11;77;103;0;3;3;12;37.700000000000003;17.699999999999999;20;42.18;40;33;149;22;24;46;38;139;31;49;4;56;709
6;30404;Basto;463;475;421;459;243;161;218;124;25;37;10.288;22.981000000000002;10;170;162;1;10;24;27;168.19999999999999;83;85.200000000000003;34.75;102;64;249;22;26;109;65;237;31;33;4;56;712
6;30406;Cabeceiras de Basto;344;367;323;348;143;95;122;66;21;29;14.685;30.526;20;86;82;1;14;20;15;29;14;15;44.200000000000003;45;46;186;26;41;47;47;170;40;63;4;56;714
6;30410;Outeiro;547;569;523;558;269;202;245;170;24;32;8.9220000000000006;15.842000000000001;6;166;243;4;11;20;21;147.30000000000001;72.200000000000003;75.099999999999994;38.619999999999997;110;81;273;45;38;99;70;286;61;53;4;56;718
6;30411;Painzela;464;495;418;476;220;157;204;135;16;22;7.2729999999999997;14.013;16;156;167;2;7;14;15;130.5;63.100000000000001;67.400000000000006;38.280000000000001;94;62;241;32;35;82;80;245;34;54;4;56;719
6;30414;Refojos de Basto;2260;2420;2064;2297;1120;968;1010;773;110;195;9.8209999999999997;20.145;66;542;1175;22;64;88;131;333.69999999999999;161.09999999999999;172.59999999999999;38.630000000000003;432;282;1263;144;139;396;309;1289;184;242;4;56;722
6;30416;Vila Nune;188;191;178;184;84;51;69;30;15;21;17.856999999999999;41.176000000000002;9;40;50;1;3;14;18;83.299999999999997;41.299999999999997;42;42.170000000000002;31;21;102;13;21;31;22;90;21;27;4;56;724
6;30417;Vilar de Cunhas;93;101;88;96;44;28;41;23;3;5;6.8179999999999996;17.856999999999999;27;10;27;2;2;1;3;9.6999999999999993;4.7000000000000002;5.0999999999999996;49.039999999999999;5;10;46;15;17;13;7;46;19;16;4;56;725
6;30502;Arnóia;838;864;780;832;430;306;365;247;65;59;15.116;19.280999999999999;58;219;335;16;29;49;30;90.900000000000006;44.700000000000003;46.100000000000001;43.770000000000003;106;129;443;63;97;103;113;433;88;127;4;57;727
6;30504;Britelo;1238;1323;1197;1305;614;513;558;438;56;75;9.1210000000000004;14.619999999999999;28;247;721;16;23;40;52;329.10000000000002;159.09999999999999;170;40.270000000000003;216;148;706;85;83;195;162;713;117;136;4;57;731
6;30506;Canedo de Basto;492;518;443;490;218;154;191;127;27;27;12.385;17.532;14;120;184;3;9;24;18;101.2;49.299999999999997;51.899999999999999;42.810000000000002;62;63;283;39;45;55;71;279;52;61;4;57;733
6;30507;Carvalho;385;404;402;421;163;103;136;85;27;18;16.564;17.475999999999999;8;105;108;8;8;19;10;115.7;56.5;59.200000000000003;40.280000000000001;68;46;210;31;30;61;56;193;42;52;4;57;734
6;30508;Codeçoso;206;238;196;232;106;66;92;43;14;23;13.208;34.847999999999999;4;82;49;0;7;14;16;41.5;19.300000000000001;22.300000000000001;45.07;19;31;118;16;22;31;36;109;23;39;4;57;735
6;30509;Corgo;144;167;144;169;67;40;54;32;13;8;19.402999999999999;20;8;27;51;3;3;10;5;95.799999999999997;44.299999999999997;51.399999999999999;43.149999999999999;19;16;82;13;14;21;20;91;9;26;4;57;736
6;30511;Gagos;308;320;287;312;156;98;139;78;17;20;10.897;20.408000000000001;6;64;147;6;12;11;8;142.5;69.900000000000006;72.599999999999994;42.460000000000001;38;42;180;33;15;35;38;193;25;29;4;57;738
6;30512;Gémeos;324;326;305;320;153;120;135;104;18;16;11.765000000000001;13.333;13;81;145;3;8;15;8;161.80000000000001;80.700000000000003;81.200000000000003;38.409999999999997;66;48;169;18;23;53;38;172;31;32;4;57;739
6;30513;Infesta;148;144;118;135;73;36;64;33;9;3;12.329000000000001;8.3330000000000002;22;30;45;2;1;7;2;52.799999999999997;26.800000000000001;26;42.270000000000003;20;24;77;12;15;25;15;64;15;25;4;57;740
6;30519;Basto (Santa Tecla);98;114;90;111;53;15;42;12;11;3;20.754999999999999;20;2;32;20;3;2;8;1;66.200000000000003;30.600000000000001;35.600000000000001;42.18;12;21;48;5;12;20;14;54;10;16;4;57;728
6;30520;Basto (São Clemente);761;763;692;694;369;280;317;233;52;47;14.092000000000001;16.786000000000001;10;274;266;13;15;39;32;98.900000000000006;49.399999999999999;49.5;40.189999999999998;142;103;399;54;63;124;74;389;87;89;4;57;729
6;30521;Vale de Bouro;374;439;355;435;190;155;148;92;42;63;22.105;40.645000000000003;11;120;109;14;29;28;34;103;47.399999999999999;55.600000000000001;40.159999999999997;69;47;195;28;35;80;50;216;40;53;4;57;746
6;30522;Veade;350;364;325;351;179;118;160;104;19;14;10.615;11.864000000000001;17;88;159;3;6;16;8;129.5;63.5;66;42.759999999999998;49;37;204;33;27;49;36;192;42;45;4;57;747
6;30610;Gemeses;518;560;499;546;262;223;246;192;16;31;6.1070000000000002;13.901;25;202;211;3;2;13;29;193.59999999999999;93;100.59999999999999;39.799999999999997;94;74;277;36;37;89;68;297;43;63;4;58;757
6;30611;Mar;564;618;520;595;298;247;273;218;25;29;8.3889999999999993;11.741;43;232;216;5;8;20;21;501.60000000000002;239.30000000000001;262.30000000000001;38.810000000000002;93;84;308;44;35;99;89;332;55;43;4;58;758
6;30614;Rio Tinto;285;333;274;324;151;139;143;130;8;9;5.298;6.4749999999999996;61;115;97;1;2;7;7;144.90000000000001;66.799999999999997;78.099999999999994;41.960000000000001;44;26;166;26;23;48;36;188;32;29;4;58;761
6;30702;Agrela;79;108;77;107;40;37;31;32;9;5;22.5;13.513999999999999;2;38;23;2;2;7;3;95.200000000000003;40.200000000000003;55;42.770000000000003;11;10;47;3;8;11;21;54;10;12;4;59;764
6;30704;Ardegão;129;172;123;172;64;64;52;50;12;14;18.75;21.875;2;56;44;3;3;9;11;137;58.700000000000003;78.299999999999997;43.640000000000001;18;12;77;15;7;24;15;96;15;22;4;59;766
6;30711;Felgueiras;52;65;51;64;21;22;20;20;1;2;4.7620000000000005;9.0909999999999993;2;21;17;0;0;1;2;20.300000000000001;9;11.300000000000001;43.640000000000001;9;9;27;2;5;5;8;33;10;9;4;59;775
6;30717;Monte;126;182;121;176;45;43;39;34;6;9;13.333;20.93;5;28;40;0;1;6;8;32.200000000000003;13.199999999999999;19;50.57;20;9;54;26;17;13;17;78;35;39;4;59;781
6;30720;Pedraído;118;147;114;143;59;48;44;39;15;9;25.423999999999999;18.75;1;42;40;2;4;13;5;51.200000000000003;22.800000000000001;28.399999999999999;46.899999999999999;9;13;67;11;18;18;21;62;22;24;4;59;784
6;30721;Queimadela;201;289;195;286;85;56;76;42;9;14;10.587999999999999;25;8;58;52;2;5;7;9;47.700000000000003;19.600000000000001;28.199999999999999;47.509999999999998;23;23;112;22;21;37;24;119;49;60;4;59;785
6;30732;Serafão;468;528;454;513;181;168;166;152;15;16;8.2870000000000008;9.5240000000000009;13;157;148;2;4;13;12;128.30000000000001;60.299999999999997;68;43.43;78;56;238;54;42;60;61;277;69;61;4;59;792
6;30803;Atães;980;938;964;925;552;489;476;418;76;71;13.768000000000001;14.519;15;484;395;13;14;63;57;281.60000000000002;143.90000000000001;137.69999999999999;36.280000000000001;192;148;556;40;44;150;135;556;53;44;4;55;586
6;30804;Azurém;3931;4417;4236;4548;2137;2148;1830;1797;307;351;14.366;16.341000000000001;8;1294;2325;54;50;253;301;2878.5999999999999;1355.5;1523.0999999999999;41.460000000000001;547;437;2385;378;184;534;424;2656;432;371;4;55;588
6;30809;Calvos;513;569;506;559;304;286;260;248;44;38;14.474;13.287000000000001;2;372;134;5;5;39;33;530.5;251.5;279;34.890000000000001;114;58;306;15;20;113;81;312;28;35;4;55;604
6;30812;Costa;2475;2680;2355;2588;1406;1451;1282;1276;124;175;8.8189999999999991;12.061;7;751;1800;24;31;100;144;1094.4000000000001;525.39999999999998;568.89999999999998;36.25;505;256;1500;135;79;480;236;1675;160;129;4;55;611
6;30813;Creixomil;4584;5057;4458;4933;2467;2541;2092;2148;375;393;15.201000000000001;15.465999999999999;23;1490;2727;83;60;292;333;3206.3000000000002;1524.5;1681.8;40.549999999999997;722;549;2690;400;223;666;495;3052;461;383;4;55;612
6;30817;Gandarela;544;530;523;519;298;276;265;249;33;27;11.074;9.7829999999999995;4;382;128;8;6;25;21;626.20000000000005;317.19999999999999;309;38.270000000000003;85;81;322;35;21;78;75;307;36;34;4;55;629
6;30830;Mesão Frio;2010;2163;1915;2073;1129;1145;978;993;151;152;13.375;13.275;7;874;1090;29;20;122;132;1010.3;486.60000000000002;523.70000000000005;37.560000000000002;323;286;1207;125;69;348;262;1332;130;91;4;55;652
6;30831;Moreira de Cónegos;2377;2476;2322;2449;1274;1140;1101;969;173;171;13.579000000000001;15;9;1420;641;19;15;154;156;1027.2;503.10000000000002;524.10000000000002;42.270000000000003;299;347;1375;213;143;297;277;1439;246;217;4;55;654
6;30835;Pencelo;624;634;615;654;315;292;265;250;50;42;15.872999999999999;14.384;6;262;247;9;10;41;32;526.10000000000002;261;265.19999999999999;40.259999999999998;87;90;362;56;29;97;78;367;49;43;4;55;668
6;30840;Ronfe;2207;2255;2127;2199;1194;1102;1037;941;157;161;13.148999999999999;14.609999999999999;19;1225;734;24;29;133;132;888.79999999999995;439.60000000000002;449.19999999999999;38.799999999999997;361;306;1302;143;95;348;278;1317;170;142;4;55;680
6;30842;Prazins (Santa Eufémia);594;627;577;609;343;308;302;274;41;34;11.952999999999999;11.039;10;370;196;3;6;38;28;546.39999999999998;265.80000000000001;280.60000000000002;36.920000000000002;105;88;345;36;20;104;105;349;35;34;4;55;675
6;30844;Airão (Santa Maria);841;845;810;815;426;393;368;328;58;65;13.615;16.539000000000001;0;468;228;6;9;52;56;708.10000000000002;353.19999999999999;354.89999999999998;40;147;119;481;60;34;115;100;478;79;73;4;55;580
6;30846;Candoso (Santiago);1075;1088;1026;1068;612;551;530;473;82;78;13.399000000000001;14.156000000000001;7;535;461;27;14;55;64;830.89999999999998;413;418;36.399999999999999;196;171;623;58;27;188;139;653;56;52;4;55;605
6;30847;Briteiros (Santo Estêvão);649;643;647;635;338;320;287;282;51;38;15.089;11.875;13;314;242;10;7;41;31;454.30000000000001;228.19999999999999;226.09999999999999;36.329999999999998;130;102;351;39;27;101;103;361;52;26;4;55;600
6;30862;Souto (São Salvador);394;436;381;434;221;207;199;184;22;23;9.9550000000000001;11.111000000000001;16;237;130;3;7;19;16;167.40000000000001;79.5;87.900000000000006;39.079999999999998;59;63;225;22;25;60;68;243;29;36;4;55;699
6;30863;Guimarães (São Sebastião);905;1071;859;1040;405;420;338;351;67;69;16.542999999999999;16.428999999999998;3;191;495;21;9;46;60;4848.8999999999996;2220.8000000000002;2628.0999999999999;47.229999999999997;125;131;454;85;110;94;82;531;158;206;4;55;640
6;30867;Serzedo;596;606;573;598;324;303;291;270;33;33;10.185;10.891;2;386;173;5;6;28;27;487.69999999999999;241.80000000000001;245.90000000000001;38.049999999999997;102;70;360;34;30;101;80;344;43;38;4;55;695
6;30872;Vermil;559;585;543;579;299;279;254;238;45;41;15.050000000000001;14.695;5;293;194;6;8;39;33;492.89999999999998;240.80000000000001;252;38.740000000000002;98;81;320;34;26;83;91;321;44;46;4;55;706
6;30902;Ajude;74;65;74;63;41;21;35;18;6;3;14.634;14.286;2;27;24;1;1;5;2;58.600000000000001;31.199999999999999;27.399999999999999;42.460000000000001;12;10;39;5;8;6;8;38;7;6;4;60;800
6;30904;Calvos;250;233;237;237;124;80;114;68;10;12;8.0649999999999995;15;9;72;101;2;8;8;4;110.8;57.299999999999997;53.399999999999999;42.109999999999999;40;32;140;21;17;33;26;121;23;30;4;60;802
6;30906;Covelas;209;207;213;214;111;99;104;92;7;7;6.306;7.0709999999999997;2;67;127;3;0;4;7;143;71.799999999999997;71.200000000000003;40.5;36;26;116;14;17;32;18;117;20;20;4;60;804
6;30910;Frades;134;136;128;136;56;42;50;35;6;7;10.714;16.667000000000002;1;26;58;3;5;3;2;61.299999999999997;30.399999999999999;30.899999999999999;42.890000000000001;17;16;74;8;19;22;20;70;12;12;4;60;808
6;30915;Lanhoso;334;408;334;408;171;177;153;151;18;26;10.526;14.689;12;118;174;0;6;18;20;122.7;55.200000000000003;67.5;39.219999999999999;62;38;188;27;19;73;40;234;22;39;4;60;813
6;31004;Carvalheira;186;200;182;196;74;70;61;44;13;26;17.568000000000001;37.143000000000001;10;35;60;0;5;13;21;42.600000000000001;20.5;22.100000000000001;47.399999999999999;22;23;85;28;28;17;28;95;31;29;4;61;831
6;31010;Moimenta;353;388;347;397;162;145;143;130;19;15;11.728;10.345000000000001;9;39;225;2;2;17;13;220.90000000000001;105.3;115.7;41.899999999999999;56;52;173;43;29;60;44;199;42;43;4;61;837
6;31011;Monte;63;63;62;58;35;34;34;31;1;3;2.8570000000000002;8.8239999999999998;29;6;30;0;0;1;3;10.5;5.2999999999999998;5.2999999999999998;46.090000000000003;6;10;28;10;9;7;9;31;7;9;4;61;838
6;31013;Rio Caldo;433;459;421;450;178;138;153;108;25;30;14.045;21.739000000000001;13;70;178;4;5;21;25;63.899999999999999;31;32.899999999999999;43.240000000000002;68;62;222;40;41;62;49;228;64;56;4;61;840
6;31103;Campos;89;96;84;84;27;30;24;28;3;2;11.111000000000001;6.6669999999999998;7;13;32;1;0;2;2;13.4;6.4000000000000004;7;53.170000000000002;10;7;38;16;18;5;8;47;12;24;4;62;847
6;31107;Eira Vedra;356;346;342;347;165;136;149;120;16;16;9.6969999999999992;11.765000000000001;13;65;191;4;6;12;10;125.7;63.700000000000003;61.899999999999999;42.439999999999998;54;54;186;33;29;45;32;188;51;30;4;62;851
6;31115;Salamonde;183;204;168;185;99;65;82;49;17;16;17.172000000000001;24.614999999999998;1;59;71;0;4;17;12;46.200000000000003;21.899999999999999;24.399999999999999;49.009999999999998;12;19;109;22;21;16;19;106;27;36;4;62;859
6;31117;Soutelo;83;90;80;85;35;39;33;32;2;7;5.7140000000000004;17.949000000000002;7;27;31;1;5;1;2;27.800000000000001;13.300000000000001;14.5;45.719999999999999;13;6;47;4;13;9;11;46;12;12;4;62;861
6;31201;Abade de Vermoim;207;230;203;228;107;92;94;77;13;15;12.15;16.303999999999998;5;80;86;1;3;12;12;469.69999999999999;222.5;247.19999999999999;38.880000000000003;40;19;125;13;10;41;19;128;27;15;4;63;866
6;31212;Cruz;832;906;810;902;497;436;451;373;46;63;9.2560000000000002;14.449999999999999;6;395;423;13;13;33;50;420.69999999999999;201.40000000000001;219.30000000000001;39.130000000000003;123;102;513;63;31;152;88;533;76;57;4;63;879
6;31213;Delães;1885;2032;1833;2003;1027;988;814;772;213;216;20.739999999999998;21.861999999999998;15;877;694;24;23;189;193;1590.2;765.29999999999995;824.89999999999998;39.859999999999999;305;202;1128;142;108;303;216;1195;177;141;4;63;880
6;31219;Joane;3956;4133;3769;4056;2217;2135;1923;1811;294;324;13.260999999999999;15.176;14;2064;1656;54;54;240;270;1105.7;540.79999999999995;564.89999999999998;37.479999999999997;725;536;2312;222;161;672;512;2411;290;248;4;63;886
6;31222;Lemenhe;637;635;624;632;330;309;296;251;34;58;10.303000000000001;18.77;14;285;248;3;5;31;53;425.19999999999999;212.90000000000001;212.30000000000001;39.789999999999999;115;77;353;63;29;98;61;372;57;47;4;63;889
6;31223;Louro;1084;1166;1035;1117;611;549;551;488;60;61;9.8200000000000003;11.111000000000001;19;502;518;14;12;46;49;451.80000000000001;217.69999999999999;234.09999999999999;40.75;172;145;658;66;43;142;142;682;101;99;4;63;890
6;31226;Mouquim;627;639;606;628;343;286;306;231;37;55;10.787000000000001;19.231000000000002;23;265;249;2;6;35;49;324.69999999999999;160.80000000000001;163.90000000000001;42.100000000000001;92;68;365;62;40;88;60;373;67;51;4;63;893
6;31227;Nine;1453;1521;1414;1490;810;695;743;612;67;83;8.2720000000000002;11.942;18;633;704;6;21;61;62;685.89999999999998;335.10000000000002;350.80000000000001;38.759999999999998;268;153;865;101;66;224;161;894;128;114;4;63;894
6;31229;Outiz;412;501;392;497;225;200;198;169;27;31;12;15.5;14;186;167;3;3;24;28;274.60000000000002;123.90000000000001;150.69999999999999;41.030000000000001;69;56;226;35;26;83;63;250;36;69;4;63;898
6;31231;Portela;297;288;279;283;172;147;151;115;21;32;12.209;21.768999999999998;4;144;118;5;7;16;25;219.30000000000001;111.40000000000001;108;36.170000000000002;63;50;162;6;16;49;35;165;20;19;4;63;900
6;31233;Requião;1660;1716;1611;1669;922;843;813;711;109;132;11.821999999999999;15.657999999999999;22;748;754;24;24;85;108;455.19999999999999;223.80000000000001;231.40000000000001;38.090000000000003;301;243;941;100;75;267;221;985;137;106;4;63;902
6;31238;Arnoso (Santa Maria);997;1011;945;989;540;493;488;439;52;54;9.6300000000000008;10.952999999999999;15;469;443;7;14;45;40;503.30000000000001;249.90000000000001;253.40000000000001;37.770000000000003;179;138;576;58;46;163;129;561;76;82;4;63;869
6;31240;Vale (São Cosme);1494;1538;1405;1493;805;746;709;614;96;132;11.925000000000001;17.693999999999999;15;724;584;12;15;84;117;481.5;237.30000000000001;244.19999999999999;39.530000000000001;245;197;869;113;70;225;179;900;119;115;4;63;910
6;31301;Aboim da Nóbrega;458;529;426;500;212;128;185;106;27;22;12.736000000000001;17.187999999999999;13;103;175;4;8;23;14;80.900000000000006;37.5;43.299999999999997;44.799999999999997;52;57;251;57;41;69;63;250;57;90;4;64;915
6;31303;Atães;307;352;281;344;144;99;124;81;20;18;13.888999999999999;18.181999999999999;3;68;134;3;5;17;13;259.69999999999999;121;138.69999999999999;43.100000000000001;42;34;167;31;33;51;31;175;46;49;4;64;917
6;31305;Azões;148;166;131;163;70;53;64;45;6;8;8.5709999999999997;15.093999999999999;4;61;44;2;3;4;5;193.09999999999999;91;102.09999999999999;41.75;34;19;68;8;19;25;20;78;14;29;4;64;919
6;31306;Barbudo;1135;1265;1063;1229;596;545;538;460;58;85;9.7319999999999993;15.596;18;318;662;13;15;45;70;544;257.30000000000001;286.80000000000001;38.950000000000003;216;143;610;89;77;220;124;676;93;152;4;64;920
6;31313;Dossãos;251;249;232;246;129;99;116;89;13;10;10.077999999999999;10.101000000000001;20;84;101;1;2;12;8;149.40000000000001;75;74.400000000000006;39.280000000000001;50;37;117;30;17;40;28;139;26;16;4;64;929
6;31326;Marrancos;226;278;199;268;130;118;116;102;14;16;10.769;13.558999999999999;12;106;100;0;2;14;14;156.40000000000001;70.099999999999994;86.299999999999997;40.399999999999999;38;19;135;23;11;45;30;143;33;27;4;64;944
6;31327;Mós;151;172;145;165;76;54;72;43;4;11;5.2629999999999999;20.370000000000001;8;40;67;0;3;4;8;94.700000000000003;44.299999999999997;50.399999999999999;40.990000000000002;27;20;75;15;14;29;15;90;18;20;4;64;945
6;31330;Oleiros;552;617;555;617;268;229;241;207;27;22;10.074999999999999;9.6069999999999993;12;206;230;4;2;23;20;309.30000000000001;146.09999999999999;163.30000000000001;37.729999999999997;113;77;282;55;25;114;73;330;47;53;4;64;948
6;31333;Pedregais;150;181;148;180;73;67;69;60;4;7;5.4790000000000001;10.448;15;57;57;0;1;4;6;148.90000000000001;67.5;81.400000000000006;42.710000000000001;28;12;84;15;11;24;20;93;17;27;4;64;953
6;31336;Pico de Regalados;402;443;393;434;207;189;191;172;16;17;7.7290000000000001;8.9949999999999992;18;98;247;1;2;15;15;283.5;134.90000000000001;148.59999999999999;41.560000000000002;59;48;221;39;35;68;42;250;36;47;4;64;955
6;31338;Portela das Cabras;135;143;135;143;59;47;56;43;3;4;5.085;8.5109999999999992;1;39;59;2;1;1;3;112.90000000000001;54.799999999999997;58.100000000000001;43.740000000000002;19;16;72;18;10;19;9;70;26;19;4;64;958
6;31345;Escariz (São Mamede);181;207;173;204;79;61;69;55;10;6;12.657999999999999;9.8360000000000003;9;62;53;2;2;8;4;113.5;53;60.600000000000001;44.539999999999999;23;22;97;20;19;23;20;114;26;24;4;64;931
6;31347;Valbom (São Martinho);81;104;77;103;35;30;32;25;3;5;8.5709999999999997;16.667000000000002;5;13;39;0;0;3;5;108.59999999999999;47.600000000000001;61.100000000000001;46.740000000000002;10;7;40;13;11;9;18;48;16;13;4;64;966
6;31350;Prado (São Miguel);355;362;331;361;183;110;169;93;14;17;7.6500000000000004;15.455;14;132;116;3;5;11;12;130.19999999999999;64.5;65.799999999999997;42.210000000000001;67;42;192;24;30;44;38;187;35;58;4;64;959
6;31355;Valdreu;238;278;231;279;93;55;84;49;9;6;9.6769999999999996;10.909000000000001;37;35;61;4;2;5;4;28.699999999999999;13.300000000000001;15.5;49.259999999999998;28;24;112;45;29;22;32;110;61;53;4;64;968
6;31404;Infias;912;928;885;904;508;455;436;376;72;79;14.173;17.363;6;536;270;11;7;61;72;591;292.89999999999998;298.10000000000002;38.369999999999997;149;126;538;59;40;144;119;532;88;45;4;65;975
6;31405;Tagilde;936;925;914;915;548;472;482;408;66;64;12.044;13.558999999999999;10;616;264;9;6;57;58;671.60000000000002;337.80000000000001;333.80000000000001;34.369999999999997;178;159;531;40;28;193;124;509;55;44;4;65;977
6;40102;Alfândega da Fé;1004;1051;1005;1034;505;472;463;382;42;90;8.3170000000000002;19.068000000000001;31;193;621;11;30;31;60;50.600000000000001;24.699999999999999;25.899999999999999;43.560000000000002;139;111;539;115;100;139;123;555;111;123;5;66;981
6;40106;Gebelim;86;104;83;99;34;22;32;20;2;2;5.8819999999999997;9.0909999999999993;16;7;29;0;0;2;2;11;5;6;49.280000000000001;4;8;51;10;13;6;15;51;16;16;5;66;985
6;40107;Gouveia;62;60;58;54;23;14;22;11;1;3;4.3479999999999999;21.428999999999998;6;12;15;0;2;1;1;7.2999999999999998;3.7000000000000002;3.6000000000000001;53.630000000000003;4;3;29;20;6;2;7;25;18;8;5;66;986
6;40108;Parada;58;66;50;59;24;14;22;11;2;3;8.3330000000000002;21.428999999999998;12;5;16;0;1;2;2;12.1;5.7000000000000002;6.4000000000000004;53.229999999999997;7;3;28;10;10;5;7;23;5;26;5;66;987
6;40109;Pombal;60;63;52;59;26;13;24;11;2;2;7.6920000000000002;15.385;6;7;22;0;0;2;2;14.6;7.0999999999999996;7.5;49.109999999999999;4;8;27;10;11;11;3;28;7;14;5;66;988
6;40112;Sendim da Ribeira;40;52;36;48;22;15;21;12;1;3;4.5449999999999999;20;13;4;16;0;0;1;3;6.2000000000000002;2.7000000000000002;3.5;52.469999999999999;2;5;20;8;5;6;5;20;6;15;5;66;991
6;40113;Sendim da Serra;41;50;43;50;25;13;24;13;1;0;4;0;12;8;17;0;0;1;0;8.3000000000000007;3.7000000000000002;4.5;48.380000000000003;1;4;27;4;5;4;5;21;12;8;5;66;992
6;40206;Carragosa;90;100;86;98;39;19;37;18;2;1;5.1280000000000001;5.2629999999999999;12;9;34;0;1;2;0;6.7999999999999998;3.2000000000000002;3.6000000000000001;49.350000000000001;9;3;49;15;14;8;10;49;14;19;5;67;1007
6;40208;Castrelos;63;64;63;63;23;11;19;10;4;1;17.390999999999998;9.0909999999999993;9;5;15;2;0;2;1;6.7000000000000002;3.2999999999999998;3.3999999999999999;57.799999999999997;4;5;27;14;13;1;4;25;19;15;5;67;1009
6;40210;Coelhoso;136;183;140;182;40;38;35;35;5;3;12.5;7.8949999999999996;18;15;37;1;2;4;1;16.100000000000001;6.9000000000000004;9.3000000000000007;59.740000000000002;9;7;58;26;36;8;7;67;47;54;5;67;1011
6;40214;Failde;67;83;68;81;18;11;15;10;3;1;16.667000000000002;9.0909999999999993;3;5;17;0;1;3;0;9.5999999999999996;4.2999999999999998;5.2999999999999998;59.399999999999999;2;6;32;14;13;;6;32;18;27;5;67;1015
6;40217;Gondesende;94;100;91;99;30;25;28;23;2;2;6.6669999999999998;8;3;16;32;1;2;1;0;15;7.2999999999999998;7.7000000000000002;53.619999999999997;12;6;35;22;19;5;8;46;15;26;5;67;1018
6;40225;Nogueira;244;251;233;251;110;102;101;94;9;8;8.1820000000000004;7.843;10;28;157;0;2;9;6;41;20.199999999999999;20.800000000000001;43.909999999999997;45;19;135;27;18;34;16;141;26;34;5;67;1026
6;40231;Pombares;21;20;19;19;7;4;6;2;1;2;14.286;50;4;1;3;0;0;1;2;3.7999999999999998;1.8999999999999999;1.8999999999999999;56.020000000000003;2;2;8;3;6;1;1;11;2;5;5;67;1032
6;40232;Quintanilha;106;110;101;104;39;27;33;26;6;1;15.385;3.7039999999999997;4;9;46;3;1;3;0;10.6;5.2000000000000002;5.4000000000000004;59.030000000000001;2;4;52;30;18;;8;47;23;32;5;67;1033
6;40237;Rio Frio;96;107;100;110;36;23;35;23;1;0;2.778;0;13;10;35;0;0;1;0;6;2.7999999999999998;3.2000000000000002;59.700000000000003;5;5;43;21;22;6;4;32;26;39;5;67;1039
6;40239;Salsas;200;189;203;191;62;41;56;34;6;7;9.6769999999999996;17.073;13;27;50;0;1;6;6;14.9;7.7000000000000002;7.2000000000000002;56.600000000000001;19;13;78;39;51;11;7;75;38;58;5;67;1040
6;40240;Samil;605;641;581;622;317;312;283;279;34;33;10.725999999999999;10.577;7;105;450;4;7;30;26;121.59999999999999;59;62.600000000000001;41.710000000000001;105;71;343;48;38;84;59;370;49;79;5;67;1041
6;40246;Sendas;83;100;80;93;24;20;22;18;2;2;8.3330000000000002;10;5;10;25;0;0;2;2;9.5;4.2999999999999998;5.2000000000000002;61.369999999999997;3;;32;24;24;3;9;31;27;30;5;67;1045
6;40249;Zoio;96;93;94;91;23;12;20;11;3;1;13.042999999999999;8.3330000000000002;11;1;19;0;0;3;1;7.7999999999999998;3.8999999999999999;3.7999999999999998;46.390000000000001;18;12;33;17;16;17;6;36;19;15;5;67;1048
6;40303;Belver;160;162;151;152;63;55;56;43;7;12;11.111000000000001;21.818000000000001;4;19;76;4;4;3;8;31;15.4;15.6;47.950000000000003;18;25;69;22;26;16;17;79;24;26;5;68;1051
6;40507;Carrapatas;97;100;95;101;47;31;42;21;5;10;10.638;32.258000000000003;14;16;33;0;2;5;8;30.300000000000001;14.9;15.4;50.710000000000001;9;10;49;15;14;7;8;43;20;22;5;70;1080
6;40512;Edroso;40;55;38;54;12;15;12;13;0;2;0;13.333;11;4;10;0;1;0;1;7.7000000000000002;3.2999999999999998;4.5;52.560000000000002;3;5;17;8;7;6;2;27;9;11;5;70;1085
6;40519;Lombo;165;181;155;170;68;41;60;36;8;5;11.765000000000001;12.195;34;11;51;1;3;7;2;24;11.5;12.6;52.43;14;19;77;22;33;14;14;81;26;46;5;70;1092
6;40521;Morais;319;325;245;263;125;68;124;67;1;1;0.80000000000000004;1.4710000000000001;77;52;62;1;0;0;1;12.4;6.0999999999999996;6.2000000000000002;46.340000000000003;35;37;159;44;44;39;37;159;49;41;5;70;1094
6;40522;Murçós;60;74;56;71;9;3;9;2;0;1;0;33.332999999999998;3;5;3;0;1;0;0;6.5;2.8999999999999999;3.6000000000000001;56.950000000000003;3;3;28;13;13;3;7;27;20;17;5;70;1095
6;40526;Salselas;196;190;199;191;62;34;59;26;3;8;4.8390000000000004;23.529;19;13;53;0;2;3;6;10.6;5.4000000000000004;5.2000000000000002;54.399999999999999;16;12;91;38;39;11;17;79;41;42;5;70;1099
6;40529;Soutelo Mourisco;17;14;17;14;8;0;8;0;0;0;0;0;7;1;0;0;0;0;0;2.5;1.3999999999999999;1.1000000000000001;62.350000000000001;2;1;7;2;5;;;5;3;6;5;70;1102
6;40604;Duas Igrejas;291;308;271;291;117;93;114;87;3;6;2.5640000000000001;6.452;35;39;127;1;0;2;6;12;5.7999999999999998;6.2000000000000002;52.979999999999997;15;27;145;52;52;24;20;142;67;55;5;71;1116
6;40607;Malhadas;170;174;170;173;69;37;68;36;1;1;1.4490000000000001;2.7029999999999998;14;20;70;0;1;1;0;12.4;6.0999999999999996;6.2999999999999998;47.640000000000001;21;18;81;32;18;20;18;79;33;24;5;71;1119
6;40611;Picote;146;155;142;149;63;45;53;36;10;9;15.872999999999999;20;5;36;48;2;0;8;9;15.5;7.5;8;55.170000000000002;14;10;69;19;34;10;6;69;30;40;5;71;1123
6;40616;Vila Chã de Braciosa;164;163;150;150;66;34;62;25;4;9;6.0609999999999999;26.471;24;25;38;0;3;4;6;7.5999999999999996;3.7999999999999998;3.7999999999999998;56.07;7;10;83;23;41;10;11;65;38;39;5;71;1128
6;40704;Alvites;120;117;118;113;52;22;45;17;7;5;13.462;22.727;19;27;16;0;1;7;4;13.300000000000001;6.7000000000000002;6.5999999999999996;52.729999999999997;13;11;59;18;19;9;5;52;16;35;5;72;1132
6;40705;Avantos;43;53;42;49;18;7;15;6;3;1;16.667000000000002;14.286;6;4;11;0;0;3;1;7.4000000000000004;3.2999999999999998;4.0999999999999996;60.039999999999999;;;22;9;12;6;2;19;13;13;5;72;1133
6;40706;Avidagos;120;125;115;119;60;29;57;27;3;2;5;6.8970000000000002;36;11;37;0;0;3;2;14;6.9000000000000004;7.2000000000000002;51.780000000000001;9;12;63;15;21;7;12;52;29;25;5;72;1134
6;40708;Bouça;125;136;124;135;48;16;46;15;2;1;4.1669999999999998;6.25;19;16;26;0;0;2;1;22.300000000000001;10.699999999999999;11.6;59.490000000000002;6;8;55;27;29;3;13;47;29;44;5;72;1136
6;40722;Múrias;137;144;113;129;48;23;46;21;2;2;4.1669999999999998;8.6959999999999997;32;5;30;0;1;2;1;12.5;6.0999999999999996;6.4000000000000004;57.710000000000001;7;12;55;34;29;10;10;49;31;44;5;72;1150
6;40727;São Pedro Velho;154;175;151;169;37;23;35;20;2;3;5.4050000000000002;13.042999999999999;10;12;33;0;2;2;1;13.9;6.5;7.4000000000000004;54.920000000000002;9;15;72;35;23;12;12;75;34;42;5;72;1155
6;40732;Vale de Gouvinhas;154;165;148;161;59;30;51;22;8;8;13.558999999999999;26.667000000000002;27;21;25;2;2;6;6;18.600000000000001;9;9.5999999999999996;50.68;18;13;73;19;31;11;19;72;34;29;5;72;1160
6;40734;Vale de Telhas;132;151;128;148;65;20;58;17;7;3;10.769;15;22;20;33;1;1;6;2;18.699999999999999;8.6999999999999993;10;51.119999999999997;7;15;72;21;17;9;18;63;28;33;5;72;1162
6;40735;Valverde;71;73;68;72;27;8;26;6;1;2;3.7039999999999997;25;18;7;7;0;0;1;2;8.1999999999999993;4;4.2000000000000002;45.07;7;13;35;11;5;11;5;34;12;11;5;72;1163
6;40809;Meirinhos;141;146;139;139;53;30;49;24;4;6;7.5469999999999997;20;23;20;30;0;4;4;2;5.4000000000000004;2.6000000000000001;2.7000000000000002;49.759999999999998;23;10;55;23;30;12;21;57;25;31;5;73;1174
6;40811;Paradela;77;79;74;79;28;20;25;18;3;2;10.714;10;12;8;23;1;0;2;2;7.5999999999999996;3.7999999999999998;3.8999999999999999;50.93;8;6;35;16;12;10;4;36;14;15;5;73;1176
6;40814;Remondes;102;110;108;109;39;22;32;18;7;4;17.949000000000002;18.181999999999999;16;12;22;0;1;7;3;10.699999999999999;5.0999999999999996;5.5;51.479999999999997;11;7;51;22;11;9;9;52;26;14;5;73;1179
6;40815;Saldanha;79;86;79;86;40;28;39;28;1;0;2.5;0;26;13;28;0;0;1;0;6.4000000000000004;3.1000000000000001;3.2999999999999998;54.240000000000002;5;5;43;9;17;6;5;34;17;24;5;73;1180
6;40820;Travanca;88;84;86;81;37;13;34;12;3;1;8.1080000000000005;7.6920000000000002;12;17;17;2;1;1;0;8.1999999999999993;4.2000000000000002;4;57.530000000000001;6;9;37;18;18;1;4;31;28;20;5;73;1185
6;40905;Carviçais;372;385;362;371;128;88;113;75;15;13;11.718999999999999;14.773;30;40;118;1;2;14;11;12;5.9000000000000004;6.0999999999999996;54.32;30;45;155;60;82;22;23;162;76;102;5;74;1198
6;40906;Castedo;114;122;114;122;59;4;59;4;0;0;0;0;42;7;14;0;0;0;0;13.199999999999999;6.4000000000000004;6.7999999999999998;52.439999999999998;10;13;59;10;22;13;7;45;20;37;5;74;1199
6;40909;Horta da Vilariça;154;156;155;156;57;28;57;28;0;0;0;0;41;14;30;0;0;0;0;18.899999999999999;9.4000000000000004;9.5;55.780000000000001;7;10;84;22;31;5;9;72;33;37;5;74;1202
6;40913;Mós;118;128;118;127;38;28;35;23;3;5;7.8949999999999996;17.856999999999999;15;13;30;3;1;0;4;4.2000000000000002;2;2.2000000000000002;62.780000000000001;5;7;44;26;36;2;4;40;35;47;5;74;1206
6;40915;Souto da Velha;44;49;44;48;13;6;13;4;0;2;0;33.332999999999998;4;6;7;0;0;0;2;7.5;3.5;3.8999999999999999;60.890000000000001;1;2;19;11;11;2;3;15;14;15;5;74;1208
6;40916;Torre de Moncorvo;1354;1537;1316;1513;699;647;655;565;44;82;6.2949999999999999;12.673999999999999;56;178;986;10;23;34;59;80.099999999999994;37.5;42.600000000000001;45.32;172;144;753;157;128;171;165;788;197;216;5;74;1209
6;41009;Roios;73;77;66;75;39;34;37;25;2;9;5.1280000000000001;26.471;10;14;38;0;2;2;7;9.8000000000000007;4.7999999999999998;5;47.130000000000003;10;7;40;11;5;5;9;40;14;9;5;75;1219
6;41012;Santa Comba de Vilariça;195;212;183;201;103;61;100;54;3;7;2.9130000000000003;11.475;46;44;64;0;2;3;5;33.399999999999999;16;17.399999999999999;45.880000000000003;27;16;107;26;19;27;16;112;20;37;5;75;1222
6;41017;Vila Flor;1086;1183;1095;1157;538;514;489;430;49;84;9.1080000000000005;16.341999999999999;70;177;672;10;28;39;56;71.200000000000003;34.100000000000001;37.100000000000001;43.890000000000001;147;125;594;128;92;132;133;629;135;154;5;75;1227
6;41102;Angueira;56;60;50;59;15;8;13;7;2;1;13.333;12.5;10;2;8;0;0;2;1;5.2000000000000002;2.5;2.7000000000000002;59.130000000000003;2;5;26;13;10;3;2;23;16;16;5;76;1231
6;41105;Caçarelhos;115;104;110;104;49;20;46;18;3;2;6.1219999999999999;10;21;13;30;0;1;3;1;7.0999999999999996;3.7000000000000002;3.3999999999999999;54.759999999999998;9;10;49;25;22;8;7;36;36;17;5;76;1234
6;41113;Vilar Seco;96;85;92;81;44;42;41;34;3;8;6.8179999999999996;19.047999999999998;14;17;44;2;5;1;3;7.7000000000000002;4.0999999999999996;3.6000000000000001;52.549999999999997;8;8;49;14;17;3;10;38;21;13;5;76;1242
6;41114;Vimioso;619;666;586;630;336;279;315;253;21;26;6.25;9.3190000000000008;15;105;448;4;8;17;18;23.199999999999999;11.199999999999999;12;45.07;73;64;344;77;61;88;62;340;77;99;5;76;1243
6;41203;Candedo;166;165;163;158;63;38;47;24;16;14;25.396999999999998;36.841999999999999;15;12;44;2;6;14;8;15.4;7.7000000000000002;7.7000000000000002;55.240000000000002;10;9;89;31;27;10;6;82;35;32;5;77;1246
6;41210;Mofreita;27;27;27;27;6;5;6;5;0;0;0;0;0;4;7;0;0;0;0;3.7999999999999998;1.8999999999999999;1.8999999999999999;56.479999999999997;1;1;12;7;6;2;2;11;5;7;5;77;1253
6;41215;Paçó;96;95;95;93;34;20;29;14;5;6;14.706;30;8;7;28;3;5;2;1;11.5;5.7999999999999998;5.7000000000000002;53.57;4;9;51;16;16;6;9;39;18;23;5;77;1258
6;41226;Tuizelo;193;194;188;188;72;23;67;23;5;0;6.944;0;27;26;37;2;0;3;0;12.300000000000001;6.2000000000000002;6.2000000000000002;57.460000000000001;6;15;89;46;37;6;9;87;48;44;5;77;1269
6;41231;Vilar de Lomba;103;96;126;117;36;22;34;21;2;1;5.556;4.5449999999999999;16;8;31;0;0;2;1;9.5999999999999996;5;4.5999999999999996;47.939999999999998;17;14;44;11;17;8;9;50;13;16;5;77;1274
6;50103;Colmeal da Torre;358;371;341;366;182;164;160;149;22;15;12.087999999999999;9.1460000000000008;19;153;137;2;5;20;10;98.299999999999997;48.299999999999997;50;48.229999999999997;36;41;186;47;48;28;29;203;50;61;6;78;1281
6;50202;Almaceda;310;367;274;340;87;56;74;50;13;6;14.943;10.714;10;37;77;4;2;9;4;9.4000000000000004;4.2999999999999998;5.0999999999999996;60.280000000000001;13;21;139;61;76;9;21;125;81;131;6;79;1285
6;50206;Cebolais de Cima;485;541;467;526;183;164;166;145;17;19;9.2899999999999991;11.585000000000001;4;99;208;3;5;14;14;79.799999999999997;37.700000000000003;42.100000000000001;55.090000000000003;41;35;239;83;87;27;33;227;106;148;6;79;1289
6;50212;Louriçal do Campo;313;323;292;315;108;81;97;76;11;5;10.185;6.173;16;48;109;1;2;10;3;28.5;14;14.5;51.359999999999999;33;50;128;47;55;22;32;137;51;81;6;79;1295
6;50221;Santo André das Tojeiras;345;402;336;389;79;58;68;53;11;5;13.923999999999999;8.6210000000000004;7;29;85;1;0;10;5;10;4.5999999999999996;5.4000000000000004;65.170000000000002;6;10;128;75;126;8;6;123;103;162;6;79;1304
6;50301;Vila do Carvalho;853;888;805;852;372;327;317;266;55;61;14.785;18.654;2;245;336;8;9;47;52;175.30000000000001;85.900000000000006;89.400000000000006;48.240000000000002;91;87;471;123;81;71;87;464;132;134;6;80;1339
6;50303;Aldeia do Souto;111;129;105;126;48;44;42;36;6;8;12.5;18.181999999999999;7;38;33;1;2;5;6;31.600000000000001;14.6;17;46.390000000000001;7;20;56;21;7;7;23;61;18;20;6;80;1310
6;50309;Dominguizo;554;565;531;542;265;238;219;188;46;50;17.358000000000001;21.007999999999999;7;120;280;6;7;40;43;226.09999999999999;111.90000000000001;114.2;44.100000000000001;97;52;300;58;47;63;51;307;66;78;6;80;1322
6;50317;Covilhã (Santa Maria);1448;1772;1759;2152;727;786;643;697;84;89;11.554;11.323;6;204;1130;16;17;68;72;1628.4000000000001;732.29999999999995;896.20000000000005;45.890000000000001;195;144;816;124;169;172;144;908;202;346;6;80;1319
6;50329;Coutada;191;215;182;195;76;66;69;58;7;8;9.2110000000000003;12.121;8;45;74;0;0;7;8;40.799999999999997;19.199999999999999;21.600000000000001;51.280000000000001;21;12;94;27;37;21;15;97;43;39;6;80;1317
6;50406;Alpedrinha;523;564;484;536;246;197;214;173;32;24;13.007999999999999;12.183;55;107;225;6;1;26;23;67.200000000000003;32.299999999999997;34.799999999999997;48.25;62;61;262;60;78;57;55;264;74;114;6;81;1345
6;50409;Bogas de Baixo;95;99;91;97;21;16;20;14;1;2;4.7620000000000005;12.5;10;10;14;0;0;1;2;5.5999999999999996;2.7999999999999998;2.8999999999999999;67.120000000000005;1;3;37;21;33;1;2;30;29;37;6;81;1348
6;50412;Castelejo;299;357;283;350;129;115;113;100;16;15;12.403;13.042999999999999;19;83;111;1;4;15;11;22.199999999999999;10.1;12.1;49.119999999999997;36;22;154;41;46;38;31;157;71;60;6;81;1351
6;50413;Castelo Novo;194;212;185;207;83;75;75;65;8;10;9.6389999999999993;13.333;37;24;79;1;2;7;8;10;4.7999999999999998;5.2000000000000002;47.280000000000001;19;22;99;23;31;24;26;97;25;40;6;81;1352
6;50417;Fundão;4421;4815;4160;4575;2245;2253;1978;1932;267;321;11.893000000000001;14.247999999999999;91;751;3068;61;60;206;261;519.29999999999995;248.59999999999999;270.69999999999999;41.859999999999999;727;549;2397;432;316;650;511;2660;478;516;6;81;1357
6;50419;Lavacolhos;119;117;118;117;49;29;47;23;2;6;4.0819999999999999;20.690000000000001;2;33;35;0;2;2;4;11.9;6;5.9000000000000004;53.909999999999997;7;10;60;24;18;6;10;56;23;22;6;81;1359
6;50422;Póvoa de Atalaia;295;347;276;317;108;96;83;74;25;22;23.148;22.917000000000002;14;59;84;2;2;23;20;50.700000000000003;23.300000000000001;27.399999999999999;53.479999999999997;18;35;134;57;51;24;26;141;62;94;6;81;1363
6;50426;Souto da Casa;372;435;362;424;153;139;134;120;19;19;12.417999999999999;13.669;7;82;165;5;4;14;15;27.5;12.699999999999999;14.800000000000001;50.950000000000003;37;39;188;47;61;34;37;192;67;105;6;81;1367
6;50428;Vale de Prazeres;587;680;572;674;189;140;151;112;38;28;20.106000000000002;20;59;67;137;6;5;32;23;23.300000000000001;10.800000000000001;12.5;54.659999999999997;48;39;274;98;128;49;43;273;134;181;6;81;1369
6;50502;Aldeia de Santa Margarida;144;148;142;147;56;24;49;16;7;8;12.5;33.332999999999998;14;19;32;0;4;7;4;21.399999999999999;10.6;10.9;56.119999999999997;14;12;67;22;29;9;6;56;28;49;6;82;1372
6;50504;Idanha-a-Velha;30;33;28;33;7;6;7;6;0;0;0;0;3;0;10;0;0;0;0;3;1.3999999999999999;1.6000000000000001;63.25;1;1;11;7;10;1;2;9;12;9;6;82;1374
6;50506;Medelim;126;146;121;142;33;26;24;24;9;2;27.273;7.6920000000000002;3;5;40;1;0;8;2;8.9000000000000004;4.0999999999999996;4.7999999999999998;59.490000000000002;7;8;50;25;36;10;6;47;31;52;6;82;1376
6;50509;Oledo;162;193;160;192;59;47;58;44;1;3;1.6949999999999998;6.383;22;24;56;0;0;1;3;12.800000000000001;5.9000000000000004;7;55.619999999999997;16;11;74;21;40;14;12;73;31;63;6;82;1379
6;50512;Rosmaninhal;261;276;265;266;54;40;42;34;12;6;22.222000000000001;15;23;14;39;0;0;12;6;2;1;1;61.420000000000002;21;13;87;49;91;11;9;81;68;107;6;82;1382
6;50515;Segura;87;89;85;86;17;13;12;12;5;1;29.411999999999999;7.6920000000000002;6;3;15;0;0;5;1;2.3999999999999999;1.2;1.2;62.719999999999999;6;5;28;24;24;1;;27;39;22;6;82;1385
6;50605;Isna;102;107;76;87;29;15;29;15;0;0;0;0;5;18;21;0;0;0;0;7.5;3.7000000000000002;3.7999999999999998;58.829999999999998;3;7;51;18;23;1;8;49;21;28;6;83;1392
6;50609;Orvalho;298;380;275;368;101;80;93;74;8;6;7.9210000000000003;7.5;11;47;109;2;2;6;4;20.399999999999999;9;11.4;57.490000000000002;20;26;132;69;51;20;22;130;70;138;6;83;1396
6;50610;Sarnadas de São Simão;100;117;98;117;40;14;40;14;0;0;0;0;1;30;23;0;0;0;0;7;3.2000000000000002;3.7999999999999998;58.659999999999997;3;8;48;20;21;2;6;51;21;37;6;83;1397
6;50611;Sobral;82;78;78;78;25;8;22;8;3;0;12;0;4;5;21;0;0;3;0;8.4000000000000004;4.2999999999999998;4.0999999999999996;54.229999999999997;5;11;45;13;8;2;4;35;15;22;6;83;1398
6;50612;Vilar Barroco;61;53;61;53;19;8;19;8;0;0;0;0;2;14;11;0;0;0;0;4.7999999999999998;2.6000000000000001;2.2999999999999998;61.609999999999999;4;;28;11;18;1;;14;16;22;6;83;1399
6;50801;Alvito da Beira;173;189;163;180;50;37;45;31;5;6;10;16.216000000000001;21;11;44;0;1;5;5;10.9;5.2000000000000002;5.7000000000000002;62.560000000000002;5;7;70;36;55;8;6;60;44;71;6;85;1412
6;50805;São Pedro do Esteval;262;265;246;247;102;62;101;58;1;4;0.97999999999999998;6.452;20;59;80;0;2;1;2;7.7000000000000002;3.7999999999999998;3.8999999999999999;53.490000000000002;13;32;125;32;60;21;21;110;44;69;6;85;1416
6;50903;Castelo;505;541;418;478;228;158;198;135;30;23;13.157999999999999;14.557;28;112;193;5;5;25;18;42.600000000000001;20.600000000000001;22;46.159999999999997;67;56;263;64;55;53;69;244;88;87;6;86;1420
6;50905;Cumeada;247;256;233;246;101;81;96;68;5;13;4.9500000000000002;16.048999999999999;8;67;89;1;2;4;11;21.699999999999999;10.699999999999999;11.1;51.200000000000003;33;21;120;28;45;24;12;103;40;77;6;86;1422
6;50906;Ermida;112;106;99;100;50;47;47;43;3;4;6;8.5109999999999992;36;20;34;0;1;3;3;8.1999999999999993;4.2000000000000002;4;56.210000000000001;1;8;57;19;27;7;6;50;24;19;6;86;1423
6;50908;Marmeleiro;101;127;90;115;25;21;22;20;3;1;12;4.7620000000000005;11;11;20;1;0;2;1;8;3.5;4.4000000000000004;63.240000000000002;6;5;40;20;30;4;7;39;25;52;6;86;1425
6;50910;Palhais;122;146;120;143;37;21;32;18;5;3;13.513999999999999;14.286;5;18;27;0;1;5;2;12.199999999999999;5.5999999999999996;6.7000000000000002;58.780000000000001;6;9;51;31;25;7;9;42;44;44;6;86;1427
6;50914;Várzea dos Cavaleiros;390;430;368;415;136;91;134;81;2;10;1.4710000000000001;10.989000000000001;32;76;107;1;4;1;6;23.800000000000001;11.300000000000001;12.5;54.729999999999997;35;36;173;66;80;36;28;172;69;125;6;86;1431
6;51103;Sarnadas de Ródão;289;348;281;339;93;71;83;66;10;5;10.753;7.0419999999999998;6;42;101;1;1;9;4;10.699999999999999;4.7999999999999998;5.7999999999999998;58.350000000000001;31;19;116;47;76;19;15;110;54;150;6;88;1437
6;60116;Secarias;200;230;185;218;99;92;89;81;10;11;10.101000000000001;11.957000000000001;4;66;100;1;4;9;7;62;28.800000000000001;33.100000000000001;45.299999999999997;20;29;105;31;15;22;34;118;27;29;7;89;1454
6;60203;Cadima;1455;1508;1344;1458;705;572;645;516;60;56;8.5109999999999992;9.7899999999999991;83;502;576;16;13;44;43;109.8;53.899999999999999;55.899999999999999;43.850000000000001;192;176;809;153;125;181;152;820;187;168;7;90;1459
6;60210;Outil;420;438;401;427;210;171;186;156;24;15;11.429;8.7720000000000002;18;94;230;3;2;21;13;55.899999999999999;27.399999999999999;28.600000000000001;46.960000000000001;45;38;233;51;53;54;30;227;55;72;7;90;1468
6;60215;São Caetano;394;407;381;408;186;146;165;128;21;18;11.289999999999999;12.329000000000001;24;77;192;4;4;17;14;42.100000000000001;20.699999999999999;21.399999999999999;47.979999999999997;52;37;204;56;45;39;26;207;68;67;7;90;1472
6;60217;Vilamar;361;419;326;398;168;152;152;133;16;19;9.5240000000000009;12.5;9;53;223;6;4;10;15;137.80000000000001;63.799999999999997;74;46.880000000000003;51;41;193;43;33;46;38;191;51;93;7;90;1475
6;60303;Ameal;800;882;757;871;373;366;343;338;30;28;8.0429999999999993;7.6500000000000004;4;154;523;6;5;24;23;149.5;71.099999999999994;78.400000000000006;45.450000000000003;107;86;435;93;79;95;95;463;118;111;7;91;1477
6;60305;Antuzede;1098;1178;1025;1125;583;532;532;464;51;68;8.7479999999999993;12.782;10;255;731;8;17;43;51;282.10000000000002;136.09999999999999;146;43.18;146;126;654;109;63;150;110;667;140;111;7;91;1479
6;60306;Arzila;319;336;308;321;144;148;136;136;8;12;5.556;8.1080000000000005;3;52;217;0;2;8;10;190.09999999999999;92.599999999999994;97.5;45.810000000000002;48;33;169;33;36;36;27;179;36;58;7;91;1480
6;60307;Assafarge;1336;1410;1262;1369;709;694;640;623;69;71;9.7319999999999993;10.231;4;229;1030;18;14;51;57;282.39999999999998;137.40000000000001;145;41.189999999999998;197;172;783;123;61;206;161;818;106;119;7;91;1481
6;60309;Brasfemes;949;1020;896;968;500;490;455;449;45;41;9;8.3670000000000009;0;154;750;8;7;37;34;214.5;103.40000000000001;111.09999999999999;42.109999999999999;144;91;562;93;59;133;111;589;112;75;7;91;1483
6;60310;Castelo Viegas;818;877;845;901;358;385;319;345;39;40;10.894;10.390000000000001;7;108;549;6;8;33;32;227.09999999999999;109.59999999999999;117.5;45.719999999999999;102;72;466;104;74;94;78;489;106;110;7;91;1484
6;60312;Cernache;1922;2126;1807;2072;998;992;908;892;90;100;9.0180000000000007;10.081;7;336;1457;19;17;71;83;211.19999999999999;100.3;110.90000000000001;43.729999999999997;286;207;1107;160;162;274;203;1155;196;298;7;91;1486
6;60313;Eiras;5578;6519;5256;6268;2939;3428;2527;3024;412;404;14.018000000000001;11.785;12;735;4804;88;91;324;313;1233.8;568.89999999999998;664.89999999999998;40.340000000000003;880;691;3256;468;283;826;672;3962;573;486;7;91;1491
6;60317;Coimbra (Santa Cruz);2544;3155;2658;3413;1244;1313;1041;1158;203;155;16.318000000000001;11.805;5;257;1937;32;33;171;122;1024.8;457.5;567.29999999999995;46.560000000000002;301;295;1400;278;270;286;300;1569;428;572;7;91;1488
6;60320;São João do Campo;1010;1063;936;1034;508;486;470;451;38;35;7.4800000000000004;7.202;32;244;645;8;10;30;25;261.80000000000001;127.5;134.19999999999999;42.590000000000003;143;107;589;100;71;131;107;604;124;97;7;91;1496
6;60326;Souselas;1514;1578;1420;1528;724;687;648;617;76;70;10.497;10.189;15;348;902;18;9;58;61;196.5;96.200000000000003;100.3;43.43;224;164;841;183;102;204;135;884;190;165;7;91;1501
6;60329;Torres do Mondego;1142;1260;1106;1231;562;533;498;498;64;35;11.388;6.5670000000000002;8;178;810;9;7;55;28;144.19999999999999;68.5;75.599999999999994;46.670000000000002;130;103;653;135;121;130;104;672;189;165;7;91;1504
6;60403;Bem da Fé;59;53;51;51;27;20;21;16;6;4;22.222000000000001;20;0;9;28;1;0;5;4;29.699999999999999;15.699999999999999;14.1;47.25;5;9;32;8;5;5;2;30;8;8;7;92;1509
6;60512;Tavarede;4576;4865;4175;4594;2441;2484;2185;2139;256;345;10.488;13.888999999999999;42;1137;3145;42;53;214;292;880.5;426.80000000000001;453.69999999999999;39.119999999999997;830;483;2668;362;233;746;461;2934;399;325;7;93;1533
6;60513;Vila Verde;1440;1528;1332;1465;649;575;539;464;110;111;16.949000000000002;19.303999999999998;10;336;657;17;24;93;87;119.40000000000001;57.899999999999999;61.5;45.649999999999999;196;158;777;164;145;177;134;811;202;204;7;93;1534
6;60603;Colmeal;71;87;70;91;19;16;16;15;3;1;15.789;6.25;5;8;18;0;0;3;1;4.7999999999999998;2.2000000000000002;2.6000000000000001;59.090000000000003;8;3;27;17;16;6;2;26;22;31;7;94;1537
6;60703;Lousã;4886;5277;4596;5088;2451;2361;2218;2058;233;303;9.5060000000000002;12.834;82;990;3204;47;47;186;256;215.80000000000001;103.7;112.09999999999999;40.390000000000001;859;526;2762;443;296;757;530;2982;523;485;7;95;1543
6;60801;Mira;3450;3917;3256;3789;1609;1524;1456;1329;153;195;9.5090000000000003;12.795;155;697;1933;20;34;133;161;116.7;54.600000000000001;62;46.609999999999999;476;337;1823;478;336;400;317;2029;603;568;7;96;1547
6;60802;Seixo;568;666;551;667;253;255;232;233;21;22;8.3000000000000007;8.6270000000000007;61;125;279;6;3;15;19;76;35;41;47.619999999999997;75;61;277;84;71;76;65;305;95;125;7;96;1549
6;60804;Praia de Mira;1526;1621;1409;1574;737;676;668;566;69;110;9.3620000000000001;16.271999999999998;157;386;691;16;22;53;88;78.099999999999994;37.899999999999999;40.200000000000003;42.439999999999998;221;186;817;189;113;206;184;896;182;153;7;96;1548
6;61004;Gatões;263;253;248;247;120;93;108;84;12;9;10;9.6769999999999996;8;54;130;2;3;10;6;91.400000000000006;46.600000000000001;44.799999999999997;47.289999999999999;30;38;126;35;34;27;19;131;30;46;7;98;1559
6;61005;Liceia;608;646;526;623;309;246;284;219;25;27;8.0909999999999993;10.975999999999999;32;219;252;2;7;23;20;98.799999999999997;47.899999999999999;50.899999999999999;44.530000000000001;76;72;335;62;63;75;64;348;91;68;7;98;1560
6;61014;Ereira;315;334;296;325;152;129;141;118;11;11;7.2370000000000001;8.5269999999999992;13;70;176;3;2;8;9;89.599999999999994;43.5;46.100000000000001;48.350000000000001;38;25;178;36;38;27;25;177;49;56;7;98;1558
6;61103;Avô;289;306;272;296;116;92;107;80;9;12;7.7590000000000003;13.042999999999999;2;77;108;1;2;8;10;83;40.299999999999997;42.700000000000003;52.880000000000003;26;37;126;50;50;26;21;128;49;82;7;99;1571
6;61107;Lagos da Beira;374;408;352;392;188;158;168;138;20;20;10.638;12.657999999999999;5;129;172;2;5;18;15;93.900000000000006;44.899999999999999;49;45.549999999999997;43;53;198;43;37;49;44;201;61;53;7;99;1575
6;61110;Meruge;258;297;253;297;124;122;107;112;17;10;13.710000000000001;8.1969999999999992;2;101;116;6;3;11;7;76.599999999999994;35.600000000000001;41;48.079999999999998;37;24;131;36;30;31;20;157;46;43;7;99;1578
6;61114;Santa Ovaia;291;306;266;296;160;111;144;95;16;16;10;14.414;2;114;123;4;4;12;12;190;92.599999999999994;97.400000000000006;45.539999999999999;31;36;170;29;25;31;37;155;31;52;7;99;1582
6;61115;São Gião;206;219;193;216;85;55;76;50;9;5;10.587999999999999;9.0909999999999993;6;60;60;1;0;8;5;29.199999999999999;14.199999999999999;15.1;52.619999999999997;12;22;93;42;37;18;17;94;49;41;7;99;1583
6;61118;Seixo da Beira;780;820;725;786;345;264;309;215;36;49;10.435;18.561;20;292;212;6;6;30;43;47.399999999999999;23.100000000000001;24.300000000000001;45.43;123;73;397;101;86;104;78;410;108;120;7;99;1586
6;61203;Fajão;106;127;100;115;40;22;34;19;6;3;15;13.635999999999999;4;18;31;1;0;5;3;3.5;1.6000000000000001;1.8999999999999999;59.32;5;9;50;23;19;7;3;39;33;45;7;100;1592
6;61204;Janeiro de Baixo;332;337;305;315;121;64;110;63;11;1;9.0909999999999993;1.5629999999999999;5;92;76;3;0;8;1;16.399999999999999;8.1999999999999993;8.3000000000000007;54.350000000000001;25;22;175;64;46;17;20;160;75;65;7;100;1593
6;61206;Pampilhosa da Serra;602;787;614;782;265;254;247;237;18;17;6.7919999999999998;6.6929999999999996;2;88;394;2;4;16;13;13.9;6;7.9000000000000004;51.75;70;51;285;78;118;79;53;306;116;233;7;100;1595
6;61302;Figueira de Lorvão;1307;1430;1223;1424;706;590;633;542;73;48;10.34;8.1359999999999992;25;319;831;16;11;57;37;102.59999999999999;49;53.600000000000001;43.100000000000001;182;147;748;132;98;181;157;747;163;182;7;101;1601
6;61401;Cumeeira;503;569;466;529;241;192;225;166;16;26;6.6390000000000002;13.542;10;141;240;1;2;15;24;50.299999999999997;23.600000000000001;26.699999999999999;48.119999999999997;57;51;261;71;63;59;58;261;93;98;7;102;1611
6;61403;Podentes;235;250;228;241;109;91;103;86;6;5;5.5049999999999999;5.4950000000000001;6;47;136;0;0;6;5;28.100000000000001;13.6;14.5;47.630000000000003;29;21;123;38;24;25;22;122;43;38;7;102;1615
6;61404;Rabaçal;145;146;135;139;56;45;47;36;9;9;16.071000000000002;20;1;23;59;1;0;8;9;32.399999999999999;16.199999999999999;16.300000000000001;51.810000000000002;15;13;74;14;29;13;10;68;23;32;7;102;1616
6;61405;Penela (Santa Eufémia);813;947;798;957;341;331;316;297;25;34;7.3310000000000004;10.272;11;160;442;4;5;21;29;70.099999999999994;32.399999999999999;37.700000000000003;47;113;86;404;114;96;119;70;457;120;181;7;102;1613
6;61502;Brunhós;83;97;82;95;35;37;33;34;2;3;5.7140000000000004;8.1080000000000005;2;20;45;1;0;1;3;66.099999999999994;30.5;35.600000000000001;47.780000000000001;10;6;41;15;11;10;4;55;15;13;7;103;1618
6;61505;Gesteira;464;510;419;494;199;157;178;142;21;15;10.553000000000001;9.5540000000000003;13;83;224;3;4;18;11;69.400000000000006;33.100000000000001;36.399999999999999;50.869999999999997;52;45;228;60;79;45;38;230;75;122;7;103;1621
6;61510;Tapéus;165;173;158;171;71;53;65;47;6;6;8.4510000000000005;11.321;4;34;74;0;5;6;1;24.399999999999999;11.9;12.5;50.75;16;14;88;24;23;16;11;81;33;32;7;103;1626
6;61512;Vinha da Rainha;660;737;620;709;296;255;277;231;19;24;6.4189999999999996;9.4120000000000008;22;170;316;3;6;16;18;68.5;32.399999999999999;36.200000000000003;49.109999999999999;70;59;354;86;91;72;57;352;106;150;7;103;1628
6;61605;Covelo;120;127;110;123;61;38;56;33;5;5;8.1969999999999992;13.157999999999999;14;46;29;1;0;4;5;18.399999999999999;8.9000000000000004;9.5;44.399999999999999;16;20;65;11;8;15;11;65;12;24;7;104;1633
6;61610;Pinheiro de Coja;142;166;143;163;60;43;51;36;9;7;15;16.279;4;36;47;0;0;9;7;25.199999999999999;11.6;13.6;46.740000000000002;21;8;75;21;17;26;12;70;30;28;7;104;1638
6;61612;São João da Boa Vista;229;224;221;222;90;65;70;61;20;4;22.222000000000001;6.1539999999999999;4;48;79;2;3;18;1;46;23.199999999999999;22.699999999999999;47.270000000000003;38;25;104;30;32;22;19;102;41;40;7;104;1640
6;61613;Sinde;173;200;168;202;79;62;74;57;5;5;6.3289999999999997;8.0649999999999995;9;66;56;2;2;3;3;26.899999999999999;12.5;14.4;51.25;20;18;84;30;21;20;10;86;35;49;7;104;1641
6;61704;São Miguel de Poiares;647;684;615;665;316;270;280;243;36;27;11.391999999999999;10;22;140;361;7;7;29;20;64.799999999999997;31.5;33.299999999999997;43.270000000000003;98;73;360;62;54;92;64;371;74;83;7;105;1647
6;70102;Juromenha (Nossa Senhora do Loreto);60;47;58;43;29;19;27;14;2;5;6.8970000000000002;26.315999999999999;17;6;18;0;0;2;5;3.2999999999999998;1.8999999999999999;1.5;49.869999999999997;5;6;31;8;10;4;3;24;8;8;8;106;1650
6;70106;São Brás dos Matos (Mina do Bugalho);180;184;171;175;104;70;93;49;11;21;10.577;30;32;64;46;1;1;10;20;5.7000000000000002;2.7999999999999998;2.8999999999999999;45.329999999999998;14;24;105;17;20;27;13;87;24;33;8;106;1652
6;70204;São Gregório;167;174;164;170;79;66;77;56;2;10;2.532;15.151999999999999;24;32;77;1;0;1;10;4.5999999999999996;2.2999999999999998;2.2999999999999998;50.990000000000002;17;13;83;23;31;12;14;75;34;39;8;107;1659
6;70402;Glória;261;271;249;260;134;99;126;86;8;13;5.9699999999999998;13.131;50;62;100;3;3;5;10;7.2999999999999998;3.6000000000000001;3.7000000000000002;47.619999999999997;24;33;132;37;35;29;25;126;48;43;8;109;1669
6;70403;Estremoz (Santa Maria);3042;3242;2889;3125;1515;1448;1386;1299;129;149;8.5150000000000006;10.289999999999999;130;458;2097;29;30;100;119;99.299999999999997;48.100000000000001;51.200000000000003;43.5;457;331;1607;319;328;415;324;1690;407;406;8;109;1666
6;70407;Santo Estêvão;34;40;34;39;15;11;15;10;0;1;0;9.0909999999999993;8;3;14;0;1;0;0;2.2000000000000002;1;1.2;51.740000000000002;4;3;14;3;10;2;7;13;9;9;8;109;1671
6;70506;São Bento do Mato;564;587;538;568;260;241;232;222;28;19;10.769;7.8840000000000003;33;128;293;6;2;22;17;17.300000000000001;8.5;8.8000000000000007;48.200000000000003;79;43;287;60;95;58;48;281;89;111;8;110;1689
6;70509;São Miguel de Machede;394;400;401;425;196;153;177;142;19;11;9.6939999999999991;7.1900000000000004;24;71;224;6;2;13;9;9.6999999999999993;4.7999999999999998;4.9000000000000004;47.579999999999998;41;45;213;38;57;40;37;201;49;73;8;110;1691
6;70513;Torre de Coelheiros;353;362;323;334;187;153;164;140;23;13;12.298999999999999;8.4969999999999999;71;78;155;1;0;22;13;3.2000000000000002;1.6000000000000001;1.6000000000000001;47.759999999999998;46;42;170;31;64;42;30;173;45;72;8;110;1696
6;70515;Canaviais;1692;1750;1650;1702;864;872;792;796;72;76;8.3330000000000002;8.7159999999999993;43;271;1274;17;18;55;58;177.30000000000001;87.200000000000003;90.200000000000003;39.310000000000002;333;182;951;114;112;272;181;987;140;170;8;110;1679
6;70517;Bacelo;4536;4773;4272;4624;2491;2526;2260;2286;231;240;9.2729999999999997;9.5009999999999994;93;816;3637;49;56;182;184;903.79999999999995;440.39999999999998;463.39999999999998;39.020000000000003;795;515;2725;282;219;712;520;2909;314;318;8;110;1678
6;70519;Malagueira;5833;6540;5537;6308;3003;3109;2607;2729;396;380;13.186999999999999;12.223000000000001;154;895;4287;77;62;319;318;649.5;306.19999999999999;343.30000000000001;41.469999999999999;952;662;3333;491;395;919;722;3729;620;550;8;110;1683
6;70521;Senhora da Saúde;4145;4779;4072;4753;1975;1984;1751;1769;224;215;11.342000000000001;10.837;114;568;2838;36;40;188;175;246.5;114.5;132;46.240000000000002;529;443;2172;507;494;523;408;2438;650;760;8;110;1695
6;150801;Marateca;1853;1871;1811;1839;947;781;789;650;158;131;16.684000000000001;16.773;190;394;855;11;18;147;113;28.399999999999999;14.199999999999999;14.300000000000001;42.890000000000001;310;194;990;219;140;263;176;992;245;195;17;253;3296
6;150904;Ermidas-Sado;979;1041;929;1007;526;420;473;351;53;69;10.076000000000001;16.428999999999998;76;270;478;6;12;47;57;24.5;11.9;12.6;47.770000000000003;118;85;530;119;127;104;75;528;151;183;17;254;3304
6;150911;Vale de Água;303;312;289;305;142;85;133;69;9;16;6.3380000000000001;18.824000000000002;52;61;89;0;1;9;15;8.0999999999999996;4;4.0999999999999996;49.960000000000001;31;19;163;37;53;34;20;154;46;58;17;254;3311
6;151203;Setúbal (São Julião);7669;9071;7106;8597;3852;4040;3316;3529;536;511;13.914999999999999;12.649000000000001;63;1315;5467;105;120;431;391;3451;1581;1870;44.189999999999998;1087;873;4240;868;601;1112;860;4920;1077;1102;17;257;3327
6;151302;Porto Covo;516;522;548;529;268;214;245;185;23;29;8.5820000000000007;13.551;38;109;283;3;5;20;24;20.5;10.199999999999999;10.300000000000001;45.700000000000003;64;52;276;64;60;69;40;282;69;62;17;258;3329
6;160104;Ázere;111;136;110;133;44;35;40;28;4;7;9.0909999999999993;20;12;21;35;1;2;3;5;77.700000000000003;34.899999999999999;42.799999999999997;48.780000000000001;13;13;53;21;11;9;17;65;17;28;18;259;3336
6;160106;Cabreiro;177;251;171;249;49;55;45;52;4;3;8.1630000000000003;5.4550000000000001;40;24;33;1;1;3;2;10.300000000000001;4.2000000000000002;6;56.890000000000001;17;9;78;32;41;17;12;89;76;57;18;259;3338
6;160108;Cendufe;168;192;160;191;88;75;73;62;15;13;17.045000000000002;17.332999999999998;12;62;61;2;3;13;10;114;53.200000000000003;60.799999999999997;43.380000000000003;16;29;87;20;16;23;28;94;25;22;18;259;3340
6;160111;Ermelo;43;49;43;49;9;3;8;3;1;0;11.111000000000001;0;0;7;4;0;0;1;0;7.4000000000000004;3.3999999999999999;3.8999999999999999;61.329999999999998;3;2;18;7;13;2;;15;14;18;18;259;3343
6;160114;Giela;231;283;222;286;107;112;91;98;16;14;14.952999999999999;12.5;3;36;150;3;4;13;10;261.39999999999998;117.5;143.90000000000001;40.130000000000003;43;28;134;20;6;36;42;142;31;32;18;259;3346
6;160116;Grade;180;213;182;218;51;36;45;33;6;3;11.765000000000001;8.3330000000000002;8;29;41;1;0;5;3;85.299999999999997;39.100000000000001;46.299999999999997;51.130000000000003;21;15;77;42;25;25;15;94;29;50;18;259;3348
6;160117;Guilhadeses;520;599;486;568;241;206;216;177;25;29;10.372999999999999;14.077999999999999;2;153;238;2;4;23;25;374.10000000000002;173.90000000000001;200.30000000000001;43.200000000000003;90;51;269;71;39;92;50;292;88;77;18;259;3349
6;160120;Mei;53;65;46;60;18;18;16;15;2;3;11.111000000000001;16.667000000000002;5;13;13;0;1;2;2;56.100000000000001;25.199999999999999;30.899999999999999;48.450000000000003;8;7;26;7;5;5;6;33;13;8;18;259;3353
6;160121;Miranda;140;185;139;185;37;27;34;22;3;5;8.1080000000000005;18.518999999999998;8;23;25;0;2;3;3;32.399999999999999;14;18.5;56.710000000000001;12;9;51;31;37;7;19;72;42;45;18;259;3354
6;160122;Monte Redondo;102;125;101;131;35;23;31;19;4;4;11.429;17.390999999999998;5;26;19;1;0;3;4;95.299999999999997;42.799999999999997;52.5;50.439999999999998;8;16;53;12;13;14;10;50;18;33;18;259;3355
6;160123;Oliveira;140;190;136;187;54;48;52;46;2;2;3.7039999999999997;4.1669999999999998;3;42;53;0;0;2;2;102.90000000000001;43.700000000000003;59.200000000000003;46.039999999999999;18;15;66;25;16;24;21;91;22;32;18;259;3356
6;160128;Prozelo;452;491;438;481;197;149;179;126;18;23;9.1370000000000005;15.436;8;104;193;3;4;15;19;238.40000000000001;114.3;124.09999999999999;49.310000000000002;45;51;243;57;56;40;46;229;62;114;18;259;3363
6;160129;Rio Cabrão;64;71;65;72;19;19;18;16;1;3;5.2629999999999999;15.789;4;18;12;0;2;1;1;77.900000000000006;36.899999999999999;41;45.5;14;4;29;11;6;7;8;35;11;10;18;259;3364
6;160131;Rio de Moinhos;198;240;200;241;80;60;68;49;12;11;15;18.332999999999998;5;34;78;3;2;9;9;122;55.100000000000001;66.799999999999997;52.789999999999999;16;24;102;27;29;13;14;112;41;60;18;259;3365
6;160135;Padreiro (Salvador);132;169;133;171;62;47;53;42;9;5;14.516;10.638;5;39;51;1;3;8;2;146.5;64.200000000000003;82.200000000000003;48;19;13;67;19;14;22;12;77;31;27;18;259;3358
6;160136;Padreiro (Santa Cristina);35;41;38;42;10;3;9;2;1;1;10;33.332999999999998;0;8;3;0;0;1;1;32.100000000000001;14.800000000000001;17.300000000000001;61.719999999999999;;;18;12;5;2;1;14;14;10;18;259;3359
6;160137;Távora (Santa Maria);337;353;318;338;152;118;139;104;13;14;8.5530000000000008;11.864000000000001;17;110;116;2;3;11;11;159.59999999999999;77.900000000000006;81.599999999999994;47.310000000000002;43;35;175;48;36;37;24;177;52;63;18;259;3377
6;160139;São Cosme e São Damião;85;105;82;104;29;31;25;28;4;3;13.792999999999999;9.6769999999999996;4;24;25;0;1;4;2;64.200000000000003;28.699999999999999;35.5;51.189999999999998;12;9;40;12;12;5;8;48;20;24;18;259;3370
6;160144;Senharei;116;143;104;124;37;18;30;17;7;1;18.919;5.556;2;17;28;1;0;6;1;34.399999999999999;15.4;19;56.240000000000002;7;6;62;19;22;4;9;66;27;37;18;259;3372
6;160145;Sistelo;110;163;108;160;22;25;19;25;3;0;13.635999999999999;0;12;7;25;1;0;2;0;10.4;4.2000000000000002;6.2000000000000002;59.460000000000001;10;8;39;26;27;6;7;62;40;48;18;259;3373
6;160147;Souto;286;336;277;321;131;107;105;89;26;18;19.847000000000001;16.821999999999999;11;89;94;2;4;24;14;151.40000000000001;69.599999999999994;81.799999999999997;43.140000000000001;51;34;144;28;29;52;35;158;44;47;18;259;3375
6;160201;Âncora;576;606;544;596;287;250;256;219;31;31;10.801;12.4;23;121;331;6;8;25;23;218.19999999999999;106.3;111.90000000000001;42.520000000000003;98;67;311;50;50;74;62;331;65;74;18;260;3382
6;160206;Azevedo;77;81;75;81;40;33;36;30;4;3;10;9.0909999999999993;1;24;41;0;0;4;3;28.899999999999999;14.1;14.800000000000001;40.390000000000001;15;11;42;6;3;13;3;43;11;11;18;260;3387
6;160209;Dem;164;199;162;201;69;53;59;43;10;10;14.493;18.867999999999999;4;39;59;2;3;8;7;56.399999999999999;25.5;30.899999999999999;48.530000000000001;18;20;76;27;23;20;16;97;32;34;18;260;3390
6;160211;Lanhelas;453;538;423;503;239;209;199;171;40;38;16.736000000000001;18.181999999999999;15;107;248;4;11;36;27;196.69999999999999;89.900000000000006;106.8;46.280000000000001;47;51;249;63;43;60;61;275;67;75;18;260;3392
6;160218;Vilar de Mouros;357;396;325;369;161;152;143;126;18;26;11.18;17.105;10;100;159;1;3;17;23;72.599999999999994;34.399999999999999;38.200000000000003;44.030000000000001;54;36;190;45;32;49;40;221;38;48;18;260;3399
6;160302;Castro Laboreiro;204;336;197;332;65;87;59;84;6;3;9.2309999999999999;3.448;47;25;71;2;0;4;3;6.0999999999999996;2.2999999999999998;3.7999999999999998;59.729999999999997;6;16;94;47;41;11;8;139;87;91;18;261;3403
6;160307;Fiães;103;136;103;133;25;27;22;24;3;3;12;11.111000000000001;17;11;18;0;1;3;2;21.300000000000001;9.1999999999999993;12.1;62.329999999999998;6;6;34;26;31;3;4;44;42;43;18;261;3408
6;160308;Gave;93;144;88;139;26;13;26;11;0;2;0;15.385;6;14;17;0;1;0;1;12.699999999999999;5;7.7000000000000002;56.710000000000001;12;4;40;21;16;5;6;66;30;37;18;261;3409
6;160311;Paderne;511;649;497;653;192;158;180;145;12;13;6.25;8.2279999999999998;42;71;212;5;5;7;8;90.299999999999997;39.799999999999997;50.5;52.200000000000003;46;48;240;82;95;60;47;278;121;143;18;261;3412
6;160317;São Paio;277;325;270;320;117;75;111;64;6;11;5.1280000000000001;14.667;26;41;108;1;2;5;9;60.5;27.800000000000001;32.700000000000003;52.590000000000003;24;35;123;46;49;27;14;136;62;86;18;261;3418
6;160410;Lara;119;147;115;144;60;36;49;34;11;2;18.332999999999998;5.556;9;27;47;0;2;11;0;54;24.100000000000001;29.800000000000001;49.170000000000002;12;14;62;15;16;14;13;67;28;25;18;262;3430
6;160413;Luzio;50;70;50;69;18;10;17;8;1;2;5.556;20;3;10;12;0;0;1;2;16.399999999999999;6.7999999999999998;9.5999999999999996;59.670000000000002;;6;23;12;9;1;4;24;21;20;18;262;3433
6;160420;Pias;401;453;386;435;187;126;173;115;14;11;7.4870000000000001;8.7300000000000004;30;113;145;2;2;12;9;76.799999999999997;36.100000000000001;40.700000000000003;48.259999999999998;55;36;212;52;46;45;38;218;80;72;18;262;3440
6;160423;Portela;112;130;113;128;34;30;33;27;1;3;2.9409999999999998;10;2;31;27;0;1;1;2;29.800000000000001;13.800000000000001;16;51.259999999999998;8;9;51;28;16;12;10;67;28;13;18;262;3443
6;160433;Cortes;721;797;677;767;381;374;340;339;41;35;10.760999999999999;9.3580000000000005;12;164;503;12;6;29;29;332.30000000000001;157.80000000000001;174.5;40.189999999999998;115;91;413;56;46;116;59;465;65;92;18;262;3428
6;160503;Castanheira;309;322;295;314;163;132;144;112;19;20;11.656000000000001;15.151999999999999;5;127;124;4;3;15;17;81.299999999999997;39.799999999999997;41.5;42.880000000000003;47;34;177;25;26;42;26;167;36;51;18;263;3455
6;160508;Ferreira;195;230;186;222;79;63;76;60;3;3;3.7970000000000002;4.7620000000000005;11;45;80;2;1;1;2;32;14.699999999999999;17.300000000000001;52.100000000000001;17;28;85;32;33;16;18;98;51;47;18;263;3460
6;160515;Parada;142;156;137;158;55;46;49;44;6;2;10.909000000000001;4.3479999999999999;7;39;47;0;2;6;0;50.5;24.100000000000001;26.399999999999999;46.100000000000001;18;13;79;20;12;21;10;71;20;34;18;263;3467
6;160517;Porreiras;51;44;51;44;26;14;25;14;1;0;3.8460000000000001;0;6;14;19;0;0;1;0;22;11.800000000000001;10.199999999999999;52.090000000000003;6;4;27;7;7;1;4;20;11;8;18;263;3469
6;160518;Resende;253;265;242;261;120;105;109;91;11;14;9.1669999999999998;13.333;6;85;109;2;3;9;11;168.09999999999999;82.099999999999994;86;42.039999999999999;43;30;126;36;18;38;28;136;35;28;18;263;3470
6;160521;Vascões;106;117;101;112;45;38;43;35;2;3;4.444;7.8949999999999996;6;28;44;0;1;2;2;35.899999999999999;17.100000000000001;18.800000000000001;49.490000000000002;13;9;56;12;16;8;10;59;13;27;18;263;3473
6;160611;Lavradas;396;479;373;452;190;154;169;132;21;22;11.053000000000001;14.286;17;135;149;4;6;17;16;129.5;58.600000000000001;70.900000000000006;44.600000000000001;55;35;220;46;40;61;46;240;60;72;18;264;3484
6;160612;Lindoso;198;229;178;226;82;44;71;32;11;12;13.414999999999999;27.273;8;39;56;2;1;9;11;9.3000000000000007;4.2999999999999998;5;49.060000000000002;16;21;108;39;14;19;23;122;31;34;18;264;3485
6;160614;Oleiros;224;242;208;238;115;95;102;79;13;16;11.304;16.841999999999999;13;56;112;4;3;9;13;136.69999999999999;65.700000000000003;71;45.5;31;21;121;29;22;23;29;116;41;33;18;264;3487
6;160617;Ruivos;101;120;100;120;30;25;29;24;1;1;3.3330000000000002;4;0;19;34;0;0;1;1;99.200000000000003;45.399999999999999;53.899999999999999;46.109999999999999;14;13;46;12;16;15;18;52;21;14;18;264;3490
6;160619;Sampriz;146;196;148;196;49;27;44;22;5;5;10.204000000000001;18.518999999999998;11;24;31;2;1;3;4;52.200000000000003;22.300000000000001;29.899999999999999;45.619999999999997;21;17;71;26;11;30;18;86;34;28;18;264;3491
6;160706;Bárrio;179;180;178;176;73;55;69;47;4;8;5.4790000000000001;14.545;2;50;64;0;1;4;7;66.599999999999994;33.200000000000003;33.399999999999999;44.619999999999997;27;21;86;23;22;27;15;84;23;31;18;265;3504
6;160710;Brandara;211;231;201;227;115;84;102;77;13;7;11.304;8.3330000000000002;8;85;86;2;2;11;5;171.5;81.900000000000006;89.599999999999994;41.219999999999999;32;24;121;19;15;34;30;112;30;25;18;265;3508
6;160711;Cabaços;302;369;285;363;137;122;127;103;10;19;7.2990000000000004;15.574;15;130;85;1;5;9;14;112.5;50.700000000000003;61.899999999999999;42.600000000000001;49;32;162;36;23;50;46;183;47;43;18;265;3509
6;160712;Cabração;51;67;51;65;13;12;9;11;4;1;30.768999999999998;8.3330000000000002;0;7;13;0;0;4;1;6.7999999999999998;3;3.8999999999999999;59.420000000000002;6;3;19;12;11;2;4;25;13;23;18;265;3510
6;160723;Freixo;560;649;520;634;269;233;248;202;21;31;7.8070000000000004;13.305;14;195;241;4;4;17;27;234.80000000000001;108.8;126;43.780000000000001;93;72;303;42;50;75;68;335;61;110;18;265;3521
6;160726;Gandra;520;588;508;579;248;197;229;176;19;21;7.6609999999999996;10.66;15;180;210;1;2;18;19;317.89999999999998;149.19999999999999;168.69999999999999;44.899999999999999;74;61;280;51;54;63;60;301;73;91;18;265;3524
6;160729;Labruja;206;233;203;229;112;75;103;64;9;11;8.0359999999999996;14.667;13;70;84;0;3;9;8;30.100000000000001;14.1;16;44.560000000000002;22;37;112;14;21;26;27;116;23;41;18;265;3527
6;160744;Rebordões (Santa Maria);513;543;452;524;295;216;262;170;33;46;11.186;21.295999999999999;18;240;174;5;7;28;39;149.30000000000001;72.5;76.799999999999997;38.049999999999997;85;78;291;33;26;102;59;290;43;49;18;265;3535
6;160815;Valença;1590;1840;1571;1833;823;848;721;738;102;110;12.394;12.972;19;342;1098;13;28;89;82;881.5;408.60000000000002;472.89999999999998;41.439999999999998;257;211;883;126;113;233;203;997;176;231;18;266;3564
6;160902;Alvarães;1274;1349;1228;1346;623;522;561;444;62;78;9.952;14.943;12;503;490;3;11;59;67;288;139.90000000000001;148.09999999999999;41.57;206;152;718;110;88;177;146;760;137;129;18;267;3567
6;160909;Carvoeiro;527;577;476;564;287;250;262;220;25;30;8.7110000000000003;12;20;283;179;6;5;19;25;91.400000000000006;43.600000000000001;47.799999999999997;41.880000000000003;68;76;307;39;37;75;65;314;58;65;18;267;3574
6;160917;Meadela;4669;5113;4381;4899;2491;2529;2251;2214;240;315;9.6349999999999998;12.456;27;1156;3282;53;44;187;271;1172.0999999999999;559.39999999999998;612.60000000000002;39.100000000000001;866;506;2690;370;237;819;494;3037;386;377;18;267;3584
6;160926;Perre;1416;1540;1304;1480;785;638;713;560;72;78;9.1720000000000006;12.226000000000001;23;479;771;16;16;56;62;225.90000000000001;108.2;117.7;43.640000000000001;172;166;832;144;102;176;161;855;162;186;18;267;3591
6;160930;Geraz do Lima (Santa Maria);413;462;362;424;217;173;198;137;19;36;8.7560000000000002;20.809000000000001;7;155;173;3;6;16;30;224.30000000000001;105.90000000000001;118.40000000000001;42.909999999999997;49;54;232;51;27;66;46;241;49;60;18;267;3598
6;160935;Vila Franca;864;893;823;885;454;349;413;294;41;55;9.0310000000000006;15.759;23;309;375;3;8;38;47;245.90000000000001;120.90000000000001;125;43.539999999999999;115;97;496;87;69;99;101;489;111;93;18;267;3602
6;160936;Vila Fria;646;681;627;670;323;261;283;205;40;56;12.384;21.456;5;228;255;4;7;36;49;213.19999999999999;103.8;109.40000000000001;42.270000000000003;102;80;348;68;48;88;74;375;78;66;18;267;3603
6;161003;Cornes;220;258;213;246;116;104;101;95;15;9;12.931000000000001;8.6539999999999999;5;102;89;1;1;14;8;77.599999999999994;35.700000000000003;41.899999999999999;41.810000000000002;44;21;115;15;25;33;28;135;28;34;18;268;3608
6;161005;Gondar;59;68;56;64;24;21;23;21;1;0;4.1669999999999998;0;3;16;25;0;0;1;0;34.899999999999999;16.199999999999999;18.699999999999999;53.420000000000002;4;7;26;6;16;3;6;28;14;17;18;268;3610
6;161006;Gondarém;474;536;454;532;228;205;199;188;29;17;12.718999999999999;8.2929999999999993;10;160;217;4;4;25;13;147.19999999999999;69.099999999999994;78.099999999999994;43.719999999999999;79;37;262;66;30;65;59;272;83;57;18;268;3611
6;170101;Alijó;1273;1362;1212;1360;630;560;552;488;78;72;12.381;12.856999999999999;139;159;742;19;16;59;56;89.700000000000003;43.399999999999999;46.399999999999999;42.659999999999997;183;157;719;128;86;183;156;708;139;176;19;269;3621
6;170102;Amieiro;38;43;35;36;8;6;8;5;0;1;0;16.667000000000002;4;1;8;0;0;0;1;12.5;5.9000000000000004;6.7000000000000002;63.159999999999997;1;2;17;11;7;;2;19;5;17;19;269;3622
6;170105;Castedo;178;195;157;186;78;40;74;29;4;11;5.1280000000000001;27.5;57;12;34;0;3;4;8;27.600000000000001;13.199999999999999;14.4;44.049999999999997;29;23;99;16;11;27;21;88;25;34;19;269;3625
6;170108;Pegarinhos;230;235;638;233;94;52;83;44;11;8;11.702;15.385;58;15;54;3;3;8;5;24.800000000000001;12.300000000000001;12.5;46;30;29;111;25;35;27;27;108;30;43;19;269;3628
6;170109;Pinhão;313;335;290;309;168;146;156;124;12;22;7.1429999999999998;15.068;38;45;197;1;4;11;18;216.40000000000001;104.5;111.90000000000001;44.689999999999998;39;37;183;30;24;38;32;191;42;32;19;269;3629
6;170110;Pópulo;129;148;123;141;46;23;40;18;6;5;13.042999999999999;21.739000000000001;16;11;31;3;2;3;3;22.800000000000001;10.6;12.199999999999999;49.32;9;16;60;26;18;18;11;66;34;19;19;269;3630
6;170115;Vale de Mendiz;119;130;115;122;63;51;55;44;8;7;12.698;13.725;42;27;30;1;0;7;7;44.5;21.300000000000001;23.300000000000001;43.32;15;14;69;12;9;16;16;62;16;20;19;269;3635
6;170118;Vilar de Maçada;431;484;405;459;195;106;178;86;17;20;8.718;18.867999999999999;125;23;116;3;9;14;11;45.299999999999997;21.300000000000001;24;48.909999999999997;48;42;226;66;49;40;44;236;66;98;19;269;3638
6;170203;Beça;415;428;405;421;201;157;193;137;8;20;3.98;12.739000000000001;40;154;136;2;5;6;15;28.199999999999999;13.9;14.300000000000001;46.600000000000001;43;42;229;41;60;48;43;225;54;58;19;270;3642
6;170204;Bobadela;151;179;153;180;64;53;47;43;17;10;26.562999999999999;18.867999999999999;19;33;38;3;4;14;6;22.5;10.300000000000001;12.199999999999999;48.359999999999999;16;12;85;18;20;20;14;88;26;31;19;270;3643
6;170206;Cerdedo;69;76;68;73;26;17;22;16;4;1;15.385;5.8819999999999997;25;4;9;0;1;4;0;6.0999999999999996;2.8999999999999999;3.2000000000000002;54.689999999999998;6;4;29;16;14;5;9;32;15;15;19;270;3645
6;170209;Curros;33;34;33;34;13;5;13;5;0;0;0;0;9;5;4;0;0;0;0;5.5999999999999996;2.7999999999999998;2.7999999999999998;50.219999999999999;7;2;13;3;8;3;1;15;8;7;19;270;3648
6;170211;Fiães do Tâmega;44;55;42;49;17;8;14;4;3;4;17.646999999999998;50;4;8;6;0;4;3;0;6.7999999999999998;3;3.7999999999999998;51.609999999999999;3;3;19;9;10;4;10;20;15;6;19;270;3650
6;170213;Pinho;192;209;187;205;70;45;62;38;8;7;11.429;15.556000000000001;8;41;51;4;2;4;5;17.899999999999999;8.5999999999999996;9.3000000000000007;50.100000000000001;22;17;90;41;22;26;9;98;44;32;19;270;3652
6;170214;São Salvador de Viveiro;151;142;144;136;53;29;43;25;10;4;18.867999999999999;13.792999999999999;33;15;20;1;3;9;1;15.6;8;7.5999999999999996;51.789999999999999;12;18;71;19;31;13;9;64;34;22;19;270;3653
6;170305;Bustelo;261;258;242;247;108;82;94;64;14;18;12.962999999999999;21.951000000000001;21;34;103;2;4;12;14;55.5;27.899999999999999;27.600000000000001;43.780000000000001;37;43;136;27;18;26;26;140;28;38;19;271;3660
6;170307;Cela;72;78;67;75;32;25;30;22;2;3;6.25;12;8;16;28;0;0;2;3;42.600000000000001;20.399999999999999;22.100000000000001;47.75;9;10;36;10;7;7;4;47;9;11;19;271;3662
6;170321;Outeiro Seco;450;488;429;465;225;204;202;180;23;24;10.222;11.765000000000001;6;57;319;7;8;16;16;61.700000000000003;29.600000000000001;32.100000000000001;43.340000000000003;67;49;272;29;33;52;55;285;38;58;19;271;3676
6;170325;Roriz;73;91;70;92;18;6;13;4;5;2;27.777999999999999;33.332999999999998;7;3;7;2;2;3;0;19.300000000000001;8.5999999999999996;10.699999999999999;53.909999999999997;3;4;37;19;10;13;5;35;14;24;19;271;3680
6;170403;Oliveira;196;195;182;185;94;61;81;44;13;17;13.83;27.869;40;35;50;1;5;12;12;113.7;57;56.700000000000003;43.229999999999997;32;26;108;20;10;16;27;100;28;24;19;272;3711
6;170405;Mesão Frio (São Nicolau);216;268;202;256;90;87;80;73;10;14;11.111000000000001;16.091999999999999;4;24;125;1;4;9;10;1102.5;492;610.5;48.25;38;27;102;18;31;26;20;111;32;79;19;272;3710
6;170407;Vila Marim;591;652;552;630;273;174;246;132;27;42;9.8900000000000006;24.138000000000002;125;88;165;8;15;19;27;145.30000000000001;69.099999999999994;76.200000000000003;45.700000000000003;67;65;344;57;58;72;62;347;92;79;19;272;3713
6;170504;Ermelo;232;251;234;246;56;29;49;18;7;11;12.5;37.930999999999997;11;23;33;0;1;7;10;10.199999999999999;4.9000000000000004;5.2999999999999998;50.670000000000002;23;18;111;48;32;20;27;108;59;37;19;273;3717
6;170506;Paradança;163;195;159;186;80;44;73;36;7;8;8.75;18.181999999999999;11;41;57;1;2;6;6;43;19.600000000000001;23.399999999999999;40.460000000000001;24;21;90;16;12;35;30;92;16;22;19;273;3719
6;170508;Vilar de Ferreiros;564;572;489;546;271;145;237;115;34;30;12.545999999999999;20.690000000000001;19;161;172;6;14;28;16;40.700000000000003;20.199999999999999;20.5;40.539999999999999;97;80;288;61;38;94;75;284;71;48;19;273;3721
6;170602;Cambeses do Rio;58;72;58;71;19;17;19;15;0;2;0;11.765000000000001;14;2;18;0;0;0;2;11.5;5.0999999999999996;6.4000000000000004;55.009999999999998;4;5;22;12;15;7;3;32;13;17;19;274;3723
6;170604;Chã;366;382;371;381;172;115;149;91;23;24;13.372;20.870000000000001;71;50;119;9;11;14;13;14.699999999999999;7.2000000000000002;7.5;46.460000000000001;51;36;193;48;38;43;36;201;51;51;19;274;3725
6;170625;Reigoso;75;92;77;94;22;16;20;9;2;7;9.0909999999999993;43.75;13;6;10;1;6;1;1;9.6999999999999993;4.4000000000000004;5.2999999999999998;58.869999999999997;5;3;29;17;21;3;8;33;31;17;19;274;3746
6;170633;Venda Nova;121;141;114;134;50;32;38;25;12;7;24;21.875;3;19;41;3;3;9;4;31.800000000000001;14.699999999999999;17.100000000000001;49.130000000000003;11;3;64;27;16;19;15;66;23;18;19;274;3753
6;170707;Palheiros;151;181;136;165;67;44;61;39;6;5;8.9550000000000001;11.364000000000001;26;23;51;1;2;5;3;12.300000000000001;5.5999999999999996;6.7000000000000002;47.009999999999998;15;17;83;15;21;17;25;87;25;27;19;275;3763
6;170802;Fontelas;397;384;357;363;206;127;180;103;26;24;12.621;18.898;39;73;171;0;9;26;15;241.40000000000001;122.7;118.7;44.18;37;54;241;33;32;44;53;193;49;45;19;276;3768
6;170806;Moura Morta;267;258;241;253;125;71;107;59;18;12;14.4;16.901;52;48;66;2;4;16;8;147;74.799999999999997;72.299999999999997;41.729999999999997;43;45;128;31;20;42;27;126;32;31;19;276;3772
6;170812;Canelas;330;334;324;328;130;91;118;78;12;13;9.2309999999999999;14.286;86;32;78;1;4;11;9;43.799999999999997;21.800000000000001;22;43.140000000000001;56;41;184;29;20;48;34;163;43;46;19;276;3766
6;170903;Cerva;1116;1164;1095;1152;538;320;485;273;53;47;9.8509999999999991;14.688000000000001;127;240;391;15;20;38;27;54;26.399999999999999;27.600000000000001;43.450000000000003;169;121;611;117;98;164;144;555;136;165;19;277;3780
6;170905;Ribeira de Pena (Salvador);1181;1236;1123;1220;559;436;484;337;75;99;13.417;22.706;77;201;543;14;47;61;52;59.700000000000003;29.199999999999999;30.5;45.590000000000003;165;131;611;141;133;135;131;617;177;176;19;277;3782
6;171002;Covas do Douro;229;215;219;202;122;60;112;54;10;6;8.1969999999999992;10;60;44;62;5;2;5;4;22.600000000000001;11.6;10.9;46.960000000000001;23;31;124;24;27;22;22;102;34;35;19;278;3786
6;171008;Provesende;132;178;126;170;59;44;56;41;3;3;5.085;6.8179999999999996;42;12;43;0;2;3;1;34.399999999999999;14.699999999999999;19.800000000000001;48.219999999999999;10;7;74;23;18;32;11;80;20;35;19;278;3792
6;171010;São Cristovão do Douro;77;83;73;84;35;23;35;19;0;4;0;17.390999999999998;8;25;21;0;0;0;4;54.399999999999999;26.199999999999999;28.199999999999999;45;11;11;38;11;6;12;5;44;12;10;19;278;3794
6;171015;Vilarinho de São Romão;134;160;138;161;50;47;40;39;10;8;20;17.021000000000001;36;16;27;0;1;10;7;47.399999999999999;21.600000000000001;25.800000000000001;46.950000000000003;15;15;70;16;18;23;17;70;24;26;19;278;3799
6;171106;Medrões;243;262;241;258;111;70;101;59;10;11;9.0090000000000003;15.714;60;35;65;0;2;10;9;98.099999999999994;47.200000000000003;50.899999999999999;44.649999999999999;43;29;119;28;24;33;19;135;35;40;19;279;3807
6;171206;Canaveses;109;128;104;118;35;30;33;26;2;4;5.7140000000000004;13.333;31;7;21;0;1;2;3;18.399999999999999;8.5;9.9000000000000004;55.729999999999997;7;12;53;16;21;8;8;54;25;33;19;280;3815
6;171209;Ervões;312;324;297;313;137;58;125;48;12;10;8.7590000000000003;17.241;56;39;78;3;6;9;4;29.100000000000001;14.300000000000001;14.800000000000001;51.399999999999999;26;30;165;53;38;24;20;153;67;60;19;280;3818
6;171212;Friões;289;330;287;326;101;36;93;33;8;3;7.9210000000000003;8.3330000000000002;49;25;52;2;2;6;1;22;10.300000000000001;11.699999999999999;57.490000000000002;17;23;144;46;59;13;20;137;55;105;19;280;3821
6;171217;Rio Torto;161;201;156;190;74;38;64;34;10;4;13.513999999999999;10.526;45;9;44;3;0;7;4;11.800000000000001;5.2999999999999998;6.5999999999999996;54.460000000000001;11;15;78;29;28;14;14;83;47;43;19;280;3826
6;171220;Santa Valha;198;217;193;213;80;34;73;25;7;9;8.75;26.471;43;25;30;3;3;4;6;15.199999999999999;7.2999999999999998;8;54.490000000000002;16;12;101;42;27;14;15;92;44;52;19;280;3829
6;171221;Santiago da Ribeira de Alhariz;288;315;281;312;102;28;98;22;4;6;3.9220000000000002;21.428999999999998;37;44;39;0;3;4;3;27.899999999999999;13.300000000000001;14.6;54.130000000000003;21;25;140;57;45;17;25;133;74;66;19;280;3830
6;171223;São Pedro de Veiga de Lila;149;155;152;151;59;24;56;19;3;5;5.085;20.832999999999998;43;8;24;0;3;3;2;15.699999999999999;7.7000000000000002;8;55.439999999999998;4;10;78;21;36;11;12;67;30;35;19;280;3832
6;171301;Afonsim;90;93;91;91;43;28;41;25;2;3;4.6509999999999998;10.714;30;10;26;1;1;1;2;16.5;8.0999999999999996;8.4000000000000004;49.340000000000003;9;8;55;9;9;6;8;51;9;19;19;281;3841
6;171303;Bornes de Aguiar;1004;1053;957;1002;456;356;401;292;55;64;12.061;17.978000000000002;29;245;419;14;27;41;37;45.299999999999997;22.100000000000001;23.199999999999999;45.189999999999998;128;127;527;119;103;126;101;555;134;137;19;281;3843
6;171310;Soutelo de Aguiar;296;342;280;327;127;88;112;73;15;15;11.811;17.045000000000002;13;61;111;3;5;12;10;36.700000000000003;17;19.699999999999999;47.119999999999997;33;31;147;50;35;48;38;153;55;48;19;281;3852
6;171313;Valoura;186;190;186;190;62;33;59;26;3;7;4.8390000000000004;21.212;15;24;46;1;4;2;3;25.199999999999999;12.5;12.699999999999999;48.829999999999998;24;14;90;36;22;22;14;90;35;29;19;281;3855
6;171316;Vreia de Jales;471;496;478;510;162;94;143;74;19;20;11.728;21.277000000000001;24;83;110;1;9;18;11;20.5;10;10.5;46.140000000000001;60;53;232;75;51;67;55;224;76;74;19;281;3858
6;171406;Campeã;641;734;630;717;293;235;257;202;36;33;12.287000000000001;14.042999999999999;40;113;306;5;10;31;23;57.200000000000003;26.699999999999999;30.5;47.869999999999997;66;71;333;83;88;72;69;353;110;130;19;282;3864
6;171407;Constantim;470;550;448;525;265;267;228;218;37;49;13.962;18.352;13;72;361;8;8;29;41;157.90000000000001;72.799999999999997;85.200000000000003;39.950000000000003;65;63;284;42;16;82;70;310;47;41;19;282;3865
6;171408;Ermida;197;222;183;214;75;45;59;38;16;7;21.332999999999998;15.556000000000001;27;12;58;2;5;14;2;60.600000000000001;28.5;32.100000000000001;48.939999999999998;15;23;113;29;17;17;25;116;31;33;19;282;3866
6;171413;Lamas de Olo;43;66;45;66;19;21;19;20;0;1;0;4.7620000000000005;22;7;10;0;0;0;1;3.7000000000000002;1.5;2.2999999999999998;53.939999999999998;3;1;22;10;7;5;7;30;8;16;19;282;3871
6;171419;Vila Real (Nossa Senhora da Conceição);4221;4664;4219;4857;2224;2428;2003;2175;221;253;9.9369999999999994;10.42;63;500;3615;52;52;169;201;2611.1999999999998;1240.5;1370.7;38.729999999999997;759;456;2492;315;199;725;449;2805;361;324;19;282;3885
6;171422;Quinta;80;94;75;94;41;30;38;27;3;3;7.3170000000000002;10;3;17;45;0;1;3;2;41.700000000000003;19.199999999999999;22.5;43.939999999999998;7;9;50;8;6;9;16;45;12;12;19;282;3879
6;171426;Torgueda;660;722;615;696;291;246;259;211;32;35;10.997;14.228;22;119;329;5;12;27;23;95.799999999999997;45.700000000000003;50;44.170000000000002;92;86;348;83;51;78;82;382;99;81;19;282;3881
6;171429;Vila Marim;843;899;809;880;423;377;373;326;50;51;11.82;13.528;30;178;491;6;14;44;37;75;36.299999999999997;38.700000000000003;41.149999999999999;138;108;458;83;56;130;94;491;106;78;19;282;3884
6;180101;Aldeias;165;172;162;169;65;57;60;52;5;5;7.6920000000000002;8.7720000000000002;12;18;82;2;3;3;2;64.900000000000006;31.800000000000001;33.100000000000001;44.950000000000003;24;20;82;19;20;22;15;85;32;18;20;283;3889
6;180111;Santa Cruz;103;103;99;98;49;25;46;23;3;2;6.1219999999999999;8;35;13;21;1;0;2;2;26.100000000000001;13.1;13.1;45.009999999999998;18;8;50;15;12;12;13;49;15;14;20;283;3899
6;180112;Santiago;68;71;62;70;33;14;30;10;3;4;9.0909999999999993;28.571000000000002;19;4;17;1;1;2;3;35.799999999999997;17.5;18.300000000000001;46.960000000000001;7;11;32;9;9;7;8;33;10;13;20;283;3900
6;180116;São Romão;79;88;58;67;41;27;37;22;4;5;9.7560000000000002;18.518999999999998;13;14;32;0;0;4;5;54.700000000000003;25.899999999999999;28.800000000000001;48.619999999999997;8;6;47;6;12;6;9;41;16;16;20;283;3904
6;180118;Vacalar;92;113;85;113;47;30;45;25;2;5;4.2549999999999999;16.667000000000002;20;19;31;0;2;2;3;34;15.199999999999999;18.699999999999999;47.149999999999999;11;14;49;8;10;12;10;57;13;21;20;283;3906
6;180202;Cabanas de Viriato;710;823;661;787;309;257;275;224;34;33;11.003;12.84;24;197;278;6;4;28;29;71.400000000000006;33.100000000000001;38.299999999999997;47.899999999999999;82;76;362;94;96;101;72;382;117;151;20;284;3909
6;180312;Mões;891;953;857;937;367;263;340;218;27;45;7.3570000000000002;17.109999999999999;28;161;369;8;11;19;34;40.700000000000003;19.600000000000001;21;45.259999999999998;135;104;429;112;111;122;95;459;135;142;20;285;3926
6;180313;Moledo;585;630;567;616;176;105;152;79;24;26;13.635999999999999;24.762;40;70;121;7;9;17;17;26.5;12.800000000000001;13.800000000000001;50.759999999999998;61;48;276;116;84;59;46;312;112;101;20;285;3927
6;180317;Pepim;163;171;157;163;59;39;53;36;6;3;10.169;7.6920000000000002;7;32;50;4;1;2;2;28;13.699999999999999;14.300000000000001;50.939999999999998;26;17;75;18;27;11;12;73;30;45;20;285;3931
6;180403;Cinfães;1578;1817;1415;1745;791;660;681;511;110;149;13.906000000000001;22.576000000000001;69;314;809;21;50;89;99;133.5;62.100000000000001;71.5;41.509999999999998;265;184;858;128;143;294;192;951;152;228;20;286;3939
6;180409;Nespereira;959;1018;867;979;419;269;353;213;66;56;15.752000000000001;20.818000000000001;101;187;278;16;23;50;33;54.899999999999999;26.600000000000001;28.300000000000001;44.560000000000002;135;122;502;103;97;128;118;492;138;142;20;286;3945
6;180410;Oliveira do Douro;753;776;685;767;366;166;306;109;60;57;16.393000000000001;34.337000000000003;22;234;159;10;23;50;34;108.2;53.299999999999997;54.899999999999999;43.340000000000003;100;107;403;70;73;113;92;364;100;107;20;286;3946
6;180414;Souselo;1577;1625;1353;1560;837;473;705;331;132;142;15.771000000000001;30.021000000000001;53;497;486;15;69;117;73;349.10000000000002;171.90000000000001;177.19999999999999;40.200000000000003;254;202;896;123;102;260;171;885;164;145;20;286;3950
6;180415;Tarouquela;634;608;519;580;321;148;263;79;58;69;18.068999999999999;46.622;10;192;140;2;26;56;43;186.90000000000001;95.400000000000006;91.5;39.82;110;93;347;57;27;83;66;335;74;50;20;286;3951
6;180506;Cepões;443;417;390;398;220;116;197;94;23;22;10.455;18.966000000000001;29;72;190;7;7;16;15;159.09999999999999;81.900000000000006;77.099999999999994;42.909999999999997;66;57;240;43;37;56;43;232;39;47;20;287;3958
6;180507;Ferreirim;409;495;388;485;198;155;184;135;14;20;7.0709999999999997;12.903;56;98;165;2;3;12;17;163.5;74;89.5;46.880000000000003;57;44;216;46;46;54;50;233;57;101;20;287;3959
6;180509;Figueira;167;175;159;165;82;63;75;57;7;6;8.5370000000000008;9.5240000000000009;49;24;59;1;1;6;5;75.099999999999994;36.700000000000003;38.399999999999999;46.68;23;15;96;16;17;13;17;92;28;25;20;287;3961
6;180510;Lalim;364;365;345;353;175;115;147;91;28;24;16;20.870000000000001;13;87;138;10;8;18;16;101;50.399999999999999;50.600000000000001;45.039999999999999;46;43;198;42;35;45;33;186;49;52;20;287;3962
6;180511;Lazarim;255;266;235;254;107;75;97;61;10;14;9.3460000000000001;18.667000000000002;14;56;88;3;2;7;12;31.5;15.4;16.100000000000001;47.799999999999997;25;31;118;38;43;31;30;128;39;38;20;287;3965
6;180512;Magueija;283;308;253;293;119;104;102;89;17;15;14.286;14.423;9;64;118;1;5;16;10;54.200000000000003;26;28.300000000000001;45.369999999999997;41;32;141;33;36;34;41;145;46;42;20;287;3966
6;180513;Meijinhos;42;44;39;41;9;6;8;5;1;1;11.111000000000001;16.667000000000002;2;3;8;0;0;1;1;28.699999999999999;14;14.699999999999999;47.149999999999999;10;1;20;6;5;6;3;21;6;8;20;287;3967
6;180605;Cunha Baixa;423;461;399;443;176;163;154;134;22;29;12.5;17.791;27;95;166;4;6;18;23;57;27.300000000000001;29.699999999999999;48.399999999999999;64;38;196;66;59;44;46;214;76;81;20;288;3982
6;180606;Espinho;478;506;452;491;223;139;189;106;34;33;15.247;23.741;22;123;150;4;11;30;22;67.599999999999994;32.899999999999999;34.799999999999997;45.18;70;59;239;68;42;54;56;258;69;69;20;288;3983
6;180615;Santiago de Cassurrães;564;662;528;649;251;176;228;148;23;28;9.1630000000000003;15.909000000000001;10;143;223;6;10;17;18;54.700000000000003;25.199999999999999;29.600000000000001;47.219999999999999;72;59;286;79;68;89;64;289;76;144;20;288;3992
6;180617;Travanca de Tavares;53;61;48;58;18;12;12;10;6;2;33.332999999999998;16.667000000000002;0;10;12;1;0;5;2;27.800000000000001;12.9;14.9;47.82;11;5;21;8;8;7;3;27;7;17;20;288;3994
6;180618;Várzea de Tavares;150;164;138;161;62;47;51;37;11;10;17.742000000000001;21.277000000000001;14;20;54;3;4;8;6;36.899999999999999;17.600000000000001;19.300000000000001;49.219999999999999;22;12;74;20;22;14;15;73;24;38;20;288;3995
6;180704;Ariz;50;57;45;54;18;11;16;10;2;1;11.111000000000001;9.0909999999999993;3;10;13;0;0;2;1;11.699999999999999;5.5;6.2000000000000002;55.469999999999999;2;3;22;15;8;2;5;32;9;9;20;289;3999
6;180705;Baldos;99;102;95;97;42;29;34;23;8;6;19.047999999999998;20.690000000000001;14;13;30;0;2;8;4;45.299999999999997;22.300000000000001;23;42.560000000000002;15;12;49;12;11;14;14;51;15;8;20;289;4000
6;180709;Leomil;528;587;517;567;242;204;232;192;10;12;4.1319999999999997;5.8819999999999997;66;81;277;3;1;7;11;30.300000000000001;14.4;16;44.049999999999997;97;56;262;62;51;74;66;293;72;82;20;289;4004
6;180711;Nagosa;43;68;42;62;11;5;9;3;2;2;18.181999999999999;40;5;2;5;0;0;2;2;17.399999999999999;6.7999999999999998;10.699999999999999;54.850000000000001;5;3;17;9;9;6;6;24;12;20;20;289;4006
6;180714;Pêra Velha;99;115;95;113;35;16;30;13;5;3;14.286;18.75;14;10;19;3;2;2;1;13.6;6.2999999999999998;7.2999999999999998;51.869999999999997;10;10;41;21;17;11;9;49;24;22;20;289;4009
6;180905;Senhorim;515;641;500;632;219;179;205;159;14;20;6.3929999999999998;11.173;15;169;180;1;3;13;17;36.899999999999999;16.399999999999999;20.5;47.399999999999999;59;52;275;77;52;69;58;324;96;94;20;291;4033
6;180907;Aguieira;258;300;249;293;117;76;106;61;11;15;9.4019999999999992;19.736999999999998;8;89;70;2;4;9;11;101.2;46.799999999999997;54.399999999999999;48.380000000000003;28;21;133;26;50;41;27;139;46;47;20;291;4026
6;180908;Lapa do Lobo;349;407;329;400;160;140;142;104;18;36;11.25;25.713999999999999;4;122;120;3;7;15;29;103.3;47.700000000000003;55.600000000000001;49.140000000000001;52;27;175;52;43;36;32;196;47;96;20;291;4029
6;181001;Arca;177;182;167;168;78;66;70;59;8;7;10.256;10.606;26;68;35;1;2;7;5;39.100000000000001;19.300000000000001;19.800000000000001;48.079999999999998;24;21;82;28;22;15;14;90;33;30;20;292;4035
6;181004;Oliveira de Frades;1367;1515;1287;1456;774;734;721;658;53;76;6.8479999999999999;10.353999999999999;67;480;832;12;13;41;63;305.10000000000002;144.69999999999999;160.40000000000001;38.200000000000003;262;174;761;91;79;264;157;837;102;155;20;292;4038
6;181011;Souto de Lafões;401;440;393;483;231;199;211;178;20;21;8.6579999999999995;10.553000000000001;26;180;183;4;3;16;18;115.3;55;60.299999999999997;37.979999999999997;82;54;212;27;26;77;54;232;34;43;20;292;4045
6;181101;Antas;134;150;120;137;63;42;53;34;10;8;15.872999999999999;19.047999999999998;9;32;46;2;3;8;5;27.5;13;14.5;49.969999999999999;9;15;64;21;25;16;14;62;26;32;20;293;4047
6;181104;Germil;207;220;188;215;99;57;92;41;7;16;7.0709999999999997;28.07;5;41;87;0;5;7;11;78.200000000000003;37.899999999999999;40.299999999999997;45.75;30;22;109;27;19;25;21;104;27;43;20;293;4050
6;181106;Lusinde;88;101;80;95;32;25;28;17;4;8;12.5;32;3;18;24;0;0;4;8;67.299999999999997;31.399999999999999;36;49.969999999999999;14;4;44;20;6;6;9;47;16;23;20;293;4052
6;181110;Real;123;140;117;136;54;45;51;35;3;10;5.556;22.222000000000001;6;36;44;1;1;2;9;56.100000000000001;26.199999999999999;29.899999999999999;50.299999999999997;12;11;62;16;22;12;15;65;22;26;20;293;4056
6;181202;Beselga;155;166;147;157;62;42;60;39;2;3;3.226;7.1429999999999998;7;34;58;0;1;2;2;21.699999999999999;10.5;11.199999999999999;51.5;19;13;73;19;31;13;13;67;35;38;20;294;4061
6;181203;Castainço;81;80;73;76;32;21;31;18;1;3;3.125;14.286;5;16;28;0;1;1;2;12;6.0999999999999996;6;51.049999999999997;7;8;42;10;14;7;5;39;9;20;20;294;4062
6;181204;Granja;75;73;64;67;36;18;35;16;1;2;2.778;11.111000000000001;1;6;44;0;1;1;1;15;7.5999999999999996;7.4000000000000004;49.299999999999997;7;13;41;4;10;2;4;47;9;11;20;294;4063
6;181311;Resende;1539;1627;1479;1647;725;578;654;478;71;100;9.7929999999999993;17.300999999999998;98;210;824;19;43;52;57;266.5;129.59999999999999;137;39.920000000000002;269;232;821;109;108;258;183;868;112;206;20;295;4079
6;181312;São Cipriano;381;390;376;390;161;57;138;46;23;11;14.286;19.297999999999998;31;72;81;0;7;23;4;115;56.799999999999997;58.200000000000003;43.960000000000001;59;47;204;32;39;47;45;185;55;58;20;295;4080
6;181402;Ovoa;392;445;367;430;196;148;174;125;22;23;11.224;15.541;21;128;150;2;7;20;16;50.100000000000001;23.5;26.699999999999999;48.119999999999997;46;39;200;62;45;41;38;222;77;67;20;296;4086
6;181408;Vimieiro;376;427;348;420;183;164;163;139;20;25;10.929;15.244;11;114;177;2;5;18;20;139.30000000000001;65.200000000000003;74.099999999999994;45.719999999999999;57;33;193;44;49;49;43;220;55;60;20;296;4092
6;181409;Nagozela;209;238;201;229;90;72;77;60;13;12;14.444000000000001;16.667000000000002;12;60;65;2;3;11;9;59.299999999999997;27.699999999999999;31.600000000000001;49.43;24;14;104;35;32;22;25;111;41;39;20;296;4085
6;181506;Pereiros;44;40;39;40;21;16;19;16;2;0;9.5240000000000009;0;14;4;17;0;0;2;0;11.1;5.7999999999999998;5.2999999999999998;47.380000000000003;5;7;22;2;8;4;6;18;3;9;20;297;4098
6;181611;São Cristóvão de Lafões;93;98;89;89;47;29;42;26;5;3;10.638;10.345000000000001;8;25;35;1;0;4;3;30.199999999999999;14.699999999999999;15.5;47.82;11;12;47;12;11;10;12;42;12;22;20;298;4117
6;181613;São Martinho das Moitas;118;133;115;133;39;20;39;19;0;1;0;5;17;18;23;0;1;0;0;8.0999999999999996;3.7999999999999998;4.2999999999999998;58.770000000000003;9;12;45;19;33;6;6;42;31;48;20;298;4119
6;181614;São Pedro do Sul;1724;1973;1673;1894;836;839;755;718;81;121;9.6890000000000001;14.422000000000001;45;298;1130;16;22;65;99;285.5;133.09999999999999;152.40000000000001;44.240000000000002;250;224;903;181;166;255;197;1018;218;285;20;298;4120
6;181618;Várzea;827;918;946;1219;441;419;404;372;37;47;8.3900000000000006;11.217000000000001;14;178;584;4;3;33;44;293.30000000000001;139;154.30000000000001;39.590000000000003;141;101;460;69;56;158;97;494;84;85;20;298;4124
6;181701;Águas Boas;87;85;81;86;37;27;34;21;3;6;8.1080000000000005;22.222000000000001;6;15;34;2;3;1;3;20.199999999999999;10.199999999999999;10;50.100000000000001;8;10;43;15;11;8;5;46;13;13;20;299;4126
6;181702;Avelal;228;301;215;288;84;78;73;69;11;9;13.095000000000001;11.538;6;35;101;0;1;11;8;64.900000000000006;28;36.899999999999999;53.869999999999997;34;17;100;29;48;28;15;114;38;106;20;299;4127
6;181706;Mioma;586;631;547;603;267;203;247;182;20;21;7.4909999999999997;10.345000000000001;9;130;290;3;6;17;15;79.299999999999997;38.200000000000003;41.100000000000001;41.200000000000003;104;85;291;58;48;102;76;310;60;83;20;299;4131
6;181711;Silvã de Cima;241;214;236;213;89;51;81;41;8;10;8.9890000000000008;19.608000000000001;9;44;69;4;6;4;4;66.099999999999994;35;31.100000000000001;47.899999999999999;33;24;107;37;40;20;21;103;38;32;20;299;4136
6;181712;Vila Longa;88;98;91;99;31;32;29;24;2;8;6.452;25;8;20;25;1;1;1;7;21.899999999999999;10.300000000000001;11.5;54.460000000000001;11;3;40;17;17;7;3;50;15;23;20;299;4137
6;181806;Faia;97;110;84;100;42;31;39;27;3;4;7.1429999999999998;12.903;8;16;42;0;1;3;3;57.100000000000001;26.800000000000001;30.300000000000001;45.840000000000003;20;8;44;12;13;12;8;54;15;21;20;300;4143
6;181807;Ferreirim;228;229;231;231;109;101;98;93;11;8;10.092000000000001;7.9210000000000003;76;52;63;0;3;11;5;46.100000000000001;23;23.100000000000001;46.149999999999999;38;20;118;33;19;24;18;119;40;28;20;300;4144
6;181810;Granjal;134;138;132;135;45;36;38;32;7;4;15.556000000000001;11.111000000000001;5;21;44;0;1;7;3;19.800000000000001;9.8000000000000007;10.1;45.710000000000001;11;19;74;19;11;15;14;75;25;9;20;300;4147
6;181816;Sernancelhe;561;622;541;600;272;254;252;226;20;28;7.3529999999999998;11.023999999999999;21;103;354;8;8;12;20;48.700000000000003;23.100000000000001;25.600000000000001;41.609999999999999;96;62;305;50;48;97;76;312;61;76;20;300;4153
6;181901;Adorigo;200;197;172;173;88;28;73;22;15;6;17.045000000000002;21.428999999999998;35;17;43;5;2;10;4;43;21.699999999999999;21.399999999999999;46.670000000000002;28;17;100;25;30;16;27;99;29;26;20;301;4155
6;181903;Barcos;294;298;291;297;149;81;129;61;20;20;13.423;24.690999999999999;45;36;109;0;0;20;20;54.5;27;27.399999999999999;45.710000000000001;44;37;155;25;33;38;26;137;34;63;20;301;4157
6;181908;Longra;179;191;152;175;68;45;65;40;3;5;4.4119999999999999;11.111000000000001;9;41;55;2;2;1;3;54.200000000000003;26.199999999999999;28;46.969999999999999;21;21;92;19;26;16;25;94;18;38;20;301;4162
6;90605;Folgosinho;234;265;229;261;105;66;97;55;8;11;7.6189999999999998;16.667000000000002;23;38;91;2;4;6;7;9.6999999999999993;4.5;5.0999999999999996;54.450000000000003;22;26;104;25;57;20;23;94;41;87;10;140;1923
6;90611;Nabais;188;217;183;208;98;66;84;55;14;11;14.286;16.667000000000002;18;30;91;3;3;11;8;56.399999999999999;26.199999999999999;30.199999999999999;48.689999999999998;20;22;100;18;28;17;30;99;24;47;10;140;1931
6;91201;Alvoco da Serra;214;252;190;225;82;63;69;40;13;23;15.853999999999999;36.508000000000003;6;49;54;2;2;11;21;12.4;5.7000000000000002;6.7000000000000002;52.759999999999998;12;26;110;31;35;10;26;122;42;52;10;146;2083
6;91212;Sandomil;433;484;415;477;188;148;168;124;20;24;10.638;16.216000000000001;22;135;135;2;5;18;19;69.400000000000006;32.799999999999997;36.600000000000001;50.049999999999997;39;47;226;59;62;45;42;226;73;98;10;146;2095
6;91225;Valezim;150;160;145;157;60;46;44;35;16;11;26.667000000000002;23.913;2;23;54;8;4;8;7;25.699999999999999;12.4;13.199999999999999;51.329999999999998;15;11;75;24;25;14;13;78;27;28;10;146;2108
6;90712;Castanheira;161;184;152;177;64;43;63;37;1;6;1.5629999999999999;13.952999999999999;2;34;64;0;0;1;6;14;6.5;7.5;54.609999999999999;16;16;68;27;34;8;13;77;34;52;10;141;1952
6;90738;Santana da Azinha;230;229;226;227;115;84;105;66;10;18;8.6959999999999997;21.428999999999998;10;68;93;4;2;6;16;28.800000000000001;14.4;14.4;46.950000000000003;33;26;122;15;34;22;19;116;11;61;10;141;1982
6;90744;Sobral da Serra;117;125;115;126;50;36;46;30;4;6;8;16.667000000000002;4;27;45;1;1;3;5;21.600000000000001;10.4;11.199999999999999;49.460000000000001;15;4;63;13;22;13;9;62;14;27;10;141;1985
6;90746;Vale de Estrela;186;208;174;206;94;88;81;71;13;17;13.83;19.318000000000001;4;30;118;3;4;10;13;28.300000000000001;13.300000000000001;14.9;45.469999999999999;22;22;104;21;17;21;24;112;18;33;10;141;1987
6;91018;Pínzio;200;253;199;251;62;54;62;51;0;3;0;5.556;0;31;82;0;0;0;3;16.699999999999999;7.4000000000000004;9.3000000000000007;56.619999999999997;6;13;83;53;45;20;23;93;45;72;10;144;2033
6;91110;Bendada;268;312;255;296;105;92;93;78;12;14;11.429;15.217000000000001;9;75;87;0;1;12;13;16.800000000000001;7.7999999999999998;9;52.840000000000003;19;27;125;45;52;23;22;140;53;74;10;145;2052
6;91120;Nave;105;125;103;130;34;29;31;26;3;3;8.8239999999999998;10.345000000000001;7;16;34;1;1;2;2;8.5;3.8999999999999999;4.5999999999999996;58.310000000000002;6;11;44;17;27;8;5;41;25;46;10;145;2062
6;91132;Seixo do Côa;85;86;78;75;30;14;27;11;3;3;10;21.428999999999998;2;11;25;0;1;3;2;9.0999999999999996;4.5;4.5999999999999996;56.490000000000002;4;7;44;10;20;3;9;32;15;27;10;145;2074
6;91305;Cótimos;107;113;105;119;29;28;27;25;2;3;6.8970000000000002;10.714;1;13;38;0;1;2;2;16.300000000000001;7.9000000000000004;8.4000000000000004;52.57;9;3;51;30;14;12;3;51;30;17;10;147;2116
6;91316;Rio de Mel;164;159;163;160;64;40;61;39;3;1;4.6879999999999997;2.5;19;29;52;0;0;3;1;13.800000000000001;7;6.7999999999999998;48.649999999999999;23;18;72;27;24;16;12;78;25;28;10;147;2127
6;50208;Escalos de Cima;462;476;428;455;231;185;206;162;25;23;10.823;12.432;16;160;192;5;9;20;14;60.899999999999999;30;30.899999999999999;49.219999999999999;49;35;269;52;57;40;41;241;68;86;6;79;1291
6;50501;Alcafozes;94;108;99;116;30;22;27;21;3;1;10;4.5449999999999999;13;9;26;0;0;3;1;3.6000000000000001;1.7;1.8999999999999999;59.020000000000003;7;4;40;17;26;5;7;37;23;36;6;82;1371
6;50514;São Miguel de Acha;272;288;286;298;95;77;87;64;8;13;8.4209999999999994;16.882999999999999;17;52;82;0;0;8;13;13.6;6.5999999999999996;7;57.539999999999999;20;18;117;52;65;12;16;111;60;89;6;82;1384
6;50712;Vale da Senhora da Póvoa;116;141;115;135;22;19;16;16;6;3;27.273;15.789;2;8;22;0;1;6;2;13.300000000000001;6;7.2999999999999998;61.950000000000003;4;11;41;30;30;5;8;35;38;55;6;84;1411
6;50316;Peso;344;393;330;385;162;166;150;137;12;29;7.407;17.469999999999999;5;141;141;2;11;10;18;68.400000000000006;31.899999999999999;36.5;43.880000000000003;58;38;174;52;22;46;47;195;49;56;6;80;1329
6;50322;Sobral de São Miguel;190;228;183;215;59;47;54;40;5;7;8.4749999999999996;14.894;3;33;58;0;2;5;5;17.5;7.9000000000000004;9.5;55.689999999999998;18;11;87;34;40;10;19;90;49;60;6;80;1332
6;50325;Unhais da Serra;672;726;684;749;332;288;310;260;22;28;6.6269999999999998;9.7219999999999995;19;273;278;3;4;19;24;46.700000000000003;22.5;24.300000000000001;48.289999999999999;70;60;381;77;84;74;57;383;88;124;6;80;1335
6;50331;Canhoso;1075;1162;1007;1122;585;591;526;518;59;73;10.085000000000001;12.352;13;284;747;13;23;46;50;325.89999999999998;156.59999999999999;169.30000000000001;37.960000000000001;206;105;650;65;49;206;89;714;84;69;6;80;1313
6;50403;Alcongosta;234;263;219;257;121;91;117;69;4;22;3.306;24.175999999999998;42;40;104;1;5;3;17;68;32;36;47.32;26;26;123;27;32;30;25;118;42;48;6;81;1342
6;50411;Capinha;234;260;234;255;106;82;90;65;16;17;15.093999999999999;20.731999999999999;13;56;86;2;4;14;13;12.5;5.9000000000000004;6.5999999999999996;51.380000000000003;25;20;125;24;40;21;16;115;34;74;6;81;1350
6;50416;Fatela;266;298;249;287;132;131;119;91;13;40;9.8480000000000008;30.533999999999999;13;82;115;1;10;12;30;50.100000000000001;23.600000000000001;26.5;45.020000000000003;29;40;146;28;23;32;33;157;32;44;6;81;1356
6;50424;Silvares;478;490;454;477;234;196;210;160;24;36;10.256;18.367000000000001;6;170;194;5;7;19;29;47.799999999999997;23.600000000000001;24.199999999999999;46.619999999999997;65;50;255;60;48;46;45;246;74;79;6;81;1365
6;100109;Maiorga;978;1072;911;1001;466;435;428;380;38;55;8.1549999999999994;12.644;14;321;473;3;10;35;45;204.19999999999999;97.400000000000006;106.8;44.469999999999999;125;104;533;134;82;148;99;552;131;142;11;149;2168
6;100502;Carvalhal;1272;1362;1203;1324;629;475;545;406;84;69;13.355;14.526;174;214;563;10;10;74;59;81.400000000000006;39.299999999999997;42.100000000000001;46.950000000000003;143;142;682;167;138;149;135;681;199;198;11;153;2196
6;100504;Vale Covo;566;591;533;574;274;206;254;179;20;27;7.2990000000000004;13.106999999999999;54;96;283;4;10;16;17;103.40000000000001;50.600000000000001;52.799999999999997;45.799999999999997;76;55;293;74;68;84;50;291;81;85;11;153;2199
6;101405;Serra d' El-Rei;685;716;643;691;349;302;312;258;37;44;10.602;14.57;32;163;375;3;9;34;35;157;76.799999999999997;80.200000000000003;43.450000000000003;112;62;365;68;78;110;50;380;84;92;11;162;2275
6;110105;Cadafais;836;898;793;868;458;411;430;371;28;40;6.1139999999999999;9.7319999999999993;20;227;554;3;6;25;34;183.90000000000001;88.700000000000003;95.200000000000003;41.920000000000002;138;89;459;88;62;139;79;495;97;88;12;165;2312
6;110204;Santiago dos Velhos;733;785;711;775;381;329;359;304;22;25;5.774;7.5990000000000002;19;179;465;2;5;20;20;93.099999999999994;45;48.200000000000003;42.329999999999998;132;68;396;89;48;114;85;411;93;82;12;167;2336
6;110406;Painho;634;686;610;657;327;235;298;215;29;20;8.8689999999999998;8.5109999999999992;117;150;246;2;3;27;17;151.19999999999999;72.599999999999994;78.599999999999994;45.060000000000002;76;64;339;96;59;100;74;323;100;89;12;169;2351
6;110410;Vilar;834;850;813;833;387;305;354;273;33;32;8.5269999999999992;10.492000000000001;55;176;396;6;6;27;26;99.5;49.299999999999997;50.200000000000003;47.170000000000002;132;62;418;112;110;97;67;403;126;157;12;169;2355
6;111306;Freiria;1219;1242;1194;1235;669;504;609;442;60;62;8.9689999999999994;12.302;89;381;581;13;8;47;54;183.19999999999999;90.799999999999997;92.5;41.810000000000002;191;158;659;116;95;165;155;636;129;157;12;179;2505
6;111314;São Pedro da Cadeira;2557;2520;2464;2474;1365;1111;1208;1011;157;100;11.502000000000001;9.0009999999999994;118;867;1234;22;17;135;83;212.90000000000001;107.2;105.7;39.899999999999999;456;290;1395;246;170;392;273;1386;247;222;12;179;2514
6;140104;Bemposta;878;917;816;893;417;293;370;249;47;44;11.271000000000001;15.016999999999999;133;218;268;4;3;43;41;9.5999999999999996;4.7000000000000002;4.9000000000000004;50.869999999999997;77;70;485;117;129;74;67;449;147;180;16;225;3061
6;140105;Martinchel;299;305;276;295;120;75;101;65;19;10;15.833;13.333;9;52;105;2;1;17;9;35.399999999999999;17.5;17.899999999999999;52.020000000000003;23;28;160;38;50;24;23;151;44;63;16;225;3065
6;141905;Lapas;1253;1337;1170;1280;659;636;604;568;55;68;8.3460000000000001;10.692;6;302;864;7;8;48;60;522.10000000000002;252.59999999999999;269.5;38.490000000000002;239;120;731;81;82;241;138;733;98;127;16;244;3231
6;141906;Olaia;860;865;814;844;371;320;329;280;42;40;11.321;12.5;22;166;421;8;4;34;36;78.5;39.100000000000001;39.399999999999999;46.649999999999999;131;96;436;97;100;84;68;440;118;155;16;244;3233
6;141913;Torres Novas (Santa Maria);2388;2638;2301;2542;1242;1279;1150;1169;92;110;7.407;8.5999999999999996;36;516;1767;19;24;73;86;228.5;108.59999999999999;120;41.289999999999999;431;233;1329;235;160;401;229;1471;252;285;16;244;3240
6;142117;Cercal;390;394;365;377;226;183;212;166;14;17;6.1950000000000003;9.2899999999999991;3;186;189;1;3;13;14;101;50.200000000000003;50.799999999999997;41.909999999999997;49;60;224;28;29;46;53;218;38;39;16;238;3145
6;110630;Santa Isabel;3034;3841;2919;3724;1555;1641;1413;1491;142;150;9.1319999999999997;9.141;22;244;2638;27;37;115;113;10964.200000000001;4838.6000000000004;6125.6000000000004;45.619999999999997;456;324;1626;304;324;420;345;1881;460;735;12;171;2391
6;110640;São Francisco Xavier;3656;4364;4135;4361;1826;1863;1692;1730;134;133;7.3380000000000001;7.1390000000000002;15;346;3061;32;31;102;102;3484.6999999999998;1588.5;1896.2;44.039999999999999;672;344;1858;431;351;633;370;2219;571;571;12;171;2401
6;110642;São João de Brito;5152;6575;5025;6491;2386;2615;2127;2363;259;252;10.855;9.6370000000000005;23;471;3996;73;56;186;196;5258;2310;2948;48.409999999999997;704;560;2617;522;749;620;498;3063;799;1595;12;171;2402
6;110648;São Nicolau;715;516;1082;864;556;243;524;210;32;33;5.7549999999999999;13.58;1;27;706;5;6;27;27;4674.5;2715.0999999999999;1959.4000000000001;42.530000000000001;32;67;551;28;37;54;39;251;52;120;12;171;2409
6;110715;São João da Talha;8360;8892;7920;8587;4428;4416;3820;3874;608;542;13.731;12.274000000000001;12;1478;6204;124;106;484;436;2700.9000000000001;1308.8;1392.0999999999999;41.009999999999998;1292;977;4814;881;396;1210;986;5240;871;585;12;172;2429
6;110719;Portela;5517;6292;5184;6106;2692;2791;2410;2565;282;226;10.475;8.0969999999999995;19;568;4388;63;50;219;176;11978.9;5596.3999999999996;6382.5;45.950000000000003;758;534;2903;921;401;682;527;3539;968;576;12;172;2424
6;110903;Cheleiros;675;672;654;656;376;284;334;252;42;32;11.17;11.268000000000001;21;218;347;5;6;37;26;117;58.600000000000001;58.399999999999999;43.450000000000003;90;81;378;76;50;83;69;351;85;84;12;174;2445
6;110916;Venda do Pinheiro;3936;4210;3691;4072;2195;2138;2006;1934;189;204;8.6099999999999994;9.5419999999999998;30;809;3101;34;43;155;161;696.60000000000002;336.60000000000002;360;36.530000000000001;837;384;2318;233;164;880;363;2380;260;327;12;174;2458
6;111105;Colares;3623;4005;3522;3912;1936;1764;1730;1559;206;205;10.640000000000001;11.621;63;587;2639;53;44;153;161;228.59999999999999;108.59999999999999;120;42.880000000000003;566;389;2029;343;296;573;378;2139;376;539;12;177;2483
6;111411;Forte da Casa;5269;5787;5048;5638;3043;3103;2707;2745;336;358;11.042;11.537000000000001;7;1025;4420;42;56;294;302;2424.4000000000001;1155.4000000000001;1269;38.859999999999999;862;616;3281;351;159;875;650;3616;345;301;12;180;2525
6;111508;Venteira;8534;10005;8722;9999;4218;4363;3614;3829;604;534;14.32;12.239000000000001;10;993;6440;80;88;524;446;3796;1747.4000000000001;2048.5999999999999;45.909999999999997;1076;830;4530;1181;917;1056;847;5181;1587;1334;12;166;2332
6;150301;Almada;7480;9104;7112;8779;3445;3565;2909;3056;536;509;15.558999999999999;14.278;18;814;5133;100;99;436;410;12096.9;5456.1999999999998;6640.8000000000002;49.649999999999999;849;738;3771;1030;1092;741;715;4374;1367;1907;17;248;3258
6;150703;Santo Isidro de Pegões;753;785;733;775;444;333;394;278;50;55;11.260999999999999;16.516999999999999;183;127;362;6;11;44;44;27.699999999999999;13.6;14.199999999999999;42.68;104;73;445;74;57;105;88;435;77;80;17;252;3294
6;150802;Palmela;8462;9019;8029;8740;4238;4003;3754;3448;484;555;11.42;13.865;173;1704;5325;95;115;389;440;225.59999999999999;109.2;116.40000000000001;42.57;1431;901;4589;955;586;1304;776;4979;990;970;17;253;3297
6;151001;Aldeia de Paio Pires;6433;6825;5976;6573;3567;3586;3098;3047;469;539;13.148;15.031000000000001;9;1204;4932;88;103;381;436;828.20000000000005;401.89999999999998;426.39999999999998;36;1306;656;3792;432;247;1273;669;4045;473;365;17;255;3312
6;151006;Fernão Ferro;8369;8690;8088;8536;4214;3827;3678;3285;536;542;12.720000000000001;14.163;23;1405;5535;103;96;433;446;707.10000000000002;346.89999999999998;360.19999999999999;41.57;1411;828;4595;950;585;1388;807;4803;941;751;17;255;3316
6;151102;Sesimbra (Santiago);2352;2489;2299;2486;1147;968;1031;811;116;157;10.113;16.219000000000001;308;192;1342;25;28;91;129;2401.4000000000001;1166.7;1234.7;50.439999999999998;192;223;1234;374;329;189;192;1261;383;464;17;256;3320
6;21117;Longueira/Almograve;681;675;662;659;362;289;303;235;59;54;16.297999999999998;18.684999999999999;223;78;237;2;4;57;50;14.800000000000001;7.4000000000000004;7.4000000000000004;43.340000000000003;96;63;370;88;64;91;78;344;83;79;3;49;434
6;120403;São João Baptista;1904;1991;1826;1937;979;872;824;714;155;158;15.832000000000001;18.119;93;523;922;44;38;111;120;36.600000000000001;17.899999999999999;18.699999999999999;42.549999999999997;302;229;1007;204;162;280;196;1055;225;235;14;195;2604
6;120606;Vale do Peso;120;141;112;135;33;36;29;30;4;6;12.121;16.667000000000002;12;5;42;0;0;4;6;4;1.8;2.2000000000000002;61.159999999999997;5;11;46;19;39;10;4;45;24;58;14;197;2614
6;120704;Barbacena;318;345;309;337;133;97;110;85;23;12;17.292999999999999;12.371;31;30;134;4;1;19;11;21.300000000000001;10.199999999999999;11.1;51.520000000000003;32;22;152;37;75;37;28;137;57;86;14;198;2618
6;121307;Tramaga;778;764;737;748;405;310;337;245;68;65;16.789999999999999;20.968;120;170;292;6;7;62;58;16.699999999999999;8.4000000000000004;8.3000000000000007;44.270000000000003;111;91;422;78;76;88;77;404;91;104;14;204;2657
6;70207;Sabugueiro;198;198;186;188;98;72;95;62;3;10;3.0609999999999999;13.888999999999999;28;47;82;0;1;3;9;10.6;5.2999999999999998;5.2999999999999998;48.969999999999999;17;22;92;35;32;21;16;91;35;35;8;107;1657
6;70408;São Bento do Ameixial;168;167;165;163;72;59;69;54;3;5;4.1669999999999998;8.4749999999999996;40;20;63;0;1;3;4;8;4;4;46.979999999999997;27;12;88;15;26;19;17;74;21;36;8;109;1673
6;70508;São Manços;462;476;445;459;236;217;206;186;30;31;12.712;14.286;90;107;195;5;7;25;24;8.6999999999999993;4.2999999999999998;4.4000000000000004;45.270000000000003;66;55;235;58;48;55;38;259;66;58;8;110;1690
6;70518;Horta das Figueiras;4799;5207;4679;5175;2526;2694;2291;2430;235;264;9.3030000000000008;9.8000000000000007;108;831;3782;66;64;169;200;220.5;105.8;114.8;38.659999999999997;891;555;2746;317;290;832;538;3055;351;431;8;110;1682
6;71103;Monsaraz;384;398;374;385;168;128;142;102;26;26;15.475999999999999;20.312999999999999;36;52;156;6;2;20;24;8.9000000000000004;4.4000000000000004;4.5;48.060000000000002;41;39;205;55;44;40;26;201;70;61;8;116;1727
6;71104;Reguengos de Monsaraz;3543;3718;3326;3542;1779;1562;1586;1347;193;215;10.849;13.763999999999999;322;541;2070;25;38;168;177;71.400000000000006;34.799999999999997;36.600000000000001;42.060000000000002;612;389;1937;293;312;534;392;1923;384;485;8;116;1728
6;71105;Campinho;351;357;338;350;134;119;107;92;27;27;20.149000000000001;22.689;56;42;101;4;3;23;24;13.199999999999999;6.5;6.7000000000000002;48.469999999999999;45;47;151;50;58;35;27;161;76;58;8;116;1724
6;121503;Santo Amaro;301;343;292;326;150;138;132;116;18;22;12;15.942;58;57;133;6;4;12;18;16.300000000000001;7.5999999999999996;8.6999999999999993;47.840000000000003;43;32;148;29;49;39;27;152;52;73;14;206;2671
6;21003;Safara;524;554;514;560;245;207;186;145;59;62;24.082000000000001;29.951999999999998;91;59;181;14;12;45;50;18.699999999999999;9.0999999999999996;9.5999999999999996;45.090000000000003;78;52;283;66;45;80;47;260;78;89;3;48;427
6;21004;Moura (Santo Agostinho);2145;2199;2075;2101;1032;946;892;772;140;174;13.566000000000001;18.393000000000001;190;291;1183;27;45;113;129;35.799999999999997;17.699999999999999;18.100000000000001;39.810000000000002;431;286;1119;183;126;361;244;1141;242;211;3;48;424
6;21203;Ourique;1431;1443;1388;1401;708;618;640;536;68;82;9.6050000000000004;13.269;89;212;875;5;14;63;68;11.5;5.7000000000000002;5.7999999999999998;46.310000000000002;174;132;769;165;191;168;127;750;181;217;3;50;450
6;21204;Panóias;248;248;245;242;115;83;98;57;17;26;14.782999999999999;31.324999999999999;35;45;75;1;1;16;25;4.5;2.2999999999999998;2.2999999999999998;50.229999999999997;31;26;117;34;40;17;17;119;39;56;3;50;451
6;110307;Vila Nova da Rainha;456;470;444;467;255;212;235;195;20;17;7.843;8.0190000000000001;4;86;340;2;2;18;15;37.200000000000003;18.300000000000001;18.899999999999999;41;67;36;276;36;41;80;47;255;46;42;12;168;2344
6;140401;Alpiarça;3699;4003;3497;3892;1766;1678;1492;1470;274;208;15.515000000000001;12.396000000000001;401;607;1954;25;14;249;194;80.799999999999997;38.799999999999997;42;44.689999999999998;611;348;1969;421;350;533;322;2034;525;589;16;228;3089
6;140504;Barrosa;371;354;359;348;202;151;182;123;20;28;9.9009999999999998;18.542999999999999;34;86;185;3;5;17;23;101.09999999999999;51.700000000000003;49.299999999999997;43.979999999999997;59;46;204;28;34;40;27;187;54;46;16;229;3090
6;140902;Couço;1323;1442;1268;1393;539;486;485;370;54;116;10.019;23.867999999999999;202;229;424;6;13;48;103;8;3.7999999999999998;4.2000000000000002;51.630000000000003;155;81;621;209;257;129;117;629;250;317;16;233;3115
6;141408;Rio Maior;5779;6226;5595;6076;3054;2874;2738;2529;316;345;10.347;12.004;154;1640;3473;58;61;258;284;131.90000000000001;63.5;68.400000000000006;41.060000000000002;962;683;3180;542;412;937;604;3452;586;647;16;239;3170
6;141412;Ribeira de São João;241;255;229;243;111;98;99;88;12;10;10.811;10.204000000000001;17;42;128;1;1;11;9;62.899999999999999;30.600000000000001;32.299999999999997;44.649999999999999;35;30;120;27;29;35;26;126;35;33;16;239;3169
6;141604;Alcanede;2247;2300;2170;2260;1131;888;1051;797;80;91;7.0730000000000004;10.247999999999999;90;860;898;16;20;64;71;43;21.199999999999999;21.699999999999999;44.920000000000002;319;236;1190;275;227;293;203;1172;309;323;16;241;3182
6;141624;Vale de Figueira;540;542;512;533;241;216;199;178;42;38;17.427;17.593;52;85;240;5;5;37;33;50.200000000000003;25.100000000000001;25.199999999999999;46.600000000000001;76;49;287;74;54;59;48;276;88;71;16;241;3203
6;80105;Olhos de Água;1944;2017;3332;3353;1076;1067;921;885;155;182;14.404999999999999;17.056999999999999;24;197;1585;22;20;133;162;276;135.40000000000001;140.5;39.109999999999999;339;214;1130;172;89;324;174;1236;150;133;9;120;1742
6;80203;Martim Longo;514;516;505;508;202;132;192;123;10;9;4.9500000000000002;6.8179999999999996;40;61;214;3;0;7;9;8;4;4;53.350000000000001;47;47;230;87;103;55;21;215;106;119;9;121;1750
6;80302;Bordeira;229;203;247;215;83;51;77;45;6;6;7.2290000000000001;11.765000000000001;19;20;83;1;0;5;6;5.4000000000000004;2.8999999999999999;2.5;50.82;26;14;116;28;45;19;11;94;39;40;9;122;1759
6;80304;Rogil;553;573;543;560;247;219;217;191;30;28;12.146000000000001;12.785;64;82;262;5;3;25;25;32.200000000000003;15.800000000000001;16.399999999999999;50.140000000000001;53;45;283;84;88;48;45;278;91;111;9;122;1761
6;80605;Carvoeiro;1316;1405;1940;1980;637;584;541;480;96;104;15.071;17.808;10;136;875;10;9;86;95;233.30000000000001;112.8;120.5;44.049999999999997;171;145;740;162;98;193;143;779;164;126;9;125;1772
6;80903;Monchique;2409;2408;2360;2341;1132;921;964;790;168;131;14.840999999999999;14.224;103;346;1305;21;18;147;113;30.199999999999999;15.1;15.1;48.890000000000001;255;200;1279;309;366;248;207;1180;351;422;9;128;1797
6;81302;Algoz;1923;1908;1825;1831;996;898;832;746;164;152;16.466000000000001;16.927;126;249;1203;14;10;150;142;116.8;58.600000000000001;58.200000000000003;42.590000000000003;303;168;1093;199;160;262;170;1071;187;218;9;132;1807
6;81303;Armação de Pêra;2397;2470;2473;2560;1285;1183;1052;950;233;233;18.132000000000001;19.696000000000002;46;385;1571;35;25;198;208;609.10000000000002;300;309.10000000000002;40.100000000000001;406;253;1371;223;144;373;233;1398;248;218;9;132;1808
6;81304;Pêra;1206;1226;1156;1202;602;547;508;462;94;85;15.615;15.539;19;136;815;12;10;82;75;112.3;55.700000000000003;56.600000000000001;41.939999999999998;178;123;682;129;94;189;114;688;114;121;9;132;1809
6;81409;Cabanas de Tavira;540;541;841;809;270;260;221;206;49;54;18.148;20.768999999999998;39;52;336;5;1;44;53;145.90000000000001;72.900000000000006;73;44.829999999999998;71;37;319;72;41;67;43;314;64;53;9;121;1745
6;181308;Ovadas;129;148;122;141;38;15;37;13;1;2;2.6320000000000001;13.333;14;14;22;0;1;1;1;22.899999999999999;10.699999999999999;12.199999999999999;48.130000000000003;15;16;60;16;22;17;17;60;22;32;20;295;4076
6;10901;Argoncilhe;4093;4327;3950;4263;2241;1911;1911;1467;330;444;14.725999999999999;23.234000000000002;26;1454;1898;48;74;282;370;1025.2;498.30000000000001;526.79999999999995;40.439999999999998;679;523;2315;364;212;616;461;2468;439;343;1;15;148
6;10903;Canedo;2921;3123;2806;3059;1559;1261;1383;1001;176;260;11.289;20.619;25;1234;1125;17;37;159;223;205.80000000000001;99.5;106.3;37.909999999999997;584;349;1694;160;134;524;357;1801;231;210;1;15;151
6;10910;Guisande;615;622;607;611;324;249;291;215;33;34;10.185;13.654999999999999;12;254;240;6;3;27;31;281.39999999999998;139.90000000000001;141.5;41.719999999999999;93;98;332;60;32;77;71;354;61;59;1;15;158
6;10922;Romariz;1484;1539;1436;1503;769;656;701;590;68;66;8.843;10.061;18;780;493;7;14;61;52;272.80000000000001;133.90000000000001;138.90000000000001;40.909999999999997;249;197;825;135;78;207;208;825;156;143;1;15;169
6;40305;Castanheiro;189;238;174;227;68;47;62;39;6;8;8.8239999999999998;17.021000000000001;28;27;46;1;3;5;5;31.300000000000001;13.800000000000001;17.399999999999999;50.009999999999998;19;19;95;29;27;24;18;115;39;42;5;68;1053
6;40313;Pinhal do Norte;125;138;118;133;58;37;57;33;1;4;1.724;10.811;54;11;25;0;2;1;2;15.6;7.4000000000000004;8.1999999999999993;56.32;6;9;57;27;26;5;11;64;27;31;5;68;1061
6;40401;Fornos;104;102;104;102;19;13;19;13;0;0;0;0;4;11;17;0;0;0;0;7.2000000000000002;3.6000000000000001;3.6000000000000001;59.560000000000002;8;2;36;32;26;5;3;38;26;30;5;69;1068
6;40910;Larinho;184;181;187;184;78;59;65;42;13;17;16.667000000000002;28.814;15;26;66;1;1;12;16;12.4;6.2000000000000002;6.0999999999999996;54.700000000000003;16;14;87;32;35;13;13;77;27;51;5;74;1203
6;41001;Assares;69;72;58;70;39;23;35;16;4;7;10.256;30.434999999999999;11;18;22;0;4;4;3;41.5;20.300000000000001;21.199999999999999;45.350000000000001;9;8;38;8;6;11;4;40;10;7;5;75;1211
6;41018;Vilarinho das Azenhas;51;58;49;55;17;9;15;8;2;1;11.765000000000001;11.111000000000001;6;9;8;2;0;0;1;7.7000000000000002;3.6000000000000001;4.0999999999999996;57.609999999999999;2;2;21;15;11;3;6;23;12;14;5;75;1228
6;91403;Cedovim;162;176;155;167;82;39;74;38;8;1;9.7560000000000002;2.5640000000000001;42;28;42;3;1;5;0;10.5;5.0999999999999996;5.5;51.140000000000001;12;21;83;21;25;16;12;79;27;42;10;148;2143
6;170113;Santa Eugénia;165;168;158;169;62;25;59;18;3;7;4.8390000000000004;28;25;26;26;0;1;3;6;36.399999999999999;18.100000000000001;18.399999999999999;54.909999999999997;14;9;80;32;30;15;5;75;31;42;19;269;3633
6;170808;Poiares;373;429;414;423;167;145;155;136;12;9;7.1859999999999999;6.2069999999999999;101;50;140;5;3;7;6;65.200000000000003;30.300000000000001;34.899999999999999;46.890000000000001;53;37;196;43;44;52;39;208;62;68;19;276;3774
6;171006;Paradela de Guiães;47;56;46;54;17;10;16;9;1;1;5.8819999999999997;10;13;2;10;0;1;1;0;10.800000000000001;5;5.9000000000000004;60.039999999999999;2;3;26;7;9;2;3;20;13;18;19;278;3791
6;171104;Fornelos;120;121;116;117;58;40;53;34;5;6;8.6210000000000004;15;25;14;48;1;1;4;5;49.100000000000001;24.5;24.699999999999999;51.020000000000003;13;17;63;7;20;4;10;62;16;29;19;279;3803
6;171415;Mateus;1624;1776;1553;1732;876;929;816;850;60;79;6.8490000000000002;8.5039999999999996;30;200;1436;13;19;47;60;821.5;392.39999999999998;429.10000000000002;37.740000000000002;340;169;963;88;64;284;182;1061;98;151;19;282;3873
6;171428;Vila Cova;75;87;73;86;23;19;18;15;5;4;21.739000000000001;21.053000000000001;0;12;21;1;1;4;3;23.399999999999999;10.9;12.6;53.140000000000001;4;7;38;19;7;4;8;43;14;18;19;282;3883
6;180119;Vila Seca;200;226;174;200;97;64;90;53;7;11;7.2160000000000002;17.187999999999999;40;32;71;2;3;5;8;36.799999999999997;17.300000000000001;19.5;49.759999999999998;24;26;92;28;30;23;23;100;25;55;20;283;3907
6;180703;Arcozelos;320;354;309;354;149;112;128;87;21;25;14.093999999999999;22.321000000000002;14;45;156;3;10;18;15;71;33.700000000000003;37.299999999999997;42.619999999999997;55;41;169;31;24;45;47;178;40;44;20;289;3998
6;180717;Sarzedo;73;89;73;89;28;11;28;10;0;1;0;9.0909999999999993;14;7;17;0;1;0;0;32.5;14.6;17.800000000000001;47.229999999999997;5;10;41;11;6;10;9;38;16;16;20;289;4012
6;181802;Carregal;176;217;171;214;67;38;58;25;9;13;13.433;34.210999999999999;15;29;39;4;4;5;9;18.899999999999999;8.5;10.5;50.450000000000003;19;14;80;40;23;20;24;90;47;36;20;300;4139
6;181808;Fonte Arcada;127;143;126;142;54;43;43;33;11;10;20.370000000000001;23.256;16;15;45;2;4;9;6;23.899999999999999;11.199999999999999;12.6;51.539999999999999;12;8;59;26;22;17;11;58;28;29;20;300;4145
6;182004;Mondim da Beira;383;403;296;336;202;139;198;120;4;19;1.98;13.669;29;69;220;0;1;4;18;111;54.100000000000001;56.899999999999999;41.399999999999999;63;63;196;39;22;52;40;230;46;35;20;302;4175
6;40105;Ferradosa;68;92;69;87;20;13;16;12;4;1;20;7.6920000000000002;7;5;16;1;0;3;1;10;4.2000000000000002;5.7000000000000002;59.710000000000001;2;3;29;16;18;6;6;27;29;24;5;66;984
6;40116;Vales;42;36;42;36;15;7;15;5;0;2;0;28.571000000000002;4;7;9;0;0;0;2;11.5;6.2000000000000002;5.2999999999999998;57;4;3;18;5;12;2;2;11;10;11;5;66;995
6;40227;Parada;243;264;234;259;74;40;66;30;8;10;10.811;25;22;19;55;1;3;7;7;13.9;6.7000000000000002;7.2999999999999998;55.030000000000001;12;19;118;48;46;18;20;117;58;51;5;67;1028
6;40236;Rebordãos;254;292;248;286;90;89;80;77;10;12;11.111000000000001;13.483000000000001;23;20;114;1;2;9;10;20.800000000000001;9.6999999999999993;11.1;48.659999999999997;32;22;121;32;47;34;31;132;39;56;5;67;1037
6;40510;Cortiços;147;149;145;145;47;22;47;22;0;0;0;0;22;17;30;0;0;0;0;12.199999999999999;6.0999999999999996;6.0999999999999996;54.590000000000003;11;14;70;20;32;12;10;65;26;36;5;70;1083
6;40514;Ferreira;94;100;94;98;26;7;25;5;1;2;3.8460000000000001;28.571000000000002;14;8;8;0;1;1;1;9.9000000000000004;4.7999999999999998;5.0999999999999996;52.530000000000001;11;9;38;25;11;12;7;34;29;18;5;70;1087
6;40525;Podence;113;137;120;133;31;36;23;26;8;10;25.806000000000001;27.777999999999999;9;2;38;7;7;1;3;17.300000000000001;7.7999999999999998;9.5;53.960000000000001;7;10;47;28;21;13;13;51;35;25;5;70;1098
6;40536;Vilarinho de Agrochão;109;126;110;126;52;22;52;21;0;1;0;4.5449999999999999;37;18;18;0;1;0;0;17;7.9000000000000004;9.0999999999999996;51.780000000000001;8;12;53;17;19;10;12;57;26;21;5;70;1109
6;40613;São Martinho de Angueira;148;159;142;154;41;23;38;20;3;3;7.3170000000000002;13.042999999999999;9;6;43;2;0;1;3;8.4000000000000004;4;4.2999999999999998;62.840000000000003;6;2;66;35;39;5;4;48;44;58;5;71;1125
6;40617;Águas Vivas;84;79;75;72;45;25;40;22;5;3;11.111000000000001;12;22;18;22;1;1;4;2;17;8.8000000000000007;8.1999999999999993;49.609999999999999;3;13;42;12;14;2;15;38;14;10;5;71;1112
6;40707;Barcel;59;67;56;63;27;10;26;9;1;1;3.7039999999999997;10;19;3;13;0;0;1;1;14.9;7;7.9000000000000004;56.43;3;4;29;13;10;5;2;31;12;17;5;72;1135
6;40711;Carvalhais;642;657;620;635;298;258;258;216;40;42;13.423;16.279;22;93;359;7;13;33;29;58.899999999999999;29.100000000000001;29.800000000000001;42.719999999999999;67;112;336;78;49;88;90;350;67;62;5;72;1139
6;40729;Sucçães;270;304;261;298;110;71;95;62;15;9;13.635999999999999;12.676;28;43;86;0;3;15;6;15.9;7.5;8.4000000000000004;52.189999999999998;25;23;141;45;36;16;30;134;59;65;5;72;1157
6;40819;Tó;74;80;70;73;39;22;35;20;4;2;10.256;9.0909999999999993;19;12;24;1;1;3;1;6.5;3.1000000000000001;3.3999999999999999;49.469999999999999;2;5;46;9;12;11;10;33;13;13;5;73;1184
6;40822;Vale da Madre;85;71;86;70;51;30;47;26;4;4;7.843;13.333;10;24;39;2;1;2;3;13.5;7.4000000000000004;6.0999999999999996;49.210000000000001;2;12;53;11;7;3;5;37;13;13;5;73;1187
6;41201;Agrochão;146;134;137;124;45;27;41;26;4;1;8.8889999999999993;3.7039999999999997;18;20;29;0;0;4;1;16;8.4000000000000004;7.7000000000000002;57.380000000000003;11;6;69;29;31;8;6;49;39;32;5;77;1244
6;41202;Alvaredos;29;33;29;33;7;2;4;1;3;1;42.856999999999999;50;0;2;3;0;0;3;1;8.4000000000000004;3.8999999999999999;4.5;64.319999999999993;;;10;11;8;;2;11;9;11;5;77;1245
6;41204;Celas;144;125;154;135;18;21;18;21;0;0;0;0;12;5;22;0;0;0;0;7.0999999999999996;3.7999999999999998;3.2999999999999998;49.770000000000003;14;16;76;19;19;6;14;69;12;24;5;77;1247
6;41205;Curopos;95;117;90;114;34;23;28;16;6;7;17.646999999999998;30.434999999999999;7;9;28;2;3;4;4;9.6999999999999993;4.4000000000000004;5.4000000000000004;55.490000000000002;6;5;50;17;17;5;10;53;15;34;5;77;1248
6;41211;Moimenta;90;78;86;73;33;23;24;20;9;3;27.273;13.042999999999999;11;7;26;0;0;9;3;10.300000000000001;5.5;4.7999999999999998;52.799999999999997;12;9;39;13;17;6;6;32;15;19;5;77;1254
6;41225;Travanca;57;57;52;53;22;15;19;13;3;2;13.635999999999999;13.333;9;9;14;0;0;3;2;9.0999999999999996;4.5999999999999996;4.5999999999999996;52.030000000000001;3;5;24;13;12;8;4;26;11;8;5;77;1268
6;170332;São Julião de Montenegro;133;147;133;145;53;40;45;30;8;10;15.093999999999999;25;21;14;40;3;8;5;2;19.199999999999999;9.0999999999999996;10.1;52.280000000000001;8;15;65;24;21;9;15;64;29;30;19;271;3689
6;170337;Soutelinho da Raia;75;75;67;68;28;18;25;17;3;1;10.714;5.556;14;5;23;1;0;2;1;17.5;8.8000000000000007;8.8000000000000007;54.909999999999997;4;6;38;15;12;3;6;32;16;18;19;271;3694
6;170618;Negrões;80;97;78;95;29;19;25;14;4;5;13.792999999999999;26.315999999999999;10;15;14;2;2;2;3;8.5999999999999996;3.8999999999999999;4.7000000000000002;51.020000000000003;10;8;32;18;12;7;7;49;14;20;19;274;3739
6;170629;Sarraquinhos;140;154;141;152;62;31;60;29;2;2;3.226;6.452;48;11;30;0;1;2;1;8.8000000000000007;4.2000000000000002;4.5999999999999996;51.119999999999997;12;14;75;18;21;15;13;70;19;37;19;274;3749
6;170703;Fiolhoso;220;232;239;258;69;44;60;35;9;9;13.042999999999999;20.454999999999998;9;32;54;0;3;9;6;27.899999999999999;13.6;14.300000000000001;53.119999999999997;27;18;108;35;32;13;16;108;45;50;19;275;3759
6;170709;Vilares;105;98;103;96;37;18;29;16;8;2;21.622;11.111000000000001;12;12;21;3;0;5;2;14.4;7.5;7;49.539999999999999;8;16;54;14;13;7;10;51;14;16;19;275;3765
6;171207;Carrazedo de Montenegro;787;833;759;809;345;221;310;167;35;54;10.145;24.434000000000001;96;85;296;11;22;24;32;55.700000000000003;27.100000000000001;28.600000000000001;47.880000000000003;108;72;405;103;99;78;73;421;115;146;19;280;3816
6;171225;Sonim;134;139;139;140;45;25;36;15;9;10;20;40;15;10;26;3;9;6;1;25.399999999999999;12.5;13;55.049999999999997;9;10;63;30;22;8;14;62;23;32;19;280;3834
6;171228;Valpaços;2116;2423;2023;2344;1005;945;906;804;99;141;9.8509999999999991;14.920999999999999;91;308;1311;20;37;79;104;134.80000000000001;62.899999999999999;72;42.259999999999998;333;247;1147;221;168;377;249;1259;247;291;19;280;3837
6;10101;Agadão;173;200;169;199;86;56;77;54;9;2;10.465;3.5709999999999997;12;71;48;0;0;9;2;9.5;4.4000000000000004;5.0999999999999996;48.329999999999998;15;14;95;21;28;26;15;102;28;29;1;1;1
6;10115;Recardães;1720;1834;1603;1751;900;853;824;759;76;94;8.4440000000000008;11.02;10;737;836;14;15;62;79;472;228.40000000000001;243.59999999999999;41.359999999999999;266;199;983;173;99;241;200;1060;181;152;1;1;16
6;10116;Segadães;567;602;540;580;321;286;289;250;32;36;9.9689999999999994;12.587;4;254;281;6;10;26;26;210.19999999999999;102;108.3;39.609999999999999;89;68;343;38;29;98;69;333;52;50;1;1;17
6;10305;Avelãs de Cima;1080;1105;1041;1072;515;420;472;395;43;25;8.3499999999999996;5.952;47;423;397;6;6;37;19;53.899999999999999;26.600000000000001;27.199999999999999;46.200000000000003;145;107;569;131;128;136;98;548;143;180;1;3;34
6;10313;Vilarinho do Bairro;1322;1442;1271;1411;629;532;577;472;52;60;8.2669999999999995;11.278;90;346;613;13;19;39;41;108.09999999999999;51.700000000000003;56.399999999999999;49.159999999999997;149;120;686;193;174;122;132;698;240;250;1;3;43
6;11701;Cedrim;404;430;380;417;214;167;198;148;16;19;7.4770000000000003;11.377000000000001;21;162;163;2;3;14;16;89.099999999999994;43.200000000000003;46;44.380000000000003;53;34;234;44;39;59;40;226;55;50;1;17;180
6;11804;Gafanha da Boa Hora;1264;1361;1214;1328;645;591;562;501;83;90;12.868;15.228;70;364;629;14;12;69;78;70.5;34;36.600000000000001;38.32;224;178;666;134;62;237;188;710;133;93;1;18;192
6;60314;Lamarosa;1003;1066;949;1038;503;420;439;376;64;44;12.724;10.475999999999999;12;228;575;7;7;57;37;127.09999999999999;61.600000000000001;65.5;42.880000000000003;159;103;558;98;85;140;99;588;117;122;7;91;1492
6;60510;Quiaios;1413;1488;1354;1427;680;640;614;566;66;74;9.7059999999999995;11.563000000000001;11;431;738;8;12;58;62;62.5;30.5;32.100000000000001;45.729999999999997;191;150;763;170;139;132;145;824;196;191;7;93;1529
6;61009;Santo Varão;936;1033;892;1022;486;498;457;446;29;52;5.9669999999999996;10.442;12;122;769;2;10;27;42;166.19999999999999;79;87.200000000000003;40.450000000000003;169;97;518;73;79;173;81;563;98;118;7;98;1564
6;61303;Friúmes;303;342;281;332;130;118;120;111;10;7;7.6920000000000002;5.9320000000000004;23;59;149;1;2;9;5;43.799999999999997;20.600000000000001;23.199999999999999;47.399999999999999;45;32;149;34;43;39;24;166;49;64;7;101;1602
6;61509;Soure;3778;4139;3586;4009;1727;1570;1582;1387;145;183;8.3960000000000008;11.656000000000001;89;624;2256;21;30;124;153;85.799999999999997;40.899999999999999;44.799999999999997;46.009999999999998;541;346;2022;461;408;454;365;2147;522;651;7;103;1625
6;100914;Marrazes;10746;11782;9972;11192;5961;6156;5362;5397;599;759;10.048999999999999;12.329000000000001;84;2878;7797;101;141;498;618;1177.7;561.79999999999995;615.89999999999998;38.060000000000002;2013;1295;6132;835;471;1874;1264;7032;904;708;11;157;2240
6;100927;Memória;367;440;344;426;139;127;132;116;7;11;5.0359999999999996;8.6609999999999996;7;109;132;3;7;4;4;72.200000000000003;32.799999999999997;39.399999999999999;50.450000000000003;42;38;173;54;60;43;45;167;74;111;11;157;2241
6;101002;Vieira de Leiria;2774;3071;2624;2944;1231;1265;1093;1122;138;143;11.210000000000001;11.304;21;713;1481;22;33;116;110;135.90000000000001;64.5;71.400000000000006;44.109999999999999;428;281;1512;319;234;393;301;1629;357;391;11;158;2254
6;101513;Vermoil;1273;1383;1200;1317;604;469;554;409;50;60;8.2780000000000005;12.792999999999999;33;423;507;10;11;40;49;122.7;58.799999999999997;63.899999999999999;44.32;200;143;641;136;153;195;131;670;221;166;11;163;2291
6;101604;Arrimal;396;378;384;367;201;113;190;103;11;10;5.4729999999999999;8.8499999999999996;20;140;133;4;3;7;7;41.899999999999999;21.5;20.5;40.5;78;48;200;41;29;69;30;193;48;38;11;164;2296
6;60109;Folques;166;190;157;194;62;47;57;46;5;1;8.0649999999999995;2.1280000000000001;3;31;69;2;0;3;1;19.399999999999999;9;10.4;57.049999999999997;9;14;77;23;43;16;9;73;29;63;7;89;1447
6;60110;Moura da Serra;58;57;55;54;15;7;13;7;2;0;13.333;0;5;9;6;0;0;2;0;8.9000000000000004;4.5;4.4000000000000004;61.079999999999998;1;2;26;17;12;3;1;20;19;14;7;89;1448
6;60901;Lamas;396;442;374;427;192;172;173;155;19;17;9.8960000000000008;9.8840000000000003;5;80;243;2;1;17;16;53.5;25.300000000000001;28.199999999999999;45.539999999999999;49;44;225;46;32;57;27;237;69;52;7;97;1550
6;61201;Cabril;110;121;107;118;35;19;31;18;4;1;11.429;5.2629999999999999;1;19;29;1;0;3;1;6.5999999999999996;3.1000000000000001;3.3999999999999999;58.710000000000001;6;7;53;15;29;7;5;44;17;48;7;100;1590
6;61209;Unhais-o-Velho;224;234;220;235;83;69;76;55;7;14;8.4339999999999993;20.289999999999999;4;45;82;0;4;7;10;11.6;5.7000000000000002;5.9000000000000004;54.340000000000003;14;14;124;43;29;11;10;114;48;51;7;100;1598
6;61606;Espariz;314;319;314;299;135;128;122;103;13;25;9.6300000000000008;19.530999999999999;8;105;112;2;7;11;18;65.599999999999994;32.5;33;45.850000000000001;38;38;164;37;37;37;29;175;31;47;7;104;1634
6;61607;Meda de Mouros;106;107;97;104;49;32;45;29;4;3;8.1630000000000003;9.375;5;22;47;1;0;3;3;28;13.9;14.1;49.979999999999997;11;8;57;7;23;9;12;50;15;21;7;104;1635
6;61702;Lavegadas;93;111;91;107;39;28;30;25;9;3;23.077000000000002;10.714;2;22;31;1;1;8;2;18.100000000000001;8.3000000000000007;9.9000000000000004;52.200000000000003;6;7;51;14;15;10;9;54;13;25;7;105;1645
6;160134;Arcos De Valdevez (São Salvador);499;580;473;565;264;276;239;248;25;28;9.4700000000000006;10.145;5;99;383;3;5;22;23;1739.8;804.60000000000002;935.20000000000005;41.810000000000002;72;68;280;41;38;74;71;297;63;75;18;259;3335
6;160204;Arga de São João;26;35;26;35;11;8;11;8;0;0;0;0;5;6;8;0;0;0;0;5.2999999999999998;2.2999999999999998;3;55.390000000000001;3;4;10;5;4;2;;13;7;13;18;260;3385
6;160210;Gondar;98;124;89;121;47;42;40;40;7;2;14.894;4.7620000000000005;3;35;42;3;0;4;2;40.299999999999997;17.800000000000001;22.5;45.25;12;13;51;11;11;11;15;61;20;17;18;260;3391
6;160214;Riba de Âncora;324;399;291;375;169;125;151;107;18;18;10.651;14.4;17;74;167;2;5;16;13;84.599999999999994;37.899999999999999;46.700000000000003;46.619999999999997;35;41;189;33;26;35;31;231;40;62;18;260;3395
6;160318;Vila;711;849;704;839;341;338;305;293;36;45;10.557;13.314;24;108;466;10;14;26;31;840.10000000000002;382.89999999999998;457.19999999999999;42.090000000000003;117;86;363;81;64;113;117;414;93;112;18;261;3419
6;160520;Rubiães;242;270;239;262;103;73;94;64;9;9;8.7379999999999995;12.329000000000001;13;69;76;1;0;8;9;56.399999999999999;26.699999999999999;29.699999999999999;48.409999999999997;27;22;123;44;26;28;28;121;44;49;18;263;3472
6;160621;Vila Chã (São João Baptista);222;262;209;252;78;44;66;41;12;3;15.385;6.8179999999999996;4;42;61;0;1;12;2;33.799999999999997;15.5;18.300000000000001;49.520000000000003;26;21;113;36;26;22;19;122;54;45;18;264;3497
6;160721;Fontão;524;577;510;569;291;234;271;203;20;31;6.8730000000000002;13.247999999999999;18;189;267;4;5;16;26;228.19999999999999;108.59999999999999;119.59999999999999;42.090000000000003;91;58;286;51;38;81;58;308;60;70;18;265;3519
6;160732;Moreira do Lima;415;454;391;443;201;146;183;124;18;22;8.9550000000000001;15.068;30;131;146;0;6;18;16;86.5;41.299999999999997;45.200000000000003;43.640000000000001;70;56;204;46;39;61;39;228;63;63;18;265;3530
6;160748;Vilar das Almas;173;201;171;196;65;53;55;40;10;13;15.385;24.527999999999999;11;49;35;3;2;7;11;80;37;43;45.329999999999998;28;15;85;28;17;29;20;93;28;31;18;265;3546
6;160810;Sanfins;85;78;86;75;38;13;33;12;5;1;13.157999999999999;7.6920000000000002;1;24;20;0;0;5;1;19.800000000000001;10.300000000000001;9.5;41.149999999999999;17;7;43;11;7;12;7;37;14;8;18;266;3559
6;160921;Moreira de Geraz do Lima;283;314;278;299;147;121;131;100;16;21;10.884;17.355;8;112;111;4;3;12;18;170.40000000000001;80.799999999999997;89.599999999999994;40.810000000000002;54;29;152;28;20;51;31;160;39;33;18;267;3586
6;160927;Portela Susã;270;327;257;319;121;119;113;101;8;18;6.6120000000000001;15.125999999999999;11;123;80;3;2;5;16;166.40000000000001;75.299999999999997;91.200000000000003;42.719999999999999;45;29;140;30;26;50;33;169;34;41;18;267;3592
6;160938;Vila de Punhe;1083;1190;1008;1163;526;454;472;370;54;84;10.266;18.501999999999999;8;402;432;9;20;45;64;377.19999999999999;179.69999999999999;197.5;43.43;155;127;602;120;79;140;145;621;149;135;18;267;3601
6;161013;Sopo;271;286;250;274;135;111;128;102;7;9;5.1849999999999996;8.1080000000000005;9;123;98;0;0;7;9;37.600000000000001;18.300000000000001;19.300000000000001;46.659999999999997;39;33;141;34;24;26;26;139;44;51;18;268;3618
6;30106;Caldelas;406;466;389;450;206;172;180;130;26;42;12.621;24.419;10;67;233;5;8;21;34;211.30000000000001;98.400000000000006;112.90000000000001;45.340000000000003;50;38;234;51;33;43;63;239;66;55;4;53;472
6;30205;Airó;454;459;423;446;248;206;235;178;13;28;5.242;13.592000000000001;7;212;194;2;11;11;17;302;150.19999999999999;151.80000000000001;37.869999999999997;88;69;254;26;17;61;75;250;38;35;4;54;493
6;30224;Cossourado;402;423;364;408;215;162;192;143;23;19;10.698;11.728;15;182;138;6;6;17;13;128.09999999999999;62.399999999999999;65.700000000000003;40.399999999999999;63;57;216;36;30;69;45;218;47;44;4;54;516
6;10929;Travanca;1083;1159;1037;1124;569;498;502;402;67;96;11.775;19.277000000000001;4;370;530;21;21;46;75;477.60000000000002;230.69999999999999;246.90000000000001;39.979999999999997;179;149;609;88;58;182;138;636;114;89;1;15;176
6;11302;Cesar;1565;1601;1499;1574;883;794;810;718;73;76;8.2669999999999995;9.5719999999999992;4;971;553;9;16;64;60;581.89999999999998;287.69999999999999;294.30000000000001;40.450000000000003;245;182;914;118;106;242;157;929;138;135;1;12;116
6;11307;Madail;406;403;394;391;243;198;228;185;15;13;6.173;6.5659999999999998;8;242;163;3;2;12;11;384.10000000000002;192.80000000000001;191.40000000000001;40.340000000000003;71;48;235;27;25;54;44;227;38;40;1;12;120
6;11903;Cepelos;633;680;589;642;297;223;282;206;15;17;5.0510000000000002;7.6230000000000002;20;290;178;3;5;12;12;69.400000000000006;33.399999999999999;35.899999999999999;46.780000000000001;72;83;328;74;76;55;78;343;106;98;1;19;201
6;11905;Junqueira;510;557;472;533;224;177;211;157;13;20;5.8040000000000003;11.298999999999999;34;172;162;2;4;11;16;59.200000000000003;28.300000000000001;30.899999999999999;47.32;65;58;245;72;70;57;63;266;72;99;1;19;203
6;40301;Amedo;145;157;143;154;51;21;45;17;6;4;11.765000000000001;19.047999999999998;22;14;26;1;2;5;2;24.699999999999999;11.9;12.800000000000001;45.079999999999998;22;19;70;18;16;17;22;69;23;26;5;68;1049
6;40314;Pombal;148;176;146;162;57;31;54;29;3;2;5.2629999999999999;6.452;34;12;37;2;0;1;2;19.300000000000001;8.8000000000000007;10.5;54.82;5;15;74;26;28;15;15;65;34;47;5;68;1062
6;40319;Zedes;78;82;76;81;32;16;28;9;4;7;12.5;43.75;9;12;16;0;2;4;5;14.300000000000001;7;7.2999999999999998;51.710000000000001;9;5;41;12;11;4;9;39;13;17;5;68;1067
6;40402;Freixo de Espada à Cinta;1057;1131;1056;1122;488;430;441;372;47;58;9.6310000000000002;13.488;133;121;559;22;16;25;42;29.300000000000001;14.1;15.1;44.719999999999999;168;114;542;118;115;152;103;538;148;190;5;69;1069
6;40903;Cabeça Boa;216;212;220;217;98;58;92;55;6;3;6.1219999999999999;5.1719999999999997;48;43;56;2;1;4;2;16.199999999999999;8.1999999999999993;8;49.289999999999999;21;17;116;27;35;22;17;103;36;34;5;74;1196
6;41003;Candoso;72;86;65;81;35;21;34;15;1;6;2.8570000000000002;28.571000000000002;5;13;31;0;3;1;3;22.199999999999999;10.1;12.1;49.460000000000001;3;7;46;9;7;10;7;42;7;20;5;75;1213
6;41016;Valtorno;114;146;121;151;50;37;46;28;4;9;8;24.324000000000002;20;19;35;1;3;3;6;18.800000000000001;8.3000000000000007;10.6;50.659999999999997;19;4;57;14;20;14;9;65;24;34;5;75;1226
6;170107;Favaios;508;556;499;554;253;194;236;181;17;13;6.7190000000000003;6.7009999999999996;99;126;192;4;6;13;7;49.600000000000001;23.699999999999999;25.899999999999999;46.539999999999999;61;44;287;73;43;69;46;279;78;84;19;269;3627
6;170402;Cidadelhe;85;86;81;83;36;19;34;18;2;1;5.556;5.2629999999999999;18;14;20;0;1;2;0;66.099999999999994;32.799999999999997;33.200000000000003;50.560000000000002;7;11;41;12;14;9;5;37;15;20;19;272;3708
6;170801;Covelinhas;111;111;112;114;49;35;48;31;1;4;2.0409999999999999;11.429;37;14;28;0;1;1;3;50.399999999999999;25.199999999999999;25.199999999999999;47.609999999999999;14;15;54;15;13;10;11;53;17;20;19;276;3767
6;171007;Paços;363;399;334;377;163;137;144;109;19;28;11.656000000000001;20.437999999999999;59;58;136;3;5;16;23;44.600000000000001;21.199999999999999;23.399999999999999;44.299999999999997;54;43;179;43;44;54;46;188;50;61;19;278;3789
6;171014;Torre do Pinhão;167;175;165;173;74;41;56;35;18;6;24.324000000000002;14.634;22;18;51;5;2;13;4;23.399999999999999;11.4;12;49;17;18;85;28;19;16;15;78;44;22;19;278;3798
6;171102;Cumieira;536;610;504;590;236;203;215;183;21;20;8.8979999999999997;9.8520000000000003;79;102;217;3;4;18;16;103.5;48.399999999999999;55.100000000000001;46.210000000000001;67;64;289;63;53;71;49;312;77;101;19;279;3801
6;171402;Adoufe;1044;1111;1012;1068;513;474;441;416;72;58;14.035;12.236000000000001;16;184;657;19;13;53;45;134.30000000000001;65.099999999999994;69.200000000000003;40.759999999999998;184;134;555;98;73;167;125;606;108;105;19;282;3860
6;171404;Arroios;540;577;530;562;265;266;244;239;21;27;7.9249999999999998;10.15;11;76;396;6;9;15;18;386.30000000000001;186.80000000000001;199.59999999999999;40.159999999999997;84;78;302;49;27;86;59;338;57;37;19;282;3862
6;171405;Borbela;1257;1395;1204;1374;648;628;579;573;69;55;10.648;8.7579999999999991;31;235;886;8;16;61;39;222.09999999999999;105.3;116.8;40.869999999999997;188;146;725;134;64;207;136;781;151;120;19;282;3863
6;171412;Lamares;172;179;169;176;75;69;65;55;10;14;13.333;20.289999999999999;11;25;84;3;3;7;11;40.399999999999999;19.800000000000001;20.600000000000001;44.259999999999998;27;14;102;18;11;28;11;94;23;23;19;282;3870
6;171417;Mouçós;1494;1557;1449;1540;676;560;632;516;44;44;6.5090000000000003;7.8570000000000002;27;317;804;2;10;42;34;129.59999999999999;63.5;66.200000000000003;42.039999999999999;269;153;834;127;111;214;147;849;161;186;19;282;3875
6;171418;Nogueira;258;287;254;284;117;85;110;82;7;3;5.9829999999999997;3.5289999999999999;97;13;82;3;2;4;1;108;51.100000000000001;56.899999999999999;47.619999999999997;33;29;132;32;32;26;25;140;49;47;19;282;3876
6;171421;Pena;226;257;216;246;90;63;78;56;12;7;13.333;11.111000000000001;11;24;99;0;1;12;6;34.799999999999997;16.300000000000001;18.5;47.520000000000003;25;19;127;28;27;35;21;122;40;39;19;282;3878
6;180106;Folgosa;212;216;199;198;103;57;85;46;18;11;17.475999999999999;19.297999999999998;21;49;61;4;7;14;4;89.099999999999994;44.100000000000001;45;45.270000000000003;33;14;118;27;20;26;25;108;36;21;20;283;3894
6;180113;Santo Adrião;35;46;34;45;17;12;17;11;0;1;0;8.3330000000000002;10;5;13;0;0;0;1;23.5;10.1;13.300000000000001;41.859999999999999;6;2;22;2;3;11;2;22;10;1;20;283;3901
6;180718;Segões;50;51;41;46;16;16;15;14;1;2;6.25;12.5;2;8;19;0;0;1;2;29.800000000000001;14.800000000000001;15.1;51.329999999999998;5;9;21;7;8;3;2;24;11;11;20;289;4013
6;181201;Antas;85;99;84;95;31;15;28;13;3;2;9.6769999999999996;13.333;6;9;26;1;1;2;1;9.6999999999999993;4.5;5.2000000000000002;53.93;9;5;40;19;12;8;5;39;23;24;20;294;4060
6;181206;Penedono;478;529;437;508;240;201;228;167;12;34;5;16.914999999999999;45;83;267;5;20;7;14;44;20.899999999999999;23.100000000000001;41.810000000000002;95;54;253;40;36;83;43;274;58;71;20;294;4065
6;181502;Ervedosa do Douro;612;682;583;660;318;215;298;186;20;29;6.2889999999999997;13.488;264;47;173;5;7;15;22;32.200000000000003;15.199999999999999;17;43.640000000000001;88;77;325;67;55;97;86;312;89;98;20;297;4094
6;181505;Paredes da Beira;313;316;296;298;169;91;158;80;11;11;6.5090000000000003;12.087999999999999;99;65;74;4;3;7;8;30.600000000000001;15.199999999999999;15.4;44.299999999999997;36;36;181;32;28;37;41;157;45;36;20;297;4097
6;181804;Cunha;159;151;145;141;75;40;71;36;4;4;5.3330000000000002;10;19;30;58;2;2;2;2;18.199999999999999;9.3000000000000007;8.9000000000000004;45.520000000000003;17;29;79;15;19;14;23;70;20;24;20;300;4141
6;181805;Escurquela;68;70;64;61;24;25;21;21;3;4;12.5;16;15;8;19;0;0;3;4;16.100000000000001;7.9000000000000004;8.1999999999999993;47.649999999999999;11;12;29;7;9;3;7;33;9;18;20;300;4142
6;181814;Quintela;133;161;137;162;65;55;61;52;4;3;6.1539999999999999;5.4550000000000001;30;24;59;0;1;4;2;21.399999999999999;9.6999999999999993;11.699999999999999;48.649999999999999;15;19;57;20;22;18;18;72;18;35;20;300;4151
6;181815;Sarzeda;252;278;240;270;126;71;122;58;4;13;3.1749999999999998;18.309999999999999;20;74;86;0;9;4;4;25.899999999999999;12.300000000000001;13.6;45.039999999999999;32;26;127;44;23;38;38;129;42;31;20;300;4152
6;181902;Arcos;109;124;102;126;41;30;37;22;4;8;9.7560000000000002;26.667000000000002;9;13;37;1;1;3;7;29.300000000000001;13.699999999999999;15.6;46.770000000000003;10;12;59;13;15;12;14;60;19;19;20;301;4156
6;182003;Granja Nova;186;210;136;164;91;70;85;65;6;5;6.593;7.1429999999999998;14;30;106;0;0;6;5;77.099999999999994;36.200000000000003;40.899999999999999;43.689999999999998;26;24;98;21;17;28;23;107;23;29;20;302;4174
6;182006;São João de Tarouca;290;316;277;306;129;74;120;59;9;15;6.9770000000000003;20.27;23;57;99;0;4;9;11;32.600000000000001;15.6;17;46.740000000000002;38;21;167;33;31;41;22;164;42;47;20;302;4177
6;182010;Vila Chã da Beira;85;85;65;73;36;23;33;17;3;6;8.3330000000000002;26.087;4;17;29;0;3;3;3;20.199999999999999;10.1;10.1;45.539999999999999;10;10;45;8;12;11;8;41;10;15;20;302;4181
6;40115;Vale Pereiro;32;32;30;32;7;8;7;6;0;2;0;25;6;0;7;0;0;0;2;7.0999999999999996;3.6000000000000001;3.6000000000000001;52.079999999999998;2;4;15;4;7;2;;19;4;7;5;66;994
6;40117;Valverde;48;59;44;55;15;3;13;3;2;0;13.333;0;4;5;7;0;0;2;0;8.5;3.7999999999999998;4.7000000000000002;49.350000000000001;4;6;19;6;13;13;4;18;14;10;5;66;996
6;40204;Baçal;243;241;243;239;103;84;95;77;8;7;7.7670000000000003;8.3330000000000002;20;39;113;4;3;4;4;17.100000000000001;8.5999999999999996;8.5;51.090000000000003;32;18;114;45;34;16;22;117;34;52;5;67;1003
6;40209;Castro de Avelãs;229;231;223;223;105;110;96;97;9;13;8.5709999999999997;11.818;15;23;155;0;2;9;11;34.100000000000001;17;17.100000000000001;47.93;28;19;121;42;19;20;19;136;30;26;5;67;1010
6;40213;Espinhosela;130;114;126;111;48;30;43;24;5;6;10.417;20;15;17;35;2;2;3;4;6.5999999999999996;3.5;3.1000000000000001;57.609999999999999;7;10;58;26;29;4;7;48;20;35;5;67;1014
6;40226;Outeiro;152;149;150;148;30;16;28;15;2;1;6.6669999999999998;6.25;10;6;27;2;0;0;1;7.4000000000000004;3.7000000000000002;3.6000000000000001;65.760000000000005;3;9;49;31;60;5;2;45;25;72;5;67;1027
6;40245;Bragança (Sé);8452;9461;8607;10000;4368;4727;3934;4295;434;432;9.9359999999999999;9.1389999999999993;78;1202;6949;97;136;337;296;1671.0999999999999;788.5;882.60000000000002;40.409999999999997;1320;1018;4934;701;479;1272;1076;5560;779;774;5;67;1005
6;40248;Sortes;138;158;130;157;52;41;48;35;4;6;7.6920000000000002;14.634;16;27;40;1;1;3;5;13.9;6.5;7.4000000000000004;50.509999999999998;12;15;65;23;23;16;13;69;21;39;5;67;1047
6;40515;Grijó;172;199;172;202;69;58;62;53;7;5;10.145;8.6210000000000004;5;31;79;0;1;7;4;41.700000000000003;19.300000000000001;22.300000000000001;49.890000000000001;19;23;85;25;20;19;11;91;33;45;5;70;1088
6;40608;Miranda do Douro;1084;1170;1063;1174;545;551;500;484;45;67;8.2569999999999997;12.16;28;127;829;14;14;31;53;63.5;30.5;32.899999999999999;43.75;165;105;604;101;109;140;123;632;124;151;5;71;1120
6;40609;Palaçoulo;284;270;263;252;127;88;121;80;6;8;4.7240000000000002;9.0909999999999993;22;98;81;1;3;5;5;13.1;6.7000000000000002;6.4000000000000004;47.299999999999997;34;30;140;38;42;27;32;126;32;53;5;71;1121
6;40725;Pereira;64;126;59;96;27;33;23;30;4;3;14.815;9.0909999999999993;6;7;40;0;0;4;3;26.199999999999999;8.8000000000000007;17.399999999999999;45.460000000000001;4;5;34;9;12;13;37;45;17;14;5;72;1153
6;40731;Vale de Asnes;134;137;133;136;23;12;22;11;1;1;4.3479999999999999;8.3330000000000002;10;8;15;0;0;1;1;12.699999999999999;6.2999999999999998;6.4000000000000004;48.799999999999997;18;9;67;21;19;18;10;67;17;25;5;72;1159
6;40804;Brunhoso;107;109;105;106;51;26;41;15;10;11;19.608000000000001;42.308;15;18;23;2;5;8;6;10.4;5.0999999999999996;5.2000000000000002;44.469999999999999;11;10;64;12;10;19;10;53;9;18;5;73;1169
6;40805;Brunhozinho;42;44;41;42;14;6;13;6;1;0;7.1429999999999998;0;7;2;10;0;0;1;0;5.5;2.7000000000000002;2.7999999999999998;56.100000000000001;4;1;19;11;7;2;5;13;13;11;5;73;1170
6;40808;Castro Vicente;162;175;152;171;79;33;72;16;7;17;8.8610000000000007;51.515000000000001;42;15;31;3;10;4;7;9.6999999999999993;4.7000000000000002;5;50.539999999999999;17;11;90;17;27;14;17;76;28;40;5;73;1173
6;40816;Sanhoane;67;59;65;58;28;13;27;12;1;1;3.5709999999999997;7.6920000000000002;19;5;15;0;1;1;0;9.9000000000000004;5.2999999999999998;4.7000000000000002;53.719999999999999;3;3;33;15;13;5;5;25;15;9;5;73;1181
6;40824;Valverde;66;67;65;66;23;9;23;9;0;0;0;0;13;1;18;0;0;0;0;5.5;2.7000000000000002;2.7999999999999998;59.579999999999998;4;2;29;10;21;2;2;25;16;22;5;73;1189
6;41104;Avelanoso;72;76;81;83;26;19;24;18;2;1;7.6920000000000002;5.2629999999999999;12;8;22;1;0;1;1;5.0999999999999996;2.5;2.6000000000000001;58.020000000000003;3;5;33;13;18;4;6;27;17;22;5;76;1233
6;41106;Campo de Víboras;71;84;68;79;33;30;32;25;1;5;3.0299999999999998;16.667000000000002;17;7;33;0;0;1;5;6.2000000000000002;2.8999999999999999;3.3999999999999999;55.509999999999998;2;6;34;10;19;8;5;36;12;23;5;76;1235
6;41109;Pinelo;105;117;95;110;28;18;28;17;0;1;0;5.556;9;8;28;0;0;0;1;6.7000000000000002;3.2000000000000002;3.6000000000000001;60;9;3;43;24;26;5;4;39;31;38;5;76;1238
6;41112;Vale de Frades;80;80;81;77;17;13;15;7;2;6;11.765000000000001;46.154000000000003;9;2;11;0;3;2;3;4;2;2;64.859999999999999;2;3;19;21;35;3;4;20;21;32;5;76;1241
6;41206;Edral;94;104;94;104;31;19;28;12;3;7;9.6769999999999996;36.841999999999999;11;14;15;1;5;2;2;7.5999999999999996;3.6000000000000001;4;55.509999999999998;6;2;50;16;20;11;6;42;23;22;5;77;1249
6;41212;Montouto;53;57;51;57;11;5;10;3;1;2;9.0909999999999993;40;4;5;4;1;0;0;2;4.0999999999999996;2;2.1000000000000001;56.359999999999999;4;5;20;9;15;4;4;19;14;16;5;77;1255
6;41213;Nunes;64;70;63;70;19;17;18;15;1;2;5.2629999999999999;11.765000000000001;9;5;19;0;0;1;2;17.399999999999999;8.3000000000000007;9.0999999999999996;53.719999999999999;7;6;27;12;12;3;5;34;16;12;5;77;1256
6;41216;Penhas Juntas;128;127;127;125;21;13;20;10;1;3;4.7620000000000005;23.077000000000002;7;8;15;0;0;1;3;9.6999999999999993;4.9000000000000004;4.7999999999999998;46.109999999999999;25;9;61;16;17;20;15;47;16;29;5;77;1259
6;41219;Rebordelo;323;295;299;287;104;64;98;54;6;10;5.7690000000000001;15.625;22;45;85;1;5;5;5;29.300000000000001;15.300000000000001;14;51.329999999999998;30;34;151;51;57;19;30;134;52;60;5;77;1262
6;41220;Santa Cruz;25;32;23;29;12;5;11;3;1;2;8.3330000000000002;40;9;0;5;1;1;0;1;5.4000000000000004;2.2999999999999998;3;57.670000000000002;2;2;12;5;4;2;2;11;5;12;5;77;1263
6;170313;Faiões;424;449;418;437;199;138;175;118;24;20;12.06;14.493;16;62;215;4;6;20;14;108;52.399999999999999;55.5;45.460000000000001;48;46;237;54;39;60;41;233;60;55;19;271;3667
6;170329;Santa Leocádia;148;176;149;177;53;23;45;16;8;7;15.093999999999999;30.434999999999999;27;14;20;2;6;6;1;24.699999999999999;11.300000000000001;13.4;53.659999999999997;11;11;76;27;23;12;13;79;35;37;19;271;3685
6;170331;Santo Estêvão;291;316;285;314;123;83;102;76;21;7;17.073;8.4339999999999993;14;38;126;3;1;18;6;70;33.600000000000001;36.399999999999999;47.25;43;28;148;47;25;39;15;159;55;48;19;271;3688
6;170339;Travancas;179;223;167;210;62;29;56;26;6;3;9.6769999999999996;10.345000000000001;37;11;34;3;0;3;3;30.100000000000001;13.4;16.699999999999999;54.460000000000001;13;14;87;29;36;19;17;92;45;50;19;271;3696
6;170343;Vila Verde da Raia;464;529;433;495;215;178;187;135;28;43;13.023;24.157;11;71;240;6;20;22;23;101.59999999999999;47.5;54.100000000000001;45.200000000000003;60;52;264;60;28;54;61;273;62;79;19;271;3700
6;170344;Vilar de Nantes;970;1114;915;1068;480;437;429;396;51;41;10.625;9.3819999999999997;17;146;662;9;14;42;27;286.5;133.30000000000001;153.09999999999999;44.710000000000001;128;98;534;114;96;135;137;590;113;139;19;271;3701
6;170601;Cabril;265;288;251;267;100;63;94;52;6;11;6;17.460000000000001;31;50;65;1;5;5;6;7.2000000000000002;3.5;3.7999999999999998;50.799999999999997;27;28;126;39;45;26;19;133;40;70;19;274;3722
6;170606;Covelães;69;66;63;58;29;16;28;15;1;1;3.448;6.25;12;3;28;0;0;1;1;6.7000000000000002;3.3999999999999999;3.2999999999999998;54.82;5;4;37;9;14;3;4;30;15;14;19;274;3727
6;170607;Covelo do Gerês;99;95;95;92;43;15;36;11;7;4;16.279;26.667000000000002;6;22;19;0;2;7;2;18;9.1999999999999993;8.8000000000000007;48.07;10;14;47;12;16;8;12;45;19;11;19;274;3728
6;170611;Fiães do Rio;36;40;34;41;8;5;4;5;4;0;50;0;1;4;4;3;0;1;0;12.6;6;6.5999999999999996;52.5;1;5;16;8;6;4;2;17;13;4;19;274;3732
6;170612;Gralhas;98;110;109;118;31;15;29;12;2;3;6.452;20;16;5;20;0;1;2;2;9.5999999999999996;4.5;5.0999999999999996;61.619999999999997;4;;46;31;17;3;2;44;34;27;19;274;3733
6;170615;Montalegre;856;960;812;927;422;411;391;370;31;41;7.3460000000000001;9.9759999999999991;21;82;658;15;14;16;27;91.700000000000003;43.200000000000003;48.5;44.469999999999999;112;99;472;89;84;116;110;498;99;137;19;274;3736
6;170623;Pitões das Junias;67;94;62;83;39;34;36;31;3;3;7.6920000000000002;8.8239999999999998;38;10;19;0;1;3;2;4.7999999999999998;2;2.7999999999999998;49.729999999999997;5;7;39;11;5;6;12;45;14;17;19;274;3744
6;170634;Viade de Baixo;347;328;339;325;109;66;105;64;4;2;3.6699999999999999;3.0299999999999998;27;40;102;2;0;2;2;15.699999999999999;8.0999999999999996;7.5999999999999996;48.369999999999997;46;34;177;34;56;37;28;152;51;60;19;274;3754
6;170704;Jou;328;326;311;307;131;54;106;43;25;11;19.084;20.370000000000001;47;33;69;2;2;23;9;17.5;8.8000000000000007;8.6999999999999993;54.170000000000002;33;25;154;63;53;19;15;140;70;82;19;275;3760
6;171213;Lebução;277;285;277;283;69;43;68;42;1;1;1.4490000000000001;2.3260000000000001;9;14;87;1;1;0;0;39.100000000000001;19.300000000000001;19.800000000000001;46.899999999999999;53;26;128;28;42;28;33;127;41;56;19;280;3822
6;171216;Possacos;211;235;201;228;100;41;93;33;7;8;7;19.512;35;39;52;1;4;6;4;34.100000000000001;16.100000000000001;18;51.030000000000001;11;28;113;32;27;17;25;104;42;47;19;280;3825
6;171222;São João da Corveira;247;290;231;274;110;43;98;34;12;9;10.909000000000001;20.93;40;37;55;2;4;10;5;33.899999999999999;15.6;18.300000000000001;51.799999999999997;18;22;127;48;32;16;27;148;53;46;19;280;3831
6;171305;Capeludos;200;240;199;233;76;26;68;19;8;7;10.526;26.923000000000002;32;21;34;3;4;5;3;20.5;9.3000000000000007;11.199999999999999;55.100000000000001;11;15;103;42;29;14;22;99;51;54;19;281;3845
6;90610;Moimenta da Serra;292;360;283;354;93;87;85;82;8;5;8.6020000000000003;5.7469999999999999;9;35;123;1;1;7;4;100.8;45.200000000000003;55.700000000000003;48.829999999999998;48;24;148;42;30;48;26;162;46;78;10;140;1930
6;90615;Rio Torto;204;259;195;244;106;109;97;98;9;11;8.4909999999999997;10.092000000000001;50;47;98;3;5;6;6;54.200000000000003;23.899999999999999;30.300000000000001;50.75;18;30;102;23;31;23;16;116;44;60;10;140;1935
6;91207;Loriga;521;532;493;511;223;183;190;145;33;38;14.798;20.765000000000001;4;106;225;4;11;29;27;29.100000000000001;14.4;14.699999999999999;51.299999999999997;33;56;289;81;62;32;46;278;78;98;10;146;2090
6;91215;Santa Marinha;490;501;442;474;200;185;162;139;38;46;19;24.864999999999998;16;108;177;3;8;35;38;117.7;58.200000000000003;59.5;48.770000000000003;56;53;254;68;59;32;45;254;83;87;10;146;2098
6;91224;Travancinha;219;253;212;245;112;95;99;82;13;13;11.606999999999999;13.683999999999999;6;109;66;2;3;11;10;37.899999999999999;17.600000000000001;20.300000000000001;47.609999999999999;24;29;108;21;37;28;26;123;35;41;10;146;2107
6;90217;Miuzela;187;181;177;174;61;43;54;36;7;7;11.475;16.279;10;25;55;1;2;6;5;26.5;13.5;13;51.670000000000002;21;18;92;29;27;11;16;72;37;45;10;136;1851
6;90219;Nave de Haver;158;200;152;195;31;30;27;28;4;2;12.903;6.6669999999999998;7;16;32;0;1;4;1;8.6999999999999993;3.7999999999999998;4.9000000000000004;63.920000000000002;9;8;56;38;47;8;2;65;41;84;10;136;1853
6;90221;Parada;58;56;56;55;18;16;17;14;1;2;5.556;12.5;3;9;19;1;1;0;1;9.0999999999999996;4.5999999999999996;4.4000000000000004;57.090000000000003;2;3;31;14;8;1;3;24;14;14;10;136;1855
6;90227;Vale da Mula;97;85;96;85;41;31;33;26;8;5;19.512;16.129000000000001;20;10;29;2;1;6;4;11.1;5.9000000000000004;5.2000000000000002;54.329999999999998;9;7;49;13;19;2;5;44;17;17;10;136;1860
6;90306;Forno Telheiro;347;388;330;384;186;149;174;132;12;17;6.452;11.409000000000001;25;116;165;0;3;12;14;35.399999999999999;16.699999999999999;18.699999999999999;46.859999999999999;45;29;195;29;49;41;43;194;41;69;10;137;1872
6;90411;Penha de Águia;48;63;44;62;28;21;25;19;3;2;10.714;9.5240000000000009;33;5;6;0;0;3;2;7.4000000000000004;3.2000000000000002;4.2000000000000002;61.289999999999999;2;;22;14;10;3;3;18;21;18;10;138;1896
6;90414;Vale de Afonsinho;41;42;40;42;13;7;10;7;3;0;23.077000000000002;0;2;7;8;0;0;3;0;6.2999999999999998;3.1000000000000001;3.2000000000000002;55.630000000000003;1;5;19;11;5;1;;24;6;11;10;138;1899
6;90701;Adão;110;123;107;122;47;45;43;40;4;5;8.5109999999999992;11.111000000000001;2;21;60;0;1;4;4;11.199999999999999;5.2999999999999998;5.9000000000000004;54.640000000000001;9;7;52;20;22;7;7;59;18;32;10;141;1941
6;90730;Pêra do Moço;400;431;385;413;200;161;170;137;30;24;15;14.907;8;81;218;3;6;27;18;40.299999999999997;19.399999999999999;20.899999999999999;46.299999999999997;44;38;228;45;45;57;35;221;38;80;10;141;1974
6;90733;Pousada;52;66;49;64;19;17;13;14;6;3;31.579000000000001;17.646999999999998;1;5;21;0;0;6;3;9.1999999999999993;4;5.0999999999999996;58.359999999999999;4;3;21;8;16;2;5;22;16;21;10;141;1977
6;90735;Ribeira dos Carinhos;51;57;52;54;19;22;19;17;0;5;0;22.727;4;11;21;0;1;0;4;11.9;5.5999999999999996;6.2999999999999998;53.780000000000001;1;10;20;14;6;2;2;28;12;13;10;141;1979
6;90737;Rochoso;107;157;105;158;38;32;36;25;2;7;5.2629999999999999;21.875;3;15;43;0;1;2;6;13.699999999999999;5.5999999999999996;8.1999999999999993;58.880000000000003;7;6;43;23;28;13;13;44;29;58;10;141;1981
6;90740;Jarmelo (São Pedro);91;93;86;90;32;21;29;19;3;2;9.375;9.5240000000000009;9;5;34;1;0;2;2;8.8000000000000007;4.4000000000000004;4.4000000000000004;61.82;4;5;32;22;28;5;3;26;26;33;10;141;1965
6;90745;Trinta;201;205;195;199;85;81;70;62;15;19;17.646999999999998;23.457000000000001;0;60;72;2;4;13;15;53.200000000000003;26.300000000000001;26.800000000000001;47.759999999999998;23;23;100;34;21;25;17;97;31;35;10;141;1986
6;90912;Poço do Canto;213;230;199;225;83;53;77;47;6;6;7.2290000000000001;11.321;44;32;48;3;4;3;2;27.300000000000001;13.1;14.199999999999999;52.380000000000003;26;21;101;32;33;14;18;101;37;60;10;143;2011
6;90913;Prova;83;104;84;105;29;27;27;24;2;3;6.8970000000000002;11.111000000000001;10;10;31;0;1;2;2;13.5;6;7.5;51.649999999999999;9;9;38;15;12;6;10;43;23;22;10;143;2012
6;91004;Bogalhal;16;21;16;20;4;1;4;0;0;1;0;100;2;0;2;0;0;0;1;2.2000000000000002;0.90000000000000002;1.2;59.590000000000003;1;2;4;4;5;1;1;9;7;3;10;144;2019
6;91006;Cerejo;67;65;69;62;24;12;21;6;3;6;12.5;50;13;9;5;2;2;1;4;18.899999999999999;9.5999999999999996;9.3000000000000007;60.229999999999997;2;4;28;17;16;3;3;18;21;20;10;144;2021
6;91009;Ervedosa;83;107;84;105;26;26;26;24;0;2;0;7.6920000000000002;26;7;17;0;2;0;0;14.800000000000001;6.5;8.3000000000000007;56.520000000000003;9;6;32;17;19;4;11;41;24;27;10;144;2024
6;91012;Lamegal;128;125;112;111;68;39;62;34;6;5;8.8239999999999998;12.821;27;33;36;2;1;4;4;11.5;5.7999999999999998;5.7000000000000002;55.289999999999999;8;11;63;21;25;6;10;47;24;38;10;144;2027
6;91014;Manigoto;88;98;79;89;48;30;46;30;2;0;4.1669999999999998;0;35;15;26;0;0;2;0;11.699999999999999;5.5;6.2000000000000002;56.299999999999997;8;7;44;13;16;3;7;36;18;34;10;144;2029
6;91022;Santa Eufémia;83;89;72;84;25;16;21;13;4;3;16;18.75;6;6;22;0;0;4;3;14;6.7999999999999998;7.2999999999999998;58.490000000000002;7;3;34;15;24;1;12;30;19;27;10;144;2037
6;91116;Lajeosa;84;117;85;118;16;14;12;12;4;2;25;14.286;3;5;16;0;0;4;2;12.199999999999999;5.0999999999999996;7.0999999999999996;67.290000000000006;2;2;26;19;35;3;2;28;29;55;10;145;2058
6;91117;Lomba;29;28;29;28;8;3;8;3;0;0;0;0;2;3;6;0;0;0;0;14.9;7.5999999999999996;7.2999999999999998;58.82;1;2;9;11;6;1;3;8;11;5;10;145;2059
6;91121;Pena Lobo;72;69;67;66;22;10;20;9;2;1;9.0909999999999993;10;7;7;15;0;0;2;1;9.5999999999999996;4.9000000000000004;4.7000000000000002;58.82;1;3;39;18;11;1;4;27;12;25;10;145;2063
6;91129;Ruvina;46;66;45;57;18;12;15;9;3;3;16.667000000000002;25;1;9;14;3;3;0;0;13.9;5.7000000000000002;8.1999999999999993;49.100000000000001;4;5;23;7;7;8;13;18;12;15;10;145;2071
6;91135;Vale das Éguas;17;22;17;21;5;0;4;0;1;0;20;0;1;1;2;0;0;1;0;11.1;4.7999999999999998;6.2999999999999998;67.739999999999995;;;6;6;5;;;5;10;7;10;145;2077
6;91139;Vila do Touro;84;99;81;96;24;14;22;14;2;0;8.3330000000000002;0;1;9;26;0;0;2;0;7.9000000000000004;3.6000000000000001;4.2999999999999998;65.140000000000001;1;3;35;16;29;2;2;29;24;42;10;145;2081
6;91320;Souto Maior;62;69;62;69;30;20;27;19;3;1;10;5;3;14;29;0;0;3;1;21.399999999999999;10.1;11.300000000000001;51.109999999999999;5;7;36;4;10;3;6;34;9;17;10;147;2129
6;91323;Torre do Terrenho;68;90;68;90;21;18;20;17;1;1;4.7620000000000005;5.556;9;6;22;0;0;1;1;15.4;6.5999999999999996;8.8000000000000007;48.840000000000003;7;12;32;9;8;13;3;40;15;19;10;147;2132
6;50201;Alcains;2463;2559;2331;2446;1248;1099;1104;975;144;124;11.538;11.282999999999999;51;828;1200;22;33;122;91;135.90000000000001;66.700000000000003;69.299999999999997;44.149999999999999;388;231;1343;264;237;308;233;1398;274;346;6;79;1284
6;50207;Escalos de Baixo;350;396;342;392;180;150;160;119;20;31;11.111000000000001;20.667000000000002;14;97;168;0;6;20;25;16.199999999999999;7.5999999999999996;8.5999999999999996;50.039999999999999;35;28;193;50;44;37;30;189;55;85;6;79;1290
6;50211;Lardosa;446;515;447;521;192;163;160;144;32;19;16.667000000000002;11.656000000000001;18;107;179;3;1;29;18;21.600000000000001;10;11.6;51.119999999999997;49;36;228;69;64;46;28;232;85;124;6;79;1294
6;50222;São Vicente da Beira;609;650;575;616;228;153;209;135;19;18;8.3330000000000002;11.765000000000001;24;155;165;1;5;18;13;12.6;6.0999999999999996;6.5;52.460000000000001;58;58;295;93;105;52;43;266;122;167;6;79;1305
6;50223;Sarzedas;613;722;602;715;193;107;185;101;8;6;4.1449999999999996;5.6070000000000002;37;106;143;1;0;7;6;7.7999999999999998;3.6000000000000001;4.2000000000000002;61.659999999999997;22;36;248;127;180;25;27;239;178;253;6;79;1306
6;50503;Idanha-a-Nova;1125;1227;1135;1284;515;482;482;439;33;43;6.4080000000000004;8.9209999999999994;112;121;688;4;14;29;29;10.300000000000001;4.9000000000000004;5.4000000000000004;46.689999999999998;175;84;585;112;169;145;105;579;137;261;6;82;1373
6;50507;Monfortinho;251;285;232;262;98;86;76;60;22;26;22.449000000000002;30.233000000000001;15;5;116;1;1;21;25;10.1;4.7000000000000002;5.4000000000000004;56.219999999999999;15;12;120;51;53;16;13;126;61;69;6;82;1377
6;50511;Proença-a-Velha;104;120;108;120;26;17;24;15;2;2;7.6920000000000002;11.765000000000001;7;4;28;2;2;0;0;3.8999999999999999;1.8;2.1000000000000001;62.039999999999999;5;4;41;23;31;5;6;36;24;49;6;82;1381
6;50705;Bemposta;59;61;54;57;15;9;13;8;2;1;13.333;11.111000000000001;3;5;13;0;0;2;1;12.1;5.9000000000000004;6.0999999999999996;65.730000000000004;1;4;20;10;24;2;2;15;12;30;6;84;1404
6;50706;Benquerença;277;298;262;286;116;85;107;75;9;10;7.7590000000000003;11.765000000000001;36;56;90;0;2;9;8;20.100000000000001;9.6999999999999993;10.4;56.530000000000001;14;26;126;41;70;15;17;114;57;95;6;84;1405
6;50710;Penamacor;752;825;695;779;308;282;282;255;26;27;8.4420000000000002;9.5739999999999998;47;103;387;10;5;16;22;4.2000000000000002;2;2.2000000000000002;50.609999999999999;95;81;340;107;129;73;66;363;118;205;6;84;1409
6;51104;Vila Velha de Ródão;824;942;822;975;345;315;319;298;26;17;7.5359999999999996;5.3970000000000002;20;200;397;1;4;25;13;19.5;9.0999999999999996;10.4;52.719999999999999;87;47;426;127;137;72;67;437;123;243;6;88;1438
6;50104;Inguias;336;334;330;330;140;98;125;86;15;12;10.714;12.244999999999999;16;75;120;0;2;15;10;28.899999999999999;14.5;14.4;50.109999999999999;46;29;155;54;52;26;21;155;67;65;6;78;1282
6;50105;Maçainhas;166;190;163;192;59;52;43;41;16;11;27.119;21.154;12;21;51;1;0;15;11;19.600000000000001;9.0999999999999996;10.4;50.649999999999999;21;10;80;30;25;25;15;67;40;43;6;78;1283
6;50302;Aldeia de São Francisco de Assis;303;329;278;300;151;92;145;79;6;13;3.9740000000000002;14.130000000000001;1;134;89;1;1;5;12;39.299999999999997;18.899999999999999;20.5;47.359999999999999;35;20;192;33;23;34;27;169;34;65;6;80;1309
6;50307;Covilhã (Conceição);3382;3793;3528;3985;1639;1694;1416;1416;223;278;13.606;16.411000000000001;15;531;2286;39;45;184;233;1472.3;694;778.29999999999995;44.759999999999998;471;337;1897;363;314;422;338;2073;490;470;6;80;1318
6;50308;Cortes do Meio;430;454;414;451;200;171;172;139;28;32;14;18.713000000000001;16;136;159;4;5;24;27;18.699999999999999;9.0999999999999996;9.5999999999999996;46.909999999999997;50;54;245;49;32;32;57;239;54;72;6;80;1316
6;50311;Ferro;816;884;791;861;417;346;352;279;65;67;15.587999999999999;19.364000000000001;80;181;370;13;15;52;52;55.299999999999997;26.5;28.699999999999999;45.189999999999998;109;99;451;76;81;114;81;443;91;155;6;80;1324
6;50314;Paul;772;852;728;823;354;318;305;268;49;50;13.842000000000001;15.723000000000001;9;187;377;6;4;43;46;67.700000000000003;32.200000000000003;35.5;47.270000000000003;91;93;416;94;78;81;68;434;120;149;6;80;1327
6;50401;Alcaide;300;316;290;317;142;118;121;99;21;19;14.789;16.102;18;63;139;4;3;17;16;36.899999999999999;18;18.899999999999999;48.770000000000003;28;34;162;43;33;29;25;158;53;51;6;81;1340
6;50421;Pêro Viseu;347;381;370;381;164;138;143;113;21;25;12.805;18.116;24;91;141;4;3;17;22;37.899999999999999;18.100000000000001;19.800000000000001;45.450000000000003;46;31;193;34;43;43;48;188;39;63;6;81;1362
6;100103;Alpedriz;389;388;362;375;174;148;151;122;23;26;13.218;17.568000000000001;7;132;134;1;3;22;23;48.100000000000001;24.100000000000001;24;45.950000000000003;54;42;203;50;40;47;31;197;51;62;11;149;2162
6;100105;Benedita;4190;4445;3968;4265;2293;2108;2079;1860;214;248;9.3330000000000002;11.765000000000001;96;1697;2146;33;45;181;203;296;143.59999999999999;152.40000000000001;40.240000000000002;682;524;2378;376;230;677;538;2434;413;383;11;149;2164
6;100106;Cela;1599;1665;1497;1597;781;662;718;598;63;64;8.0670000000000002;9.6679999999999993;133;457;726;17;10;46;54;126.40000000000001;61.899999999999999;64.5;44.25;242;180;850;176;151;196;165;895;195;214;11;149;2165
6;100608;Nadadouro;941;963;886;937;468;413;412;352;56;61;11.965999999999999;14.77;20;175;569;11;12;45;49;178.59999999999999;88.299999999999997;90.299999999999997;41.82;160;96;534;91;60;159;76;531;92;105;11;154;2208
6;101401;Peniche (Ajuda);3830;4159;3649;4132;1876;1712;1555;1412;321;300;17.111000000000001;17.523;261;870;1836;58;39;263;261;1659;795.29999999999995;863.60000000000002;43.090000000000003;589;461;2088;428;264;539;439;2177;535;469;11;162;2272
6;101406;Ferrel;1281;1368;1222;1337;631;553;566;458;65;95;10.301;17.178999999999998;146;246;632;10;16;55;79;192.09999999999999;92.900000000000006;99.200000000000003;42.210000000000001;196;133;721;139;92;194;137;743;162;132;11;162;2271
6;110102;Aldeia Galega da Merceana;996;1083;948;1059;509;413;462;375;47;38;9.234;9.2010000000000005;90;224;523;7;2;40;36;105.5;50.600000000000001;55;44.189999999999998;148;106;550;97;95;151;95;527;149;161;12;165;2307
6;110108;Olhalvo;901;1006;859;974;475;381;425;341;50;40;10.526;10.499000000000001;23;223;520;6;6;44;34;229.90000000000001;108.59999999999999;121.3;45.57;117;76;502;107;99;136;95;495;131;149;12;165;2316
6;110114;Vila Verde dos Francos;586;576;567;569;285;204;259;182;26;22;9.1229999999999993;10.784000000000001;45;153;243;5;4;21;18;41.299999999999997;20.800000000000001;20.5;46.329999999999998;77;56;311;73;69;61;45;305;85;80;12;165;2321
6;110115;Carregado;5770;5937;5386;5707;3434;3158;3013;2698;421;460;12.26;14.566000000000001;53;1481;4177;71;64;350;396;775.70000000000005;382.30000000000001;393.39999999999998;34.560000000000002;1256;701;3399;256;158;1111;696;3510;325;295;12;165;2314
6;110201;Arranhó;1180;1201;1155;1197;621;502;580;449;41;53;6.6020000000000003;10.558;33;279;717;13;14;28;39;112;55.5;56.5;42.159999999999997;215;99;638;135;93;181;108;644;152;116;12;167;2333
6;110806;Santa Bárbara;943;1000;864;951;520;413;474;366;46;47;8.8460000000000001;11.380000000000001;97;231;512;10;6;36;41;258.30000000000001;125.40000000000001;133;39.560000000000002;162;99;557;75;50;172;112;539;78;99;12;173;2440
6;111312;Runa;476;528;458;519;241;196;205;168;36;28;14.938000000000001;14.286;18;125;230;3;4;33;24;151;71.599999999999994;79.400000000000006;47.310000000000002;59;55;232;67;63;65;47;232;76;108;12;179;2513
6;111317;Turcifal;1628;1714;1625;1726;869;753;807;688;62;65;7.1349999999999998;8.6319999999999997;80;360;1055;6;21;56;44;135.30000000000001;65.900000000000006;69.400000000000006;42.18;289;154;885;183;117;238;168;944;182;182;12;179;2518
6;140103;Alvega;734;765;697;758;299;188;244;160;55;28;18.395;14.894;22;167;215;6;6;49;22;27.100000000000001;13.300000000000001;13.800000000000001;50.130000000000003;77;63;380;93;121;78;52;352;117;166;16;225;3060
6;140108;Rio de Moinhos;583;619;544;589;272;219;231;197;41;22;15.074;10.045999999999999;9;162;257;2;5;39;17;60;29.100000000000001;30.899999999999999;47.640000000000001;70;60;314;60;79;72;49;297;80;121;16;225;3068
6;140115;Tramagal;1679;1821;1619;1772;717;619;623;540;94;79;13.109999999999999;12.763;30;381;752;10;7;84;72;145.19999999999999;69.700000000000003;75.599999999999994;50.109999999999999;187;143;882;231;236;183;121;898;259;360;16;225;3073
6;140203;Espinheiro;260;293;241;281;117;94;106;84;11;10;9.4019999999999992;10.638;1;54;135;2;3;9;7;56;26.300000000000001;29.699999999999999;52.07;23;17;136;41;43;19;19;142;50;63;16;226;3077
6;140802;Montalvo;625;650;595;631;319;274;295;249;24;25;7.524;9.1240000000000006;16;217;311;6;5;18;20;99.5;48.799999999999997;50.700000000000003;41.5;105;71;352;59;38;90;57;363;64;76;16;232;3110
6;141002;Nossa Senhora de Fátima;6077;6553;5661;6289;3231;3106;2934;2751;297;355;9.1920000000000002;11.429;20;959;4706;72;71;225;284;1377.7;662.89999999999998;714.79999999999995;38.420000000000002;1168;671;3460;435;343;1115;663;3701;518;556;16;234;3120
6;141703;Sardoal;1172;1232;1095;1182;556;469;487;405;69;64;12.41;13.646000000000001;19;197;676;16;18;53;46;80.099999999999994;39.100000000000001;41.100000000000001;45.68;175;138;619;100;140;139;110;621;147;215;16;242;3209
6;141811;Santa Maria dos Olivais;5847;6769;5766;6700;2789;2898;2413;2545;376;353;13.481999999999999;12.180999999999999;61;846;4051;74;68;302;285;730.5;338.5;391.89999999999998;43.93;892;726;3080;590;559;826;663;3607;779;894;16;243;3223
6;141815;Serra;552;639;537;639;218;170;174;153;44;17;20.183;10;31;98;198;7;5;37;12;35.5;16.5;19.100000000000001;50.909999999999997;54;53;290;77;78;60;59;263;93;164;16;243;3225
6;142102;Atouguia;1187;1267;1130;1244;583;504;553;460;30;44;5.1459999999999999;8.7300000000000004;10;384;619;2;6;28;38;125.09999999999999;60.5;64.599999999999994;41.719999999999999;174;154;645;120;94;205;155;635;145;127;16;238;3142
6;142103;Casal dos Bernardos;430;491;413;474;187;138;176;123;11;15;5.8819999999999997;10.869999999999999;7;162;130;0;4;11;11;39.700000000000003;18.5;21.199999999999999;47.469999999999999;45;50;218;57;60;57;41;241;70;82;16;238;3143
6;142110;Olival;953;1042;920;1011;437;365;414;320;23;45;5.2629999999999999;12.329000000000001;18;318;398;4;9;19;36;94.200000000000003;45;49.200000000000003;46.130000000000003;129;94;482;122;126;132;93;498;160;159;16;238;3154
6;110506;São Domingos de Rana;27543;29959;26106;29100;14834;15298;12920;13481;1914;1817;12.903;11.877000000000001;45;4522;21834;373;392;1541;1425;2823.6999999999998;1352.5;1471.2;38.770000000000003;5224;3050;15747;2223;1299;4857;2970;17519;2543;2070;12;170;2361
6;110611;Carnide;10893;12423;10861;12211;5767;6030;5028;5467;739;563;12.814;9.3369999999999997;28;1214;9253;147;124;592;439;5736.1999999999998;2679.9000000000001;3056.3000000000002;40.18;1932;1387;6171;836;567;1842;1380;6978;1085;1138;12;171;2372
6;110620;Mártires;182;190;172;177;123;91;118;82;5;9;4.0650000000000004;9.8900000000000006;0;17;183;1;0;4;9;3738.4000000000001;1829;1909.4000000000001;45.039999999999999;22;15;124;15;6;14;15;110;16;35;12;171;2381
6;110629;Santa Engrácia;2376;2873;2305;2792;1257;1316;1098;1152;159;164;12.649000000000001;12.462;0;265;1985;22;29;137;135;9543.1000000000004;4319.6999999999998;5223.3000000000002;46;276;196;1347;283;274;288;204;1507;378;496;12;171;2390
6;110634;Santiago;261;358;242;340;135;148;117;135;18;13;13.333;8.7840000000000007;1;11;240;1;1;17;12;9542.3999999999996;4023.5999999999999;5518.8999999999996;51.439999999999998;15;22;153;39;32;21;20;173;57;87;12;171;2395
6;110708;Lousa;1511;1658;1459;1603;800;754;723;688;77;66;9.625;8.7530000000000001;41;401;969;8;10;69;56;191.69999999999999;91.400000000000006;100.3;44.399999999999999;211;168;840;150;142;197;155;910;169;227;12;172;2422
6;110709;Moscavide;6560;7706;6229;7516;3447;3575;3115;3213;332;362;9.6319999999999997;10.125999999999999;10;879;5439;36;57;296;305;12952;5955.8000000000002;6996.1999999999998;43.369999999999997;1089;470;3679;678;644;988;578;4072;972;1096;12;172;2423
6;110713;Santa Iria de Azóia;8836;9404;8396;9141;4676;4509;4143;3986;533;523;11.399000000000001;11.599;10;1672;6447;84;88;449;435;2412.6999999999998;1168.8;1243.9000000000001;41.210000000000001;1450;887;4979;1003;517;1365;933;5364;1049;693;12;172;2527
6;110904;Encarnação;2372;2426;2257;2364;1279;1031;1143;932;136;99;10.632999999999999;9.6020000000000003;136;723;1216;13;16;123;83;168.30000000000001;83.200000000000003;85.099999999999994;40.719999999999999;421;275;1280;216;180;395;227;1275;243;286;12;174;2446
6;110911;Milharado;3470;3553;3336;3500;1961;1720;1843;1577;118;143;6.0170000000000003;8.3140000000000001;123;770;2527;22;26;96;117;287.5;142;145.40000000000001;36.200000000000003;741;361;1967;253;148;748;362;1988;242;213;12;174;2453
6;111003;Carnaxide;12079;13832;11540;13447;6443;7175;5591;6433;852;742;13.224;10.340999999999999;26;1500;10498;232;211;620;531;3978.1999999999998;1854.5;2123.6999999999998;38.460000000000001;2363;1397;6768;1006;545;2323;1366;8119;1162;862;12;176;2469
6;111102;Algueirão-Mem Martins;31600;34650;29739;33295;17375;17923;14995;15359;2380;2564;13.698;14.305999999999999;66;6357;23931;476;494;1904;2070;4141.8000000000002;1975.5999999999999;2166.1999999999998;37.340000000000003;6259;3729;18174;2155;1283;6122;3823;20005;2487;2213;12;177;2478
6;111108;Rio de Mouro;22567;24744;21112;23770;12509;12884;10760;10996;1749;1888;13.981999999999999;14.654;38;4374;17344;315;413;1434;1475;2868.4000000000001;1368.2;1500.2;36.700000000000003;4524;2912;12879;1423;829;4463;2901;14325;1619;1436;12;177;2490
6;111113;Terrugem;2502;2611;2405;2529;1309;1137;1164;1034;145;103;11.077;9.0589999999999993;30;780;1388;20;20;125;83;195.90000000000001;95.900000000000006;100.09999999999999;42.119999999999997;402;255;1381;260;204;382;284;1404;287;254;12;177;2496
6;111407;São João dos Montes;2962;3056;2808;2998;1644;1460;1488;1297;156;163;9.4890000000000008;11.164;15;663;2107;27;25;129;138;333.69999999999999;164.30000000000001;169.5;39.07;534;280;1709;285;154;546;285;1740;274;211;12;180;2528
6;111503;Buraca;7599;8482;7283;8240;3707;3854;2891;3277;816;577;22.012;14.971;8;965;5195;173;165;643;412;9577.8999999999996;4526;5051.8999999999996;40.020000000000003;1286;1010;4200;713;390;1313;1001;4623;805;740;12;166;2325
6;150201;Alcochete;5902;6337;5609;6127;3221;3165;2778;2818;443;347;13.753;10.964;199;1056;4341;70;67;373;280;102.5;49.399999999999999;53.100000000000001;38.399999999999999;1143;672;3358;432;297;1134;594;3578;550;481;17;247;3255
6;150203;São Francisco;1057;1130;999;1107;570;532;513;490;57;42;10;7.8949999999999996;35;167;801;3;5;54;37;525.5;254;271.5;37.07;236;83;612;82;44;243;79;635;96;77;17;247;3257
6;150307;Pragal;3394;3762;3590;4013;1693;1795;1383;1554;310;241;18.311;13.426;6;401;2530;72;56;238;185;3151.3000000000002;1494.5999999999999;1656.7;41.700000000000003;499;466;1921;291;217;496;395;2156;378;337;17;248;3266
6;150401;Barreiro;3476;3973;3319;3902;1599;1640;1324;1415;275;225;17.198;13.720000000000001;8;424;2307;56;53;219;172;2009.3;937.60000000000002;1071.7;46.329999999999998;494;361;1830;416;375;419;338;2057;522;637;17;249;3270
6;150405;Verderena;4834;5451;4560;5227;2242;2292;1885;1926;357;366;15.923;15.968999999999999;6;643;3162;68;64;289;302;8289.3999999999996;3896.0999999999999;4393.3999999999996;46.299999999999997;581;496;2570;798;389;578;426;2934;874;639;17;249;3276
6;150705;Alto-Estanqueiro-Jardia;1379;1467;1342;1451;668;586;583;496;85;90;12.725;15.358000000000001;100;278;701;8;8;77;82;258.19999999999999;125.09999999999999;133.09999999999999;43.369999999999997;219;151;741;164;104;200;146;757;187;177;17;252;3289
6;150706;Pegões;1176;1199;1120;1173;624;494;556;451;68;43;10.897;8.7040000000000006;172;267;568;5;11;63;32;97.799999999999997;48.399999999999999;49.399999999999999;43.229999999999997;166;134;656;116;104;172;117;605;156;149;17;252;3293
6;150805;Poceirão;2311;2447;2243;2398;1205;991;1037;839;168;152;13.942;15.337999999999999;458;450;968;18;30;150;122;31.5;15.300000000000001;16.199999999999999;41.619999999999997;370;281;1244;256;160;391;259;1281;294;222;17;253;3299
6;151004;Seixal;1304;1472;1225;1412;719;714;643;634;76;80;10.57;11.204000000000001;5;157;1115;20;13;56;67;744.60000000000002;349.80000000000001;394.80000000000001;41.829999999999998;191;134;744;126;109;236;115;798;145;178;17;255;3317
6;21102;Relíquias;462;469;516;549;217;138;186;119;31;19;14.286;13.768000000000001;100;54;151;1;1;30;18;7.7999999999999998;3.8999999999999999;3.8999999999999999;50.560000000000002;40;41;245;70;66;41;34;217;94;83;3;49;439
6;21103;Sabóia;603;549;604;549;191;135;156;109;35;26;18.324999999999999;19.259;30;57;178;2;5;33;21;7.4000000000000004;3.8999999999999999;3.5;54.590000000000003;50;40;276;90;147;41;43;230;85;150;3;49;440
6;21112;Pereiras-Gare;143;128;140;126;46;35;38;26;8;9;17.390999999999998;25.713999999999999;8;19;37;1;2;7;7;4.2000000000000002;2.2000000000000002;2;51.280000000000001;18;8;69;14;34;16;7;54;20;31;3;49;438
6;21113;Bicos;287;262;276;253;144;89;127;56;17;33;11.806000000000001;37.079000000000001;46;61;76;0;1;17;32;10.4;5.5;5;47.460000000000001;31;28;154;37;37;23;26;130;43;40;3;49;431
6;150105;São Martinho;229;221;224;208;110;72;103;56;7;16;6.3639999999999999;22.222000000000001;48;40;71;1;1;6;15;5.0999999999999996;2.6000000000000001;2.5;51.369999999999997;22;15;115;35;42;23;14;100;48;36;17;246;3253
6;120103;Seda;176;176;168;167;67;48;58;47;9;1;13.433;2.0830000000000002;46;9;50;1;0;8;1;3.1000000000000001;1.6000000000000001;1.6000000000000001;56.32;14;8;78;34;42;13;9;73;35;46;14;192;2590
6;120307;Maranhão;30;33;25;31;20;15;19;10;1;5;5;33.332999999999998;12;10;7;0;0;1;5;0.90000000000000002;0.40000000000000002;0.5;35.240000000000002;4;4;19;3;;9;5;15;3;1;14;194;2600
6;120503;Santiago Maior;180;178;180;174;85;65;76;57;9;8;10.587999999999999;12.308;16;27;90;0;3;9;5;6.0999999999999996;3.1000000000000001;3;49.439999999999998;20;18;89;24;29;12;16;80;35;35;14;196;2607
6;120709;Terrugem;602;649;575;622;300;249;268;201;32;48;10.667;19.277000000000001;71;116;282;5;7;27;41;17.199999999999999;8.3000000000000007;8.9000000000000004;46.119999999999997;66;69;317;59;91;77;64;318;85;105;14;198;2623
6;120904;Gavião;770;839;743;818;342;307;288;246;54;61;15.789;19.870000000000001;19;93;422;5;15;49;46;27.5;13.199999999999999;14.4;48.380000000000003;108;86;390;71;115;83;61;400;99;196;14;200;2632
6;121004;São Salvador da Aramenha;704;722;649;679;312;259;282;236;30;23;9.6150000000000002;8.8800000000000008;42;85;391;8;8;22;15;28.100000000000001;13.9;14.199999999999999;48.240000000000002;89;55;360;91;109;71;61;355;105;130;14;201;2637
6;121202;Amieira do Tejo;113;128;107;124;31;27;23;23;8;4;25.806000000000001;14.815;5;4;37;2;3;6;1;2.3999999999999999;1.1000000000000001;1.3;57.619999999999997;12;9;39;18;35;10;8;39;28;43;14;203;2643
6;121204;Espírito Santo;880;981;847;945;402;345;360;314;42;31;10.448;8.9860000000000007;44;110;520;8;11;34;20;21.100000000000001;10;11.1;48.880000000000003;105;59;468;125;123;103;76;459;170;173;14;203;2645
6;121301;Galveias;510;551;508;540;234;191;196;152;38;39;16.239000000000001;20.419;75;54;219;2;10;36;29;13.300000000000001;6.4000000000000004;6.9000000000000004;51.07;56;55;250;55;94;52;47;221;80;151;14;204;2653
6;121407;São Julião;173;169;168;163;59;40;42;37;17;3;28.814;7.5;21;13;45;4;0;13;3;7.9000000000000004;4;3.8999999999999999;57.32;13;13;70;29;48;9;7;66;31;56;14;205;2665
6;121410;Urra;956;978;908;957;464;427;393;372;71;55;15.302;12.881;73;167;525;16;14;55;41;14.9;7.4000000000000004;7.5;47.359999999999999;105;85;525;104;137;113;80;487;134;164;14;205;2668
6;70202;Igrejinha;458;474;450;461;266;221;245;193;21;28;7.8949999999999996;12.67;53;119;266;4;2;17;26;11;5.4000000000000004;5.5999999999999996;40.909999999999997;77;41;266;34;40;76;40;250;42;66;8;107;1656
6;70303;Rio de Moinhos;1019;1037;972;999;510;399;437;323;73;76;14.314;19.047999999999998;91;274;395;12;17;61;59;38.899999999999999;19.300000000000001;19.600000000000001;46.68;113;107;562;98;139;113;110;496;136;182;8;108;1664
6;70406;Estremoz (Santo André);1066;1312;1008;1259;495;526;399;431;96;95;19.393999999999998;18.061;39;136;655;20;16;76;79;3936.6999999999998;1764.7;2172;47.109999999999999;151;107;549;114;145;133;124;605;194;256;8;109;1667
6;70514;São Sebastião da Giesteira;381;379;359;361;199;151;184;136;15;15;7.5380000000000003;9.9339999999999993;26;75;219;2;1;13;14;17.699999999999999;8.9000000000000004;8.8000000000000007;46.350000000000001;51;37;199;32;62;46;29;186;56;62;8;110;1692
6;70602;Lavre;360;380;343;365;177;148;171;140;6;8;3.3900000000000001;5.4050000000000002;64;71;176;2;1;4;7;6.5;3.2000000000000002;3.2999999999999998;51.850000000000001;31;31;185;47;66;25;30;181;54;90;8;111;1701
6;70903;Monte do Trigo;626;614;602;609;336;241;276;213;60;28;17.856999999999999;11.618;73;168;248;2;3;58;25;11.6;5.7999999999999998;5.7000000000000002;44.130000000000003;88;67;342;68;61;82;59;311;78;84;8;114;1716
6;71302;Viana do Alentejo;1299;1443;1226;1400;649;587;582;517;67;70;10.324;11.925000000000001;103;288;708;15;17;52;53;29;13.699999999999999;15.199999999999999;44.719999999999999;190;145;669;132;163;196;133;703;180;231;8;118;1733
6;71401;Bencatel;858;821;859;835;410;307;380;263;30;44;7.3170000000000002;14.332000000000001;52;284;307;0;10;30;34;46.399999999999999;23.699999999999999;22.699999999999999;44.520000000000003;115;84;481;94;84;97;73;441;107;103;8;119;1734
6;20206;São Barnabé;257;274;250;265;84;45;65;37;19;8;22.619;17.777999999999999;22;25;55;0;0;19;8;3.7999999999999998;1.8;1.8999999999999999;61.869999999999997;10;13;99;57;78;9;13;90;74;88;3;40;376
6;20503;Beringel;622;679;612;664;278;267;243;239;35;28;12.59;10.487;42;73;367;5;5;30;23;86.5;41.299999999999997;45.100000000000001;47.100000000000001;87;60;336;68;71;73;53;342;77;134;3;43;387
6;20505;Mombeja;195;191;194;187;94;71;85;62;9;9;9.5739999999999998;12.676;24;22;101;1;3;8;6;6.9000000000000004;3.5;3.3999999999999999;45.609999999999999;30;18;103;21;23;24;13;86;36;32;3;43;389
6;20506;Nossa Senhora das Neves;899;848;870;811;437;357;380;307;57;50;13.042999999999999;14.006;44;139;504;6;9;51;41;32.899999999999999;16.899999999999999;16;44.75;110;89;520;88;92;116;61;442;120;109;3;43;390
6;20511;Beja (Santa Maria da Feira);2195;2348;2124;2314;1005;960;892;827;113;133;11.244;13.853999999999999;75;212;1432;29;37;84;96;283.5;137;146.5;38.100000000000001;488;256;1192;147;112;434;252;1190;182;290;3;43;384
6;20604;Santa Bárbara de Padrões;469;474;443;466;229;124;211;99;18;25;7.8600000000000003;20.161000000000001;17;135;158;5;9;13;16;14.199999999999999;7.0999999999999996;7.2000000000000002;48.939999999999998;45;54;250;59;61;45;42;217;79;91;3;44;402
6;20903;Espírito Santo;169;166;181;173;57;37;53;33;4;4;7.0179999999999998;10.811;13;20;53;0;1;4;3;2.5;1.2;1.2;56.079999999999998;13;9;77;36;34;11;7;69;40;39;3;47;416
6;20905;Santana de Cambas;391;406;351;378;169;97;149;83;20;14;11.834;14.433;47;55;130;5;2;15;12;4.7999999999999998;2.3999999999999999;2.3999999999999999;51.780000000000001;45;30;184;65;67;36;35;154;67;114;3;47;418
6;21005;Santo Aleixo da Restauração;389;404;381;399;174;85;146;61;28;24;16.091999999999999;28.234999999999999;67;36;104;1;0;27;24;4.4000000000000004;2.2000000000000002;2.2999999999999998;47.859999999999999;53;38;204;58;36;51;27;169;67;90;3;48;428
6;21304;Serpa (Salvador);2117;2248;2018;2148;1060;982;951;841;109;141;10.282999999999999;14.358000000000001;251;218;1323;20;29;89;112;15.1;7.2999999999999998;7.7999999999999998;43.619999999999997;310;252;1150;197;208;284;245;1178;230;311;3;51;457
6;21402;Selmes;444;450;435;443;227;161;180;139;47;22;20.704999999999998;13.664999999999999;97;49;173;3;2;44;20;6.5;3.2000000000000002;3.2999999999999998;46.630000000000003;45;50;236;48;65;58;47;207;64;74;3;52;462
6;110308;Vila Nova de São Pedro;345;342;336;340;144;127;118;112;26;15;18.056000000000001;11.811;8;49;173;3;1;23;14;47.799999999999997;24;23.800000000000001;48.359999999999999;36;30;177;50;52;42;22;177;50;51;12;168;2345
6;140702;Chouto;288;289;275;281;150;84;141;74;9;10;6;11.904999999999999;94;51;70;0;0;9;10;2.7999999999999998;1.3999999999999999;1.3999999999999999;48.549999999999997;33;27;149;32;47;31;19;132;49;58;16;231;3104
6;140703;Pinheiro Grande;460;479;432;463;224;192;199;167;25;25;11.161;13.021000000000001;51;94;221;4;1;21;24;29.5;14.5;15.1;44.450000000000003;72;45;249;54;40;60;39;246;75;59;16;231;3106
6;140904;Fajarda;888;951;819;908;449;361;397;297;52;64;11.581;17.728999999999999;89;210;395;1;10;51;54;36.799999999999997;17.800000000000001;19.100000000000001;45.689999999999998;135;84;472;101;96;110;78;473;138;152;16;233;3117
6;140907;Biscainho;519;555;490;540;262;223;237;202;25;21;9.5419999999999998;9.4169999999999998;111;120;208;2;2;23;19;13.199999999999999;6.4000000000000004;6.7999999999999998;47.210000000000001;68;31;267;93;60;65;46;282;91;71;16;233;3112
6;141401;Alcobertas;974;949;940;918;535;366;491;327;44;39;8.2240000000000002;10.656000000000001;91;369;358;13;11;31;28;60;30.399999999999999;29.600000000000001;41.579999999999998;167;124;523;82;78;135;113;489;96;116;16;239;3159
6;141403;Arruda dos Pisões;186;219;180;212;91;86;77;67;14;19;15.385;22.093;6;46;92;2;5;12;14;40.700000000000003;18.699999999999999;22;43.810000000000002;30;12;111;19;14;31;22;105;32;29;16;239;3161
6;141407;Outeiro da Cortiçada;327;347;304;327;155;118;145;104;10;14;6.452;11.864000000000001;33;81;135;2;2;8;12;46.399999999999999;22.5;23.899999999999999;45.520000000000003;51;34;160;45;37;48;27;172;47;53;16;239;3168
6;141411;São Sebastião;244;279;232;268;117;106;105;97;12;9;10.256;8.4909999999999997;25;72;105;1;1;11;8;34;15.800000000000001;18.100000000000001;45.890000000000001;38;30;114;34;28;38;24;130;42;45;16;239;3172
6;141504;Salvaterra de Magos;2604;2922;2412;2731;1268;1225;1067;1045;201;180;15.852;14.693999999999999;140;486;1486;27;30;174;150;165.69999999999999;78.099999999999994;87.599999999999994;43.350000000000001;437;308;1367;284;208;393;257;1515;352;405;16;240;3178
6;141607;Amiais de Baixo;908;943;867;922;458;377;428;345;30;32;6.5499999999999998;8.4879999999999995;11;358;404;6;3;24;29;293.69999999999999;144.09999999999999;149.59999999999999;46.43;127;72;502;100;107;107;87;473;114;162;16;241;3185
6;141610;Azoia de Cima;239;257;228;258;120;95;103;88;17;7;14.167;7.3680000000000003;12;58;121;3;1;14;6;58.899999999999999;28.399999999999999;30.5;46.630000000000003;29;23;125;35;27;28;24;131;29;45;16;241;3188
6;141623;Tremês;931;1050;891;1024;447;395;389;357;58;38;12.975;9.6199999999999992;29;225;492;8;6;50;32;79.700000000000003;37.399999999999999;42.200000000000003;46.590000000000003;123;90;507;107;104;129;78;500;168;175;16;241;3202
6;80404;Altura;1076;1119;1253;1311;575;497;470;412;105;85;18.260999999999999;17.103000000000002;36;172;674;12;12;93;73;197.80000000000001;97;100.8;43;137;125;608;116;90;169;103;610;124;113;9;123;1762
6;80504;Faro (São Pedro);6990;7587;6782;7416;3734;3751;3204;3290;530;461;14.194000000000001;12.289999999999999;136;776;5582;106;107;424;354;1328.5999999999999;637.10000000000002;691.5;40.859999999999999;1186;673;4101;580;450;1080;690;4340;682;795;9;124;1768
6;80604;Porches;996;1015;1174;1137;492;444;393;345;99;99;20.122;22.297000000000001;19;131;588;9;12;90;87;128.59999999999999;63.700000000000003;64.900000000000006;43.200000000000003;132;115;565;113;71;131;115;568;97;104;9;125;1777
6;80702;Bensafrim;768;762;743;750;348;297;283;250;65;47;18.678000000000001;15.824999999999999;10;114;409;6;9;59;38;19.5;9.8000000000000007;9.6999999999999993;46.469999999999999;91;71;408;103;95;106;60;392;109;95;9;126;1779
6;80801;Almancil;5604;5532;6402;6113;3188;2651;2713;2201;475;450;14.9;16.975000000000001;135;1064;3715;75;91;400;359;176.69999999999999;88.900000000000006;87.799999999999997;40.07;843;682;3252;508;319;833;639;3151;480;429;9;127;1784
6;80805;Quarteira;10523;11275;11087;11733;5968;5757;4997;4681;971;1076;16.27;18.690000000000001;279;1417;7982;135;136;836;940;571.29999999999995;275.80000000000001;295.5;39.259999999999998;1759;1235;6130;865;534;1666;1286;6679;895;749;9;127;1791
6;80901;Alferce;231;210;226;208;83;61;68;42;15;19;18.071999999999999;31.148;31;14;65;1;5;14;14;4.5999999999999996;2.3999999999999999;2.2000000000000002;53.520000000000003;15;23;108;40;45;16;14;96;36;48;9;128;1795
6;81002;Moncarapacho;4762;4873;4571;4740;2254;1898;1858;1565;396;333;17.56876663708962;17.544783983140146;417;652;2354;52;59;344;274;127.53143613500993;63.031105228325615;64.500330906684312;44.917337830825119;686;459;2591;585;441;622;417;2581;623;630;9;129;1798
6;81003;Olhão;7098;7816;6902;7610;3599;3481;2924;2866;675;615;18.754999999999999;17.667000000000002;288;1020;4482;109;100;566;515;1217.8;579.60000000000002;638.20000000000005;41.189999999999998;1201;754;3964;654;525;1161;781;4214;790;870;9;129;1799
6;81004;Pechão;1773;1828;1698;1762;944;903;803;775;141;128;14.936;14.175000000000001;132;231;1215;16;19;125;109;182;89.599999999999994;92.400000000000006;39.329999999999998;282;185;1019;188;99;287;174;1081;151;135;9;129;1800
6;81005;Quelfes;8541;8705;8360;8684;4486;4153;3672;3505;814;648;18.145;15.603;266;1282;5629;125;112;689;536;611.60000000000002;302.89999999999998;308.69999999999999;37.670000000000002;1692;1002;4800;633;414;1571;946;4904;660;624;9;129;1801
6;81505;Vila do Bispo;455;463;469;473;241;200;219;185;22;15;9.1289999999999996;7.5;28;22;354;3;2;19;13;15.699999999999999;7.7999999999999998;7.9000000000000004;45.219999999999999;55;34;275;47;44;46;48;246;52;71;9;133;1818
6;81602;Vila Real de Santo António;5687;6259;5463;6056;2893;2768;2329;2274;564;494;19.495000000000001;17.847000000000001;68;682;3853;65;61;499;433;1086.9000000000001;517.39999999999998;569.5;40.909999999999997;1007;626;3134;541;379;983;646;3307;636;687;9;134;1821
6;100202;Alvaiázere;780;913;708;873;353;309;329;274;24;35;6.7990000000000004;11.327;6;162;435;5;4;19;31;53.399999999999999;24.600000000000001;28.800000000000001;47.719999999999999;101;83;391;97;108;105;85;403;131;189;11;150;2177
6;100204;Maçãs de Dona Maria;859;976;828;938;362;263;321;228;41;35;11.326000000000001;13.308;28;202;319;8;7;33;28;74.799999999999997;35;39.799999999999997;50.259999999999998;94;84;437;114;130;89;97;417;151;222;11;150;2179
6;100804;Figueiró dos Vinhos;1615;1813;1528;1757;732;693;653;584;79;109;10.792;15.728999999999999;40;263;934;17;23;62;86;81.900000000000006;38.600000000000001;43.299999999999997;47.619999999999997;215;153;850;215;182;175;171;912;246;309;11;156;2222
6;180316;Parada de Ester;327;327;305;309;105;62;100;56;5;6;4.7620000000000005;9.6769999999999996;27;36;93;2;0;3;6;22.800000000000001;11.4;11.4;50.399999999999999;32;29;151;58;57;38;29;142;62;56;20;285;3930
6;180603;Chãs de Tavares;493;547;472;531;223;177;198;140;25;37;11.211;20.904;18;128;192;6;7;19;30;46.399999999999999;22;24.399999999999999;47.25;57;62;242;60;72;59;51;258;82;97;20;288;3980
6;181112;Trancozelos;121;148;120;144;57;42;51;36;6;6;10.526;14.286;15;36;36;2;1;4;5;52.5;23.600000000000001;28.899999999999999;46.539999999999999;13;10;67;19;12;21;15;72;22;18;20;293;4058
6;181606;Figueiredo de Alva;395;421;347;397;177;126;148;90;29;36;16.384;28.571000000000002;22;55;161;6;1;23;35;55.600000000000001;26.899999999999999;28.699999999999999;45.270000000000003;53;52;201;49;40;45;47;214;51;64;20;298;4112
6;181607;Manhouce;279;368;256;357;143;116;143;108;0;8;0;6.8970000000000002;106;85;60;0;4;0;4;16;6.9000000000000004;9.0999999999999996;50.32;37;24;158;27;33;23;34;175;57;79;20;298;4113
6;181609;Pinho;362;415;353;400;160;132;146;108;14;24;8.75;18.181999999999999;42;81;131;1;2;13;22;57;26.5;30.399999999999999;46.93;44;35;190;46;47;52;47;199;58;59;20;298;4115
6;181704;Ferreira de Aves;1166;1298;1075;1241;520;352;466;284;54;68;10.385;19.318000000000001;65;274;411;12;18;42;50;37.299999999999997;17.600000000000001;19.600000000000001;48.25;134;115;606;158;153;119;134;614;179;252;20;299;4129
6;182106;Dardavaz;374;408;342;387;189;142;172;123;17;19;8.9949999999999992;13.380000000000001;42;108;145;3;3;14;16;57.100000000000001;27.300000000000001;29.800000000000001;46.159999999999997;61;43;181;47;42;37;44;201;63;63;20;303;4187
6;182304;Bodiosa;1474;1573;1399;1514;721;567;630;477;91;90;12.621;15.872999999999999;20;374;713;8;23;83;67;120;58;61.899999999999999;43.659999999999997;226;164;784;182;118;188;177;819;212;177;20;305;4218
6;182330;São Salvador;1789;2018;1727;1979;919;929;823;830;96;99;10.446;10.657;12;275;1366;21;23;75;76;589.20000000000005;276.89999999999998;312.30000000000001;38.310000000000002;332;202;1034;144;77;357;210;1138;171;142;20;305;4241
6;182405;Fataunços;354;397;320;380;176;161;163;141;13;20;7.3860000000000001;12.422000000000001;4;120;180;5;4;8;16;89.900000000000006;42.399999999999999;47.5;43.939999999999998;38;49;193;35;39;55;36;211;51;44;20;306;4253
6;50603;Cambas;143;166;132;160;44;27;43;26;1;1;2.2730000000000001;3.7039999999999997;5;25;39;0;0;1;1;6.4000000000000004;3;3.3999999999999999;59.960000000000001;5;7;61;31;39;10;6;62;35;53;6;83;1390
6;50901;Cabeçudo;452;505;432;478;228;165;193;148;35;17;15.350999999999999;10.303000000000001;6;129;206;6;3;29;14;92.099999999999994;43.5;48.600000000000001;44.630000000000003;56;48;258;48;42;65;69;238;52;81;6;86;1418
6;50907;Figueiredo;90;115;92;113;33;18;33;16;0;2;0;11.111000000000001;10;18;21;0;0;0;2;12.699999999999999;5.5999999999999996;7.0999999999999996;57.079999999999998;3;7;38;19;23;10;6;45;26;28;6;86;1424
6;90513;Sobral Pichorro;109;99;99;92;40;22;38;16;2;6;5;27.273;6;18;30;0;1;2;5;23.100000000000001;12.1;11;53.299999999999997;7;9;53;20;20;8;8;38;21;24;10;139;1915
6;90514;Vila Chã;38;44;37;42;11;10;9;8;2;2;18.181999999999999;20;3;6;8;1;0;1;2;27.100000000000001;12.6;14.6;45.350000000000001;4;8;16;8;2;5;6;19;7;7;10;139;1916
6;70505;Évora (Santo Antão);585;738;694;864;271;303;232;265;39;38;14.391;12.541;17;70;410;4;3;35;35;4887.3999999999996;2161.0999999999999;2726.3000000000002;48.280000000000001;67;49;317;72;80;57;58;356;111;156;8;110;1680
6;70511;São Vicente do Pigeiro;181;183;175;176;84;61;74;49;10;12;11.904999999999999;19.672000000000001;35;23;65;0;0;10;12;4.2999999999999998;2.1000000000000001;2.2000000000000002;48.240000000000002;17;15;97;23;29;20;21;88;24;30;8;110;1693
6;70601;Cabrela;316;333;313;352;141;112;134;103;7;9;4.9649999999999999;8.0359999999999996;69;43;125;0;2;7;7;3.3999999999999999;1.6000000000000001;1.7;55.020000000000003;22;21;156;41;76;20;21;140;74;78;8;111;1697
6;70803;Mourão;858;910;832;889;381;354;306;255;75;99;19.684999999999999;27.966000000000001;52;81;428;16;23;59;76;13.1;6.4000000000000004;6.7000000000000002;41.829999999999998;165;116;413;91;73;151;107;414;103;135;8;113;1713
6;71404;Pardais;281;265;276;263;133;98;125;86;8;12;6.0149999999999997;12.244999999999999;12;85;114;0;0;8;12;30.399999999999999;15.699999999999999;14.800000000000001;43.560000000000002;41;24;152;25;39;34;24;142;36;29;8;119;1736
6;80101;Albufeira;11113;11668;14060;14546;6509;6424;5390;5139;1119;1285;17.192;20.003;89;1386;9054;118;136;1001;1149;849.29999999999995;414.30000000000001;435;37.890000000000001;1947;1368;6668;712;418;1764;1347;7094;756;707;9;120;1739
6;80402;Castro Marim;1629;1638;1603;1633;800;689;650;580;150;109;18.75;15.82;33;215;982;11;12;139;97;41.200000000000003;20.5;20.600000000000001;44.009999999999998;237;182;871;193;146;211;164;871;192;200;9;123;1764
6;80704;Odiáxere;1462;1522;1428;1480;724;636;603;540;121;96;16.713000000000001;15.093999999999999;31;253;859;11;14;110;82;93.700000000000003;45.899999999999999;47.799999999999997;43.159999999999997;233;128;792;156;153;249;145;774;161;193;9;126;1783
6;80807;Salir;1381;1394;1324;1347;622;476;537;439;85;37;13.666;7.7729999999999997;44;218;714;8;2;77;35;14.800000000000001;7.4000000000000004;7.4000000000000004;51.130000000000003;139;84;719;209;230;144;64;669;227;290;9;127;1793
6;80811;Tôr;453;432;446;429;200;144;168;123;32;21;16;14.583;8;66;217;5;1;27;20;55.899999999999999;28.600000000000001;27.300000000000001;47.920000000000002;55;41;217;65;75;62;29;193;60;88;9;127;1794
6;81301;Alcantarilha;1247;1293;1315;1359;624;563;529;479;95;84;15.224;14.92;34;154;820;9;10;86;74;103.2;50.700000000000003;52.600000000000001;43.689999999999998;180;125;703;126;113;187;117;664;173;152;9;132;1806
6;81305;São Bartolomeu de Messines;4212;4218;4156;4119;2046;1667;1797;1423;249;244;12.17;14.637;256;589;2375;35;28;214;216;35.100000000000001;17.600000000000001;17.600000000000001;47.07;541;373;2231;501;566;446;360;2120;599;693;9;132;1810
6;90202;Aldeia Nova;14;19;15;19;2;0;2;0;0;0;0;0;1;1;0;0;0;0;0;3.2999999999999998;1.3999999999999999;1.8999999999999999;65.480000000000004;1;1;4;5;3;1;;3;6;9;10;136;1836
6;90208;Castelo Mendo;36;51;34;51;12;12;12;8;0;4;0;33.332999999999998;4;3;13;0;1;0;3;4;1.7;2.3999999999999999;58.82;1;5;15;4;11;4;1;13;12;21;10;136;1842
6;90218;Monte Perobolço;27;34;27;32;11;11;9;11;2;0;18.181999999999999;0;0;4;16;0;0;2;0;7.7000000000000002;3.3999999999999999;4.2999999999999998;60.479999999999997;;3;14;3;7;;2;14;7;11;10;136;1852
6;90403;Castelo Rodrigo;253;264;253;262;109;80;101;71;8;9;7.3390000000000004;11.25;18;28;126;3;5;5;4;15.699999999999999;7.7000000000000002;8;51.969999999999999;30;34;116;32;41;21;20;106;30;87;10;138;1888
6;90503;Cortiçô;72;72;72;74;33;21;24;18;9;3;27.273;14.286;3;18;21;1;0;8;3;28.699999999999999;14.300000000000001;14.300000000000001;49.490000000000002;7;6;36;12;11;10;6;31;9;16;10;139;1905
6;90510;Matança;109;134;98;127;44;38;37;35;7;3;15.909000000000001;7.8949999999999996;12;20;40;2;0;5;3;17.600000000000001;7.9000000000000004;9.6999999999999993;55.380000000000003;7;12;41;24;25;9;9;53;26;37;10;139;1912
6;90512;Queiriz;118;142;112;138;40;33;36;30;4;3;10;9.0909999999999993;6;21;39;1;2;3;1;26.699999999999999;12.1;14.6;51.350000000000001;13;11;47;27;20;15;15;61;22;29;10;139;1914
6;90609;Melo;242;256;229;243;99;75;85;59;14;16;14.141;21.332999999999998;14;34;96;5;1;9;15;68.599999999999994;33.299999999999997;35.299999999999997;52.43;25;18;116;37;46;17;20;112;47;60;10;140;1929
6;90620;Vila Franca da Serra;119;143;114;140;52;42;47;37;5;5;9.6150000000000002;11.904999999999999;7;23;54;0;2;5;3;23.800000000000001;10.800000000000001;13;49.32;13;10;60;22;14;15;12;68;18;30;10;140;1938
6;90915;Ranhados;131;121;130;120;54;24;52;22;2;2;3.7039999999999997;8.3330000000000002;31;21;22;0;0;2;2;10;5.2000000000000002;4.7999999999999998;52.979999999999997;12;11;62;23;23;5;8;58;28;22;10;143;2014
6;91007;Cidadelhe;20;20;20;19;7;0;7;0;0;0;0;0;7;0;0;0;0;0;0;1.7;0.80000000000000004;0.80000000000000004;68.230000000000004;1;;7;7;5;;;8;3;9;10;144;2022
6;91023;Sorval;36;44;35;44;12;12;8;9;4;3;33.332999999999998;25;6;2;9;1;1;3;2;13.800000000000001;6.2000000000000002;7.5999999999999996;53.299999999999997;3;4;17;4;8;3;4;13;12;12;10;144;2038
6;91124;Quinta de São Bartolomeu;89;91;86;80;47;26;40;21;7;5;14.894;19.231000000000002;8;22;31;2;1;5;4;16.899999999999999;8.4000000000000004;8.5999999999999996;45.140000000000001;10;9;53;8;9;14;9;44;10;14;10;145;2066
6;91138;Vila Boa;120;123;118;115;58;49;53;45;5;4;8.6210000000000004;8.1630000000000003;4;52;42;2;1;3;3;28.199999999999999;13.9;14.300000000000001;48.600000000000001;11;16;61;14;18;9;18;50;16;30;10;145;2080
6;91140;Vilar Maior;54;66;53;64;18;11;13;8;5;3;27.777999999999999;27.273;6;7;8;0;0;5;3;5;2.2999999999999998;2.7999999999999998;61.520000000000003;4;2;23;5;20;4;2;17;14;29;10;145;2082
6;91206;Lajes;124;149;116;145;48;38;43;28;5;10;10.417;26.315999999999999;4;19;48;0;2;5;8;57.600000000000001;26.199999999999999;31.399999999999999;48.259999999999998;24;11;51;21;17;13;14;71;20;31;10;146;2088
6;91302;Carnicães;64;89;63;86;18;19;14;13;4;6;22.222000000000001;31.579000000000001;5;6;16;0;2;4;4;18.100000000000001;7.5999999999999996;10.5;51.549999999999997;6;6;30;11;11;8;8;38;17;18;10;147;2113
6;91326;Vale do Seixo;56;71;56;71;38;35;35;35;3;0;7.8949999999999996;0;41;16;13;3;0;0;0;18.699999999999999;8.3000000000000007;10.5;55.229999999999997;4;6;28;9;9;5;2;30;13;21;10;147;2137
6;91329;Vilares;87;109;85;108;37;26;35;21;2;5;5.4050000000000002;19.231000000000002;9;16;31;1;1;1;4;16.800000000000001;7.5;9.3000000000000007;55.030000000000001;3;6;42;14;22;7;8;45;26;23;10;147;2140
6;91416;Touça;113;122;71;108;51;29;51;26;0;3;0;10.345000000000001;24;21;32;0;1;0;2;25;12;13;51.719999999999999;9;9;63;10;22;9;5;55;22;31;10;148;2156
6;100104;Bárrio;762;761;733;733;338;334;304;296;34;38;10.058999999999999;11.377000000000001;44;204;352;6;5;28;33;101.5;50.799999999999997;50.700000000000003;45.299999999999997;113;79;392;93;85;88;76;417;94;86;11;149;2163
6;100112;São Martinho do Porto;1351;1517;1303;1488;623;607;540;490;83;117;13.323;19.274999999999999;45;232;753;10;16;73;101;195.90000000000001;92.299999999999997;103.59999999999999;44.460000000000001;203;150;716;165;117;192;145;800;190;190;11;149;2172
6;100604;Carvalhal Benfeito;623;656;606;633;327;250;297;235;30;15;9.1739999999999995;6;93;179;260;3;5;27;10;91.700000000000003;44.700000000000003;47;44.420000000000002;87;70;335;59;72;82;76;338;83;77;11;154;2204
6;100607;Landal;506;545;487;525;271;217;255;184;16;33;5.9039999999999999;15.207000000000001;53;127;259;3;3;13;30;103;49.600000000000001;53.399999999999999;44.880000000000003;64;66;269;66;41;73;51;270;61;90;11;154;2207
6;100609;Salir de Matos;1259;1324;1204;1284;636;549;552;491;84;58;13.208;10.565;67;269;707;19;6;65;52;105;51.200000000000003;53.799999999999997;43.969999999999999;197;131;674;130;127;185;102;705;166;166;11;154;2209
6;101101;Famalicão;837;903;795;876;391;359;360;319;31;40;7.9279999999999999;11.141999999999999;32;234;413;10;6;21;34;80.099999999999994;38.5;41.600000000000001;44.130000000000003;123;88;452;93;81;131;76;468;96;132;11;159;2255
6;101204;Óbidos (Santa Maria);977;1055;930;1039;486;414;442;355;44;59;9.0530000000000008;14.250999999999999;31;178;588;6;8;38;51;93.900000000000006;45.100000000000001;48.700000000000003;43.829999999999998;171;93;539;87;87;145;88;530;122;170;11;160;2261
6;101508;Pelariga;1047;1129;989;1100;477;407;433;365;44;42;9.2240000000000002;10.319000000000001;16;296;486;11;6;33;36;83;39.899999999999999;43.100000000000001;45.25;165;122;529;134;97;145;85;573;174;152;11;163;2286
6;101510;Redinha;1002;1115;962;1090;477;361;435;325;42;36;8.8049999999999997;9.9719999999999995;16;295;449;11;5;31;31;50.700000000000003;24;26.699999999999999;46.719999999999999;123;99;544;123;113;131;86;553;177;168;11;163;2288
6;101603;Alvados;235;262;227;264;105;106;96;93;9;13;8.5709999999999997;12.263999999999999;1;76;112;0;0;9;13;24.600000000000001;11.6;13;46.490000000000002;36;24;119;30;26;26;23;134;38;41;11;164;2295
6;110104;Cabanas de Torres;480;509;458;493;238;181;198;167;40;14;16.806999999999999;7.7350000000000003;21;123;221;8;4;32;10;144.69999999999999;70.200000000000003;74.5;44.850000000000001;61;71;235;57;56;65;54;253;75;62;12;165;2311
6;110619;Madalena;187;206;234;223;111;107;93;95;18;12;16.216000000000001;11.215;1;18;169;1;2;17;10;3400.5;1618;1782.4000000000001;40.850000000000001;27;17;118;14;11;24;21;120;16;25;12;171;2380
6;110645;São José;1295;1451;1581;1578;737;711;636;616;101;95;13.704000000000001;13.361000000000001;0;112;1140;14;23;87;72;8310.8999999999996;3919.4000000000001;4391.5;45.460000000000001;127;115;808;123;122;128;104;805;151;263;12;171;2406
6;110803;Moita dos Ferreiros;845;889;801;875;409;303;364;263;45;40;11.002000000000001;13.201000000000001;102;148;377;6;9;39;31;69.900000000000006;34;35.799999999999997;45.439999999999998;118;86;432;110;99;103;80;449;116;141;12;173;2436
6;110907;Gradil;571;655;560;641;288;262;269;240;19;22;6.5969999999999995;8.3970000000000002;11;108;390;2;4;17;18;166.09999999999999;77.400000000000006;88.799999999999997;40.549999999999997;106;49;307;64;45;131;70;319;57;78;12;174;2449
6;110915;Vila Franca do Rosário;418;453;401;436;223;209;196;190;27;19;12.108000000000001;9.0909999999999993;5;161;220;2;4;25;15;140.30000000000001;67.299999999999997;73;39.880000000000003;77;45;230;38;28;69;54;244;48;38;12;174;2459
6;41019;Vilas Boas;265;285;259;276;96;61;95;53;1;8;1.042;13.115;32;47;69;0;0;1;8;19.100000000000001;9.1999999999999993;9.9000000000000004;48.369999999999997;26;21;138;50;30;22;32;136;53;42;5;75;1229
6;41103;Argozelo;351;350;341;339;152;105;138;82;14;23;9.2110000000000003;21.905000000000001;6;90;124;3;3;11;20;23.699999999999999;11.9;11.9;46.439999999999998;45;39;192;32;43;34;32;178;54;52;5;76;1232
6;41111;Uva;62;69;63;65;19;9;16;7;3;2;15.789;22.222000000000001;5;4;14;1;1;2;1;3.7999999999999998;1.8;2;62.770000000000003;2;2;22;17;19;3;2;19;24;21;5;76;1240
6;50209;Freixial do Campo;226;242;213;228;99;79;89;68;10;11;10.101000000000001;13.923999999999999;1;67;89;1;2;9;9;25.300000000000001;12.199999999999999;13.1;52.799999999999997;26;12;115;35;38;8;22;117;30;65;6;79;1292
6;50215;Mata;226;244;215;236;81;60;64;49;17;11;20.988;18.332999999999998;11;35;67;0;1;17;10;19.600000000000001;9.4000000000000004;10.199999999999999;54.850000000000001;14;10;112;46;44;23;9;104;49;59;6;79;1298
6;50315;Peraboa;440;513;433;519;217;183;167;144;50;39;23.041;21.311;21;136;154;11;13;39;26;35;16.199999999999999;18.899999999999999;47.810000000000002;52;47;235;43;63;57;53;233;65;105;6;80;1328
6;50319;Covilhã (São Martinho);1960;2205;2715;2875;963;919;816;782;147;137;15.265000000000001;14.907999999999999;11;348;1239;35;35;112;102;435.19999999999999;204.80000000000001;230.40000000000001;46.670000000000002;208;201;1117;248;186;241;201;1135;316;312;6;80;1320
6;50323;Teixoso;2108;2252;2023;2194;1022;1006;886;820;136;186;13.307;18.489000000000001;54;617;1035;27;28;109;158;122.40000000000001;59.200000000000003;63.200000000000003;44.140000000000001;268;258;1194;224;164;279;192;1265;243;273;6;80;1333
6;50330;Cantar-Galo;1095;1138;1039;1110;510;482;436;380;74;102;14.51;21.161999999999999;8;298;510;4;10;70;92;380.30000000000001;186.5;193.80000000000001;46.159999999999997;133;117;647;110;88;110;89;661;143;135;6;80;1314
6;50410;Bogas de Cima;162;185;163;175;88;74;83;68;5;6;5.6820000000000004;8.1080000000000005;64;35;52;2;1;3;5;11.1;5.2000000000000002;5.9000000000000004;52.759999999999998;17;13;77;31;24;10;13;75;44;43;6;81;1349
6;171302;Alfarela de Jales;204;197;209;199;76;40;72;36;4;4;5.2629999999999999;10;15;29;64;0;3;4;1;29.199999999999999;14.800000000000001;14.300000000000001;48.939999999999998;17;20;108;26;33;26;12;98;33;28;19;281;3842
6;171409;Folhadela;1037;1224;998;1186;524;466;462;411;62;55;11.832000000000001;11.803000000000001;58;121;694;16;12;46;43;140.80000000000001;64.599999999999994;76.200000000000003;42.049999999999997;154;131;590;99;63;168;153;634;121;148;19;282;3867
6;171427;Vale de Nogueiras;395;441;385;434;166;124;155;107;11;17;6.6269999999999998;13.710000000000001;19;54;189;1;7;10;10;42.799999999999997;20.199999999999999;22.600000000000001;44.090000000000003;65;54;198;44;34;50;57;212;56;66;19;282;3882
6;180108;Goujoim;29;29;29;29;10;5;8;2;2;3;20;60;4;1;5;1;2;1;1;8.8000000000000007;4.4000000000000004;4.4000000000000004;51.829999999999998;;5;16;2;6;2;3;13;4;7;20;283;3896
6;180207;Sobral de Papízios;128;145;125;139;56;28;50;25;6;3;10.714;10.714;9;39;27;0;1;6;2;45;21.100000000000001;23.899999999999999;49.530000000000001;14;12;63;25;14;20;10;62;23;30;20;284;3914
6;180310;Mamouros;327;352;334;395;158;114;145;89;13;25;8.2279999999999998;21.93;7;63;164;1;2;12;23;67.900000000000006;32.700000000000003;35.200000000000003;42.119999999999997;52;36;178;33;28;47;42;179;49;35;20;285;3924
6;180406;Fornelos;328;375;300;362;156;104;129;80;27;24;17.308;23.077000000000002;33;90;86;6;12;21;12;69.700000000000003;32.5;37.200000000000003;46.340000000000003;38;29;187;31;43;47;44;171;47;66;20;286;3942
6;180503;Bigorne;27;19;24;20;10;7;8;7;2;0;20;0;4;3;8;1;0;1;0;9.1999999999999993;5.4000000000000004;3.7999999999999998;43.759999999999998;8;;12;1;6;3;;9;2;5;20;287;3955
6;180519;Samodães;105;98;108;99;56;29;47;17;9;12;16.071000000000002;41.378999999999998;17;20;27;2;4;7;8;65.799999999999997;34;31.800000000000001;44.090000000000003;13;9;64;10;9;17;6;51;20;4;20;287;3973
6;180520;Sande;431;485;395;459;212;158;168;114;44;44;20.754999999999999;27.847999999999999;29;74;179;6;19;38;25;292.80000000000001;137.80000000000001;155;40.93;69;55;257;31;19;61;68;276;40;40;20;287;3974
6;180612;Moimenta de Maceira Dão;255;259;252;255;123;70;116;61;7;9;5.6909999999999998;12.856999999999999;4;82;91;0;1;7;8;89.599999999999994;44.399999999999999;45.100000000000001;42.619999999999997;30;33;145;27;20;31;39;136;32;21;20;288;3989
6;180901;Canas de Senhorim;1681;1828;1555;1746;825;727;733;617;92;110;11.151999999999999;15.131;24;524;802;23;17;69;93;137.90000000000001;66;71.799999999999997;44.590000000000003;247;187;898;194;155;221;171;964;221;251;20;291;4027
6;180904;Santar;496;546;486;542;216;133;199;117;17;16;7.8700000000000001;12.029999999999999;25;113;178;3;9;14;7;83.900000000000006;39.899999999999999;44;46.859999999999999;65;46;271;57;57;55;58;275;65;93;20;291;4032
6;181103;Esmolfe;200;217;194;213;94;72;88;65;6;7;6.383;9.7219999999999995;6;45;102;0;2;6;5;38.399999999999999;18.399999999999999;20;47.100000000000001;29;13;107;24;27;28;16;108;26;39;20;293;4049
6;181303;Cárquere;418;436;394;425;181;76;172;61;9;15;4.9719999999999995;19.736999999999998;25;82;126;5;9;4;6;113.8;55.700000000000003;58.100000000000001;39.009999999999998;83;58;217;37;23;74;63;215;44;40;20;295;4071
6;181310;Paus;257;271;244;255;98;46;88;33;10;13;10.204000000000001;28.260999999999999;28;44;49;1;4;9;9;39.399999999999999;19.199999999999999;20.199999999999999;48.409999999999997;30;40;117;30;40;26;25;128;41;51;20;295;4078
6;181314;São Martinho de Mouros;725;770;715;762;343;188;314;151;29;37;8.4550000000000001;19.681000000000001;208;68;189;10;23;19;14;103.8;50.299999999999997;53.399999999999999;44.630000000000003;104;84;390;79;68;98;82;388;103;99;20;295;4082
6;181601;Baiões;145;141;136;130;69;63;63;49;6;14;8.6959999999999997;22.222000000000001;8;41;63;1;4;5;10;78.299999999999997;39.700000000000003;38.600000000000001;40.920000000000002;26;21;72;17;9;19;16;73;19;14;20;298;4107
6;181703;Decermilo;91;114;86;110;31;21;26;20;5;1;16.129000000000001;4.7620000000000005;1;25;20;2;0;3;1;51.100000000000001;22.699999999999999;28.399999999999999;52.390000000000001;13;3;43;12;20;13;8;46;13;34;20;299;4128
6;181812;Macieira;64;60;60;57;35;12;35;10;0;2;0;16.667000000000002;10;19;16;0;1;0;1;10;5.0999999999999996;4.7999999999999998;49.25;4;8;35;8;9;5;6;28;10;11;20;300;4149
6;181906;Granja do Tedo;111;103;93;89;54;34;44;28;10;6;18.518999999999998;17.646999999999998;6;30;36;1;2;9;4;56.700000000000003;29.399999999999999;27.300000000000001;43.909999999999997;14;13;56;15;13;10;8;61;13;11;20;301;4160
6;182103;Canas de Santa Maria;857;949;821;924;405;350;354;314;51;36;12.593;10.286;41;195;432;8;6;43;30;130.40000000000001;61.899999999999999;68.5;47.619999999999997;111;102;433;111;100;81;106;464;120;178;20;303;4184
6;182104;Caparrosa;381;424;355;410;183;138;161;126;22;12;12.022;8.6959999999999997;19;102;166;4;1;18;11;48.700000000000003;23.100000000000001;25.699999999999999;46.409999999999997;55;40;199;41;46;54;37;208;60;65;20;303;4185
6;182125;Vilar de Besteiros;421;472;402;466;213;162;194;147;19;15;8.9199999999999999;9.2590000000000003;39;125;177;2;3;17;12;76.400000000000006;36;40.399999999999999;45.340000000000003;63;39;220;62;37;71;33;227;74;67;20;303;4207
6;182313;Fail;340;324;322;312;155;106;132;89;23;17;14.839;16.038;6;73;142;2;5;21;12;98.299999999999997;50.299999999999997;48;43.130000000000003;50;47;178;42;23;45;29;176;42;32;20;305;4226
6;182332;Vil de Souto;308;359;298;348;148;136;133;126;15;10;10.135;7.3529999999999998;4;77;178;3;4;12;6;82.299999999999997;38;44.299999999999997;42.890000000000001;37;33;181;38;19;55;35;193;44;32;20;305;4244
6;182409;Queirã;680;752;623;727;310;234;276;212;34;22;10.968;9.4019999999999992;51;136;301;6;4;28;18;60.100000000000001;28.5;31.600000000000001;45.82;90;73;353;109;55;92;66;386;102;106;20;306;4257
6;171306;Gouvães da Serra;61;72;57;64;26;9;25;7;1;2;3.8460000000000001;22.222000000000001;13;5;14;0;1;1;1;8.6999999999999993;4;4.7000000000000002;49.619999999999997;6;5;32;12;6;5;12;35;10;10;19;281;3846
6;171308;Pensalvos;127;151;128;148;45;19;41;15;4;4;8.8889999999999993;21.053000000000001;24;12;20;1;3;3;1;11.699999999999999;5.4000000000000004;6.4000000000000004;54.899999999999999;8;5;63;29;22;12;7;63;43;26;19;281;3849
6;171312;Tresminas;196;219;194;215;97;59;90;54;7;5;7.2160000000000002;8.4749999999999996;94;21;29;3;0;4;5;7.4000000000000004;3.5;3.8999999999999999;53.149999999999999;22;14;91;43;26;15;16;104;41;43;19;281;3854
6;171314;Vila Pouca de Aguiar;1577;1726;1505;1678;796;724;707;642;89;82;11.180999999999999;11.326000000000001;34;215;1100;20;28;69;54;144.19999999999999;68.900000000000006;75.400000000000006;43.399999999999999;217;179;903;147;131;213;199;942;178;194;19;281;3856
6;10203;Angeja;1003;1070;966;1045;505;427;450;383;55;44;10.891;10.304;35;405;393;11;11;44;33;97.599999999999994;47.200000000000003;50.399999999999999;44.509999999999998;119;117;559;105;103;135;122;544;135;134;1;2;23
6;10302;Ancas;296;328;285;321;145;119;135;103;10;16;6.8970000000000002;13.445;12;108;118;4;4;6;12;96.700000000000003;45.899999999999999;50.899999999999999;46.789999999999999;34;33;153;46;30;35;39;163;47;44;1;3;31
6;10310;São Lourenço do Bairro;1155;1259;1083;1209;585;491;540;445;45;46;7.6920000000000002;9.3689999999999998;38;391;556;8;5;37;41;156.90000000000001;75.099999999999994;81.799999999999997;44.719999999999999;158;127;617;149;104;152;132;654;174;147;1;3;40
6;10506;Glória;4212;4887;5925;6636;2245;2308;1942;2031;303;277;13.497;12.002000000000001;31;749;3193;67;70;236;207;1328.7;615.10000000000002;713.60000000000002;43.640000000000001;512;520;2414;439;327;500;476;2752;563;596;1;5;69
6;10805;Pardilhó;2039;2137;1969;2104;1036;844;898;698;138;146;13.32;17.298999999999999;52;761;783;18;33;120;113;266;129.90000000000001;136.09999999999999;41.640000000000001;321;263;1096;191;168;317;248;1084;233;255;1;8;96
6;11103;Casal Comba;1535;1648;1483;1627;797;678;743;626;54;52;6.7750000000000004;7.6699999999999999;42;504;823;8;14;46;38;169.30000000000001;81.599999999999994;87.599999999999994;44.030000000000001;215;176;836;170;138;197;146;880;227;198;1;10;105
6;11104;Luso;1267;1326;1286;1360;626;587;568;509;58;78;9.2650000000000006;13.288;14;364;699;8;9;50;69;153.69999999999999;75.099999999999994;78.599999999999994;44.789999999999999;173;136;713;125;120;143;110;738;156;179;1;10;106
6;11105;Mealhada;2125;2397;2012;2305;1177;1190;1082;1085;95;105;8.0709999999999997;8.8239999999999998;13;577;1577;22;21;73;84;452.69999999999999;212.69999999999999;240;40.340000000000003;387;222;1215;153;148;346;227;1359;203;262;1;10;107
6;11204;Torreira;1376;1369;1214;1322;784;594;704;462;80;132;10.204000000000001;22.222000000000001;304;268;594;20;41;60;91;87.299999999999997;43.700000000000003;43.5;37.159999999999997;246;180;797;86;67;230;190;741;128;80;1;11;114
6;11709;Dornelas;361;365;332;353;180;136;167;115;13;21;7.2220000000000004;15.441000000000001;16;149;117;1;4;12;17;80.299999999999997;39.899999999999999;40.399999999999999;43.630000000000003;63;31;192;49;26;44;39;190;47;45;1;17;182
6;11807;Sosa;1495;1574;1461;1562;745;636;671;564;74;72;9.9329999999999998;11.321;23;518;694;8;14;66;58;141.5;68.900000000000006;72.599999999999994;42.32;244;179;791;153;128;209;187;844;166;168;1;18;198
6;11809;Santo António de Vagos;816;937;783;921;434;422;408;389;26;33;5.9909999999999997;7.8200000000000003;37;307;453;1;9;25;24;178.69999999999999;83.200000000000003;95.5;41.770000000000003;132;83;467;64;70;139;104;491;91;112;1;18;197
6;60204;Cantanhede;3636;4102;3442;3938;1885;1922;1719;1715;166;207;8.8060000000000009;10.77;67;748;2619;32;44;134;163;185.30000000000001;87.099999999999994;98.200000000000003;40.780000000000001;636;381;1999;385;235;609;410;2254;417;412;7;90;1461
6;60206;Covões;993;1162;968;1131;425;362;389;321;36;41;8.4710000000000001;11.326000000000001;49;207;454;5;10;31;31;74.400000000000006;34.299999999999997;40.100000000000001;50.210000000000001;112;99;466;167;149;106;86;520;232;218;7;90;1464
6;60211;Pocariça;530;571;481;549;274;264;245;240;29;24;10.584;9.0909999999999993;10;129;346;7;7;22;17;89.299999999999997;43;46.299999999999997;43.759999999999998;69;62;296;73;30;65;64;311;73;58;7;90;1469
6;60213;Sepins;525;551;510;542;244;199;229;182;15;17;6.1479999999999997;8.5429999999999993;34;165;212;3;3;12;14;97.900000000000006;47.799999999999997;50.100000000000001;47.630000000000003;65;52;269;81;58;59;45;270;102;75;7;90;1473
6;60214;Tocha;1886;2106;1847;2048;958;857;870;753;88;104;9.1859999999999999;12.135;114;492;1017;11;19;77;85;50.899999999999999;24;26.899999999999999;45.740000000000002;230;168;1066;227;195;234;174;1110;294;294;7;90;1474
6;60219;Camarneira;392;432;366;421;158;141;148;123;10;18;6.3289999999999997;12.766;11;85;175;1;2;9;16;104.7;49.799999999999997;54.899999999999999;49.170000000000002;46;39;186;66;55;41;30;217;79;65;7;90;1460
6;60302;Coimbra (Almedina);405;499;563;656;197;201;153;174;44;27;22.335000000000001;13.433;5;27;295;10;5;34;22;896.79999999999995;401.80000000000001;495;48.189999999999998;40;45;221;46;53;43;49;217;87;103;7;91;1487
6;60319;Coimbra (São Bartolomeu);252;375;335;477;126;127;85;106;41;21;32.539999999999999;16.535;2;17;172;9;4;32;17;3748.5;1506.5999999999999;2241.9000000000001;51.829999999999998;22;19;150;27;34;23;29;154;55;114;7;91;1489
6;60330;Trouxemil;1324;1388;1276;1372;654;590;581;531;73;59;11.162000000000001;10;9;265;838;18;14;55;45;375.30000000000001;183.19999999999999;192.09999999999999;42.759999999999998;202;177;725;141;79;171;157;739;157;164;7;91;1505
6;60406;Ega;1335;1500;1265;1463;651;604;593;531;58;73;8.9090000000000007;12.086;13;325;786;10;19;48;54;87.099999999999994;41;46.100000000000001;45.100000000000001;189;139;703;167;137;200;139;747;172;242;7;92;1512
6;60502;Alqueidão;843;909;794;885;424;329;386;298;38;31;8.9619999999999997;9.4220000000000006;55;302;327;6;5;32;26;89.099999999999994;42.899999999999999;46.200000000000003;48.18;110;72;439;97;125;97;62;442;135;173;7;93;1518
6;60504;Buarcos;3999;4603;3632;4328;1963;1929;1708;1679;255;250;12.99;12.960000000000001;73;896;2418;30;42;225;208;619.60000000000002;288;331.5;44.700000000000003;559;382;2293;424;341;563;377;2566;494;603;7;93;1522
6;60507;Maiorca;1289;1345;1210;1313;628;504;558;420;70;84;11.146000000000001;16.667000000000002;54;328;596;8;23;62;61;105;51.399999999999999;53.600000000000001;46.219999999999999;137;133;748;151;120;141;114;719;189;182;7;93;1525
6;60509;Paião;1047;1221;972;1164;506;454;466;406;40;48;7.9050000000000002;10.573;27;329;516;7;10;33;38;106.59999999999999;49.200000000000003;57.399999999999999;47.75;141;78;561;142;125;143;94;599;153;232;7;93;1528
6;61301;Carvalho;399;447;397;437;182;119;171;100;11;19;6.0439999999999996;15.965999999999999;35;105;131;1;4;10;15;28.100000000000001;13.199999999999999;14.800000000000001;47.509999999999998;43;30;213;73;40;55;41;225;66;60;7;101;1600
6;61307;Penacova;1532;1722;1449;1662;771;682;707;621;64;61;8.3010000000000002;8.9439999999999991;28;374;926;7;13;57;48;100.40000000000001;47.299999999999997;53.100000000000001;45.82;204;140;846;188;154;199;149;897;227;250;7;101;1606
6;61309;São Pedro de Alva;748;859;698;822;352;270;328;233;24;37;6.8179999999999996;13.704000000000001;30;160;371;0;10;24;27;57.100000000000001;26.600000000000001;30.5;48.909999999999997;75;74;396;97;106;92;60;410;126;171;7;101;1608
6;61310;Sazes do Lorvão;365;384;330;372;184;143;168;132;16;11;8.6959999999999997;7.6920000000000002;7;93;200;1;1;15;10;42;20.399999999999999;21.5;45.549999999999997;44;32;213;38;38;50;35;193;55;51;7;101;1609
6;61503;Degracias;211;242;199;225;85;75;75;59;10;16;11.765000000000001;21.332999999999998;10;60;64;0;1;10;15;31.899999999999999;14.800000000000001;17;50.869999999999997;23;18;97;35;38;17;23;105;44;53;7;103;1619
6;100401;Batalha;4202;4346;4037;4211;2288;2040;2142;1837;146;203;6.3810000000000002;9.9510000000000005;90;1545;2344;21;34;125;169;300.80000000000001;147.90000000000001;152.90000000000001;39.700000000000003;739;482;2364;364;253;716;433;2430;397;370;11;152;2191
6;100403;São Mamede;1695;1865;1621;1811;883;825;812;762;71;63;8.0410000000000004;7.6360000000000001;18;767;789;16;8;55;55;85.200000000000003;40.600000000000001;44.700000000000003;42.670000000000002;254;168;927;177;169;272;198;981;198;216;11;152;2194
6;100902;Arrabal;1328;1356;1253;1288;691;610;651;563;40;47;5.7889999999999997;7.7050000000000001;15;428;771;10;6;30;41;133.59999999999999;66.099999999999994;67.5;43.530000000000001;190;167;706;133;132;198;129;716;142;171;11;157;2224
6;100905;Barreira;1996;2106;1866;1991;1125;1114;1057;1024;68;90;6.0439999999999996;8.0790000000000006;28;577;1476;10;12;58;78;346.89999999999998;168.80000000000001;178.09999999999999;38.490000000000002;336;234;1167;168;91;324;206;1265;180;131;11;157;2228
6;100906;Boa Vista;838;907;779;866;452;398;428;363;24;35;5.3099999999999996;8.7940000000000005;33;262;496;6;12;18;23;190.09999999999999;91.299999999999997;98.799999999999997;42.640000000000001;132;100;449;95;62;126;93;492;99;97;11;157;2230
6;100907;Caranguejeira;2282;2409;2165;2312;1221;1029;1148;962;73;67;5.9790000000000001;6.5110000000000001;55;1031;1024;17;21;56;46;151.40000000000001;73.599999999999994;77.700000000000003;42.159999999999997;362;276;1231;244;169;342;282;1259;281;245;11;157;2231
6;100908;Carvide;1357;1463;1320;1406;637;589;576;516;61;73;9.5760000000000005;12.394;22;481;589;12;21;49;52;229.09999999999999;110.2;118.8;44.390000000000001;212;135;732;161;117;185;132;792;160;194;11;157;2233
6;100909;Coimbrão;853;882;806;837;423;344;382;311;41;33;9.6929999999999996;9.593;35;294;364;9;2;32;31;33.200000000000003;16.300000000000001;16.899999999999999;45.789999999999999;102;102;456;105;88;94;97;439;113;139;11;157;2235
6;100913;Maceira;4840;5074;4549;4851;2485;2123;2314;1914;171;209;6.8810000000000002;9.8450000000000006;37;2271;1920;28;33;143;176;210.90000000000001;103;107.90000000000001;43.380000000000003;667;532;2723;512;406;672;524;2759;563;556;11;157;2239
6;101501;Abiul;1220;1509;1153;1474;493;400;462;346;31;54;6.2880000000000003;13.5;42;349;417;6;10;25;44;50.799999999999997;22.699999999999999;28.100000000000001;50.609999999999999;127;128;575;203;187;124;119;668;271;327;11;163;2276
6;101505;Carriço;1799;1854;1703;1783;928;751;869;690;59;61;6.3579999999999997;8.1229999999999993;102;639;818;10;14;49;47;43.799999999999997;21.600000000000001;22.199999999999999;42.469999999999999;276;205;973;192;153;260;188;1008;228;170;11;163;2280
6;101511;Santiago de Litém;1040;1197;969;1163;415;358;381;311;34;47;8.1929999999999996;13.128;11;265;416;5;12;29;35;72.799999999999997;33.799999999999997;38.899999999999999;50.030000000000001;128;95;477;169;171;122;98;517;203;257;11;163;2289
6;101601;Alcaria;110;134;111;136;50;41;48;39;2;2;4;4.8780000000000001;2;25;60;0;1;2;1;18.600000000000001;8.4000000000000004;10.199999999999999;50.229999999999997;10;7;53;22;18;21;7;58;19;29;11;164;2293
6;101605;Calvaria de Cima;1203;1259;1131;1211;646;578;600;509;46;69;7.1210000000000004;11.938000000000001;24;508;577;4;10;42;59;229.80000000000001;112.3;117.5;40.109999999999999;229;93;685;117;79;194;114;723;125;103;11;164;2297
6;101609;Pedreiras;1322;1383;1237;1331;719;595;670;525;49;70;6.8149999999999995;11.765000000000001;21;586;588;9;8;40;62;204.59999999999999;100;104.59999999999999;42.420000000000002;191;149;734;126;122;203;168;697;143;172;11;164;2301
6;101610;São Bento;393;442;384;421;198;149;189;139;9;10;4.5449999999999999;6.7110000000000003;45;182;101;1;3;8;7;20.199999999999999;9.5;10.699999999999999;46.460000000000001;43;38;214;44;54;62;41;205;56;78;11;164;2304
6;101612;Porto de Mós (São Pedro);1400;1479;1306;1398;754;696;678;599;76;97;10.08;13.936999999999999;17;420;840;5;19;71;78;212.30000000000001;103.2;109.09999999999999;40.18;247;175;754;133;91;234;137;823;147;138;11;164;2303
6;101613;Serro Ventoso;508;518;457;473;258;212;249;189;9;23;3.488;10.849;23;192;223;0;2;9;21;32;15.800000000000001;16.100000000000001;43.18;87;54;269;50;48;65;56;271;52;74;11;164;2305
6;60101;Anceriz;64;82;62;83;22;17;17;16;5;1;22.727;5.8819999999999997;1;16;16;1;1;4;0;33.100000000000001;14.5;18.600000000000001;54.920000000000002;5;6;31;12;10;5;4;34;14;25;7;89;1439
6;60117;Teixeira;71;64;70;57;18;11;14;9;4;2;22.222000000000001;18.181999999999999;3;10;10;1;0;3;2;7.2000000000000002;3.7999999999999998;3.3999999999999999;59.530000000000001;2;5;27;17;20;3;1;25;22;13;7;89;1455
6;60702;Foz de Arouce;520;542;487;519;263;219;231;184;32;35;12.167;15.981999999999999;17;130;268;4;7;28;28;67.900000000000006;33.200000000000003;34.600000000000001;44.079999999999998;73;58;285;51;53;64;59;295;56;68;7;95;1541
6;61102;Alvoco das Várzeas;138;182;132;179;54;50;44;47;10;3;18.518999999999998;6;6;43;42;1;0;9;3;27.5;11.9;15.699999999999999;55.149999999999999;10;15;66;25;22;15;9;71;34;53;7;99;1570
6;61105;Ervedal;443;486;422;472;173;138;148;120;25;18;14.451000000000001;13.042999999999999;11;86;171;11;6;14;12;42.700000000000003;20.399999999999999;22.300000000000001;50.759999999999998;48;50;200;61;84;44;47;214;73;108;7;99;1573
6;61108;Lajeosa;261;292;246;287;141;118;123;102;18;16;12.766;13.558999999999999;4;95;126;5;2;13;14;106.59999999999999;50.299999999999997;56.299999999999997;41.380000000000003;38;36;148;25;14;53;27;155;30;27;7;99;1576
6;61202;Dornelas do Zêzere;323;359;285;336;138;88;129;79;9;9;6.5220000000000002;10.227;2;109;97;1;2;8;7;41.5;19.699999999999999;21.800000000000001;52.270000000000003;25;33;173;56;36;19;32;157;61;90;7;100;1591
6;61207;Pessegueiro;99;129;108;132;23;24;16;17;7;7;30.434999999999999;29.167000000000002;0;6;27;0;2;7;5;7.0999999999999996;3.1000000000000001;4;61.020000000000003;7;1;35;30;26;5;5;41;39;39;7;100;1596
6;61609;Mouronho;405;435;377;403;188;141;171;126;17;15;9.0429999999999993;10.638;16;126;155;4;1;13;14;35;16.899999999999999;18.100000000000001;46.280000000000001;51;49;212;57;36;46;47;217;49;76;7;104;1637
6;61614;Tábua;1641;1901;1565;1879;800;841;743;755;57;86;7.125;10.226000000000001;38;449;1011;11;16;46;70;142.80000000000001;66.099999999999994;76.599999999999994;41.460000000000001;313;182;843;150;153;303;179;979;166;274;7;104;1642
6;100805;Bairradas;224;263;211;253;97;77;84;46;13;31;13.401999999999999;40.259999999999998;4;42;84;3;6;10;25;41.899999999999999;19.300000000000001;22.600000000000001;50.390000000000001;23;23;118;36;24;20;19;133;47;44;11;156;2220
6;90102;Carapito;206;236;195;228;88;51;85;37;3;14;3.4089999999999998;27.451000000000001;17;48;57;1;11;2;3;25.600000000000001;11.9;13.699999999999999;44.299999999999997;35;25;92;25;29;34;32;111;24;35;10;135;1823
6;90103;Cortiçada;157;184;157;183;55;34;53;33;2;1;3.6360000000000001;2.9409999999999998;16;29;41;0;0;2;1;27;12.4;14.5;50.939999999999998;15;11;82;26;23;16;15;90;36;27;10;135;1824
6;90108;Gradiz;78;81;79;78;42;30;41;26;1;4;2.3810000000000002;13.333;14;14;39;0;0;1;4;12.5;6.0999999999999996;6.4000000000000004;45.969999999999999;6;10;47;5;10;6;11;43;11;10;10;135;1829
6;90109;Pena Verde;379;434;370;421;169;111;155;98;14;13;8.2840000000000007;11.712;54;75;124;1;4;13;9;27.699999999999999;12.9;14.800000000000001;49.909999999999997;41;37;175;59;67;41;57;191;58;87;10;135;1830
6;90112;Souto de Aguiar da Beira;139;158;138;156;51;43;50;39;1;4;1.9609999999999999;9.3019999999999996;11;24;54;1;2;0;2;20;9.4000000000000004;10.699999999999999;52.539999999999999;14;10;65;23;27;9;15;70;32;32;10;135;1833
6;90113;Valverde;73;81;71;77;35;27;34;25;1;2;2.8570000000000002;7.407;6;8;45;1;0;0;2;22.5;10.699999999999999;11.800000000000001;45.399999999999999;11;7;38;10;7;10;9;42;10;10;10;135;1834
6;180311;Mezio;259;225;216;212;123;61;109;56;14;5;11.382;8.1969999999999992;17;66;82;0;0;14;5;39.899999999999999;21.399999999999999;18.600000000000001;39.439999999999998;54;42;124;22;17;32;31;109;30;23;20;285;3925
6;180609;Lobelhe do Mato;126;133;121;130;50;36;48;31;2;5;4;13.888999999999999;4;33;42;0;1;2;4;183.80000000000001;89.400000000000006;94.400000000000006;46.57;14;13;62;15;22;20;10;63;25;15;20;288;3986
6;180801;Almaça;37;47;56;64;20;17;20;14;0;3;0;17.646999999999998;4;13;17;0;0;0;3;12.300000000000001;5.4000000000000004;6.9000000000000004;51.759999999999998;2;3;22;3;7;2;5;22;10;8;20;290;4016
6;181113;Vila Cova do Covelo;102;109;90;103;33;18;31;18;2;0;6.0609999999999999;0;3;21;25;0;0;2;0;23.199999999999999;11.199999999999999;12;55.659999999999997;5;6;51;20;20;7;6;46;24;26;20;293;4059
6;181404;Santa Comba Dão;1597;1789;1500;1753;819;798;731;714;88;84;10.744999999999999;10.526;11;412;1022;17;14;71;70;285.89999999999998;134.80000000000001;151;42.479999999999997;249;172;882;152;142;249;176;966;179;219;20;296;4088
6;181602;Bordonhos;269;278;253;264;125;120;115;99;10;21;8;17.5;18;66;130;2;4;8;17;91.900000000000006;45.200000000000003;46.700000000000003;41.350000000000001;60;29;138;19;23;37;29;148;27;37;20;298;4108
6;181603;Candal;52;66;54;64;16;8;15;6;1;2;6.25;25;9;3;9;0;2;1;0;5.7000000000000002;2.5;3.2000000000000002;57.719999999999999;9;3;18;12;10;1;2;24;15;24;20;298;4109
6;181708;Romãs;406;462;376;433;175;110;156;92;19;18;10.856999999999999;16.364000000000001;47;83;118;3;4;16;14;25.100000000000001;11.800000000000001;13.4;49.189999999999998;34;53;205;63;51;45;40;224;70;83;20;299;4133
6;181710;Sátão;1896;2111;1794;2061;1015;888;929;766;86;122;8.4730000000000008;13.739000000000001;25;483;1187;22;25;64;97;215.80000000000001;102.09999999999999;113.7;38.689999999999998;371;218;1077;124;106;346;263;1127;176;199;20;299;4135
6;182124;Vila Nova da Rainha;226;250;219;246;98;97;90;86;8;11;8.1630000000000003;11.34;15;52;109;1;4;7;7;77.099999999999994;36.600000000000001;40.5;46.939999999999998;40;24;108;25;29;24;19;120;42;45;20;303;4206
6;182201;Alhais;246;276;236;267;120;93;106;80;14;13;11.667;13.978;19;41;126;4;3;10;10;45.100000000000001;21.300000000000001;23.899999999999999;44.719999999999999;35;30;128;28;25;44;27;129;37;39;20;304;4208
6;182206;Vila Cova à Coelheira;533;576;419;497;247;162;202;128;45;34;18.219000000000001;20.988;43;91;196;2;2;43;32;34.600000000000001;16.600000000000001;18;44.649999999999999;74;67;289;48;55;60;66;279;68;103;20;304;4213
6;182301;Abraveses;4083;4456;3817;4293;2133;2134;1902;1829;231;305;10.83;14.292;18;645;3068;46;67;185;238;698.39999999999998;333.89999999999998;364.39999999999998;38.609999999999999;750;480;2328;321;204;702;496;2591;349;318;20;305;4215
6;182303;Boa Aldeia;248;270;241;265;103;81;87;71;16;10;15.534000000000001;12.346;9;48;101;8;2;8;8;60.899999999999999;29.199999999999999;31.800000000000001;51.140000000000001;18;30;127;34;39;24;15;127;43;61;20;305;4217
6;182308;Cepões;599;685;574;661;251;195;225;165;26;30;10.359;15.385;18;147;225;5;8;21;22;44;20.5;23.5;48.299999999999997;67;69;286;101;76;78;62;312;120;113;20;305;4222
6;182315;Fragosela;1299;1363;1247;1314;685;617;636;557;49;60;7.1529999999999996;9.7240000000000002;40;309;844;14;18;35;42;241.19999999999999;117.7;123.5;38.840000000000003;246;148;736;106;63;227;154;768;121;93;20;305;4228
6;182317;Silgueiros;1521;1729;1453;1700;698;570;630;490;68;80;9.7420000000000009;14.035;107;259;754;21;28;47;52;89.900000000000006;42.100000000000001;47.799999999999997;46.259999999999998;188;173;773;204;183;202;189;857;224;257;20;305;4242
6;182401;Alcofra;495;530;457;502;225;183;205;155;20;28;8.8889999999999993;15.301;35;211;114;1;12;19;16;35.399999999999999;17.100000000000001;18.300000000000001;47.789999999999999;65;46;250;66;68;45;51;264;81;89;20;306;4249
6;182404;Carvalhal de Vermilhas;105;110;99;103;36;30;27;25;9;5;25;16.667000000000002;7;30;15;1;1;8;4;27.199999999999999;13.300000000000001;13.9;46.990000000000002;22;9;43;13;18;13;13;40;18;26;20;306;4252
6;50602;Amieira;55;61;56;62;13;4;13;3;0;1;0;25;6;3;7;0;0;0;1;4.0999999999999996;2;2.2000000000000002;63.479999999999997;1;3;23;9;19;2;1;20;22;16;6;83;1389
6;50606;Madeirã;77;94;72;92;39;20;37;18;2;2;5.1280000000000001;10;20;10;25;0;0;2;2;6.4000000000000004;2.8999999999999999;3.5;54.049999999999997;5;2;49;10;11;7;5;47;15;20;6;83;1393
6;50909;Nesperal;146;159;134;152;66;38;62;31;4;7;6.0609999999999999;18.420999999999999;7;30;56;0;3;4;4;37.799999999999997;18.100000000000001;19.699999999999999;46.560000000000002;15;20;70;26;15;18;21;69;30;21;6;86;1426
6;50913;Troviscal;422;442;422;435;188;101;183;97;5;4;2.6600000000000001;3.96;43;90;147;1;0;4;4;16.199999999999999;7.9000000000000004;8.3000000000000007;51.219999999999999;38;52;202;70;60;35;44;177;94;92;6;86;1430
6;51002;São João do Peso;79;125;69;118;25;17;21;17;4;0;16;0;4;6;28;0;0;4;0;15.6;6.0999999999999996;9.5999999999999996;62.07;6;8;29;13;23;5;10;28;15;67;6;87;1433
6;90501;Algodres;168;181;163;171;73;47;64;34;9;13;12.329000000000001;27.66;16;25;57;0;4;9;9;34.399999999999999;16.600000000000001;17.800000000000001;49.109999999999999;18;14;83;21;32;23;16;80;32;30;10;139;1903
6;90502;Casal Vasco;106;121;103;119;40;33;35;26;5;7;12.5;21.212;4;12;45;0;3;5;4;33.700000000000003;15.699999999999999;18;53.049999999999997;10;10;46;20;20;8;13;49;18;33;10;139;1904
6;90515;Vila Ruiva;72;96;71;96;26;27;20;24;6;3;23.077000000000002;11.111000000000001;9;5;30;1;2;5;1;26.399999999999999;11.300000000000001;15.1;56.82;1;6;33;17;15;6;6;42;16;26;10;139;1917
6;90603;Cativelos;331;393;322;398;103;98;93;87;10;11;9.7089999999999996;11.224;16;35;129;2;2;8;9;51.299999999999997;23.5;27.899999999999999;55.850000000000001;20;33;137;72;69;20;25;165;84;99;10;140;1921
6;90606;Freixo da Serra;47;52;41;47;13;7;12;4;1;3;7.6920000000000002;42.856999999999999;1;6;9;0;0;1;3;21.399999999999999;10.199999999999999;11.300000000000001;64.400000000000006;3;3;19;8;14;;2;13;9;28;10;140;1924
6;90608;Mangualde da Serra;78;86;75;86;25;25;24;22;1;3;4;12;3;20;23;0;1;1;2;9.5;4.5;5;46.450000000000003;12;7;36;15;8;14;3;44;11;14;10;140;1928
6;30918;Moure;121;121;109;118;61;54;57;51;4;3;6.5570000000000004;5.556;4;35;69;1;0;3;3;195.59999999999999;97.799999999999997;97.799999999999997;39.859999999999999;23;16;66;12;4;14;13;70;13;11;4;60;816
6;30919;Póvoa de Lanhoso (Nossa Senhora do Amparo);2378;2674;2313;2687;1184;1231;1006;1049;178;182;15.034000000000001;14.785;20;670;1365;39;42;139;140;927.20000000000005;436.39999999999998;490.80000000000001;37.920000000000002;468;327;1287;164;132;437;329;1506;193;209;4;60;818
6;30927;Travassos;320;376;308;384;151;119;134;107;17;12;11.257999999999999;10.084;13;108;120;5;3;12;9;171.09999999999999;78.700000000000003;92.400000000000006;43.630000000000003;44;48;178;21;29;41;41;198;42;54;4;60;825
6;31224;Lousado;2009;2048;1978;2059;1069;961;969;824;100;137;9.3550000000000004;14.256;6;993;794;17;22;83;115;697.39999999999998;345.30000000000001;352;40.140000000000001;342;265;1116;164;122;306;217;1153;187;185;4;63;891
6;31225;Mogege;950;993;912;964;532;503;471;414;61;89;11.465999999999999;17.693999999999999;2;546;337;7;16;54;73;677.5;331.19999999999999;346.19999999999999;37.490000000000002;165;128;571;53;33;162;140;573;52;66;4;63;892
6;31401;Santa Eulália;2771;2848;2631;2748;1622;1540;1424;1327;198;213;12.207000000000001;13.831;10;1938;803;8;22;190;191;996.20000000000005;491.30000000000001;504.89999999999998;36.060000000000002;531;393;1626;143;78;486;390;1682;160;130;4;65;976
6;131426;Campo (São Martinho);1683;1787;1631;1757;904;887;747;714;157;173;17.367000000000001;19.504000000000001;13;932;516;22;17;135;156;1133.5999999999999;549.79999999999995;583.79999999999995;41.079999999999998;236;241;973;138;95;230;212;1026;174;145;15;220;2970
6;131427;Couto (São Miguel);582;640;572;627;321;313;278;253;43;60;13.396000000000001;19.169;1;239;291;3;8;40;52;643;306.19999999999999;336.80000000000001;42.340000000000003;86;56;355;55;30;87;64;380;54;55;15;220;2973
6;131429;São Salvador do Campo;587;607;570;599;309;296;267;241;42;55;13.592000000000001;18.581;5;344;159;2;3;40;52;1250.4000000000001;614.70000000000005;635.70000000000005;39.520000000000003;96;74;345;48;24;95;76;355;44;37;15;220;2986
6;130602;Barca;1247;1386;1201;1371;684;589;563;459;121;130;17.690000000000001;22.071000000000002;16;354;652;11;17;110;113;799.60000000000002;378.69999999999999;420.89999999999998;42.060000000000002;178;127;749;120;73;193;150;782;140;121;15;212;2805
6;130617;Pedrouços;5697;6452;5611;6398;2997;2953;2504;2494;493;459;16.449999999999999;15.544;15;964;4019;80;79;413;380;4722.1000000000004;2214.3000000000002;2507.8000000000002;41.469999999999999;910;600;3318;509;360;848;637;3707;621;639;15;212;2814
6;130804;Leça do Balio;8422;9149;8066;9040;4600;4373;3962;3739;638;634;13.869999999999999;14.497999999999999;23;1725;5953;104;107;534;527;1928.0999999999999;924.20000000000005;1003.9;41.229999999999997;1369;883;4961;682;527;1290;805;5383;750;921;15;214;2854
6;130810;Senhora da Hora;13015;14732;12610;14647;7217;7596;6303;6492;914;1104;12.664999999999999;14.534000000000001;31;2145;10619;171;201;743;903;7343.6000000000004;3444.5999999999999;3899;40.670000000000002;2012;1582;7769;1035;617;1889;1606;9028;1218;991;15;214;2859
6;131212;Santo Ildefonso;4104;4925;4559;5329;2110;1991;1621;1591;489;400;23.175000000000001;20.09;7;364;2841;73;79;416;321;7302.5;3319.3000000000002;3983.3000000000002;47.159999999999997;402;422;2430;427;423;394;445;2498;644;944;15;218;2949
6;131309;Navais;681;798;645;772;374;303;345;279;29;24;7.7539999999999996;7.9210000000000003;140;191;293;2;3;27;21;408.89999999999998;188.30000000000001;220.59999999999999;40.289999999999999;127;68;380;58;48;122;105;428;64;79;15;219;2961
6;131713;Pedroso;9148;9566;8750;9328;4941;4365;4143;3492;798;873;16.151;20;39;2652;4944;117;130;681;743;963.10000000000002;470.80000000000001;492.30000000000001;40.130000000000003;1477;1108;5329;761;473;1403;1055;5576;830;702;15;224;3044
6;131719;Seixezelo;831;881;791;860;462;387;397;296;65;91;14.069000000000001;23.513999999999999;4;260;429;11;15;54;76;1182.7;574.10000000000002;608.60000000000002;40.520000000000003;135;87;481;75;53;135;90;500;85;71;15;224;3049
6;130126;Padronelo;435;449;409;438;209;173;185;137;24;36;11.483000000000001;20.809000000000001;6;119;197;6;7;18;29;355.69999999999999;175.09999999999999;180.69999999999999;43.57;68;49;232;39;47;55;50;240;59;45;15;207;2702
6;130139;Vila Chã do Marão;441;499;412;475;243;207;215;165;28;42;11.523;20.289999999999999;17;148;215;6;6;22;36;140.09999999999999;65.700000000000003;74.400000000000006;42.340000000000003;59;59;253;47;23;60;70;259;57;53;15;207;2711
6;130219;Valadares;428;447;356;425;215;130;180;71;35;59;16.279;45.384999999999998;27;146;78;3;23;32;36;82.900000000000006;40.5;42.299999999999997;39.969999999999999;67;66;233;33;29;68;56;227;55;41;15;208;2731
6;130717;Rosem;111;109;105;105;55;33;47;28;8;5;14.545;15.151999999999999;2;31;42;1;2;7;3;43.700000000000003;22.100000000000001;21.699999999999999;37.530000000000001;27;14;56;8;6;18;17;56;8;10;15;213;2835
6;130718;Sande;896;986;745;944;475;266;391;221;84;45;17.684000000000001;16.917000000000002;13;386;213;5;7;79;38;220.40000000000001;104.90000000000001;115.5;38.140000000000001;175;117;492;67;45;182;126;505;85;88;15;213;2836
6;131009;Cristelo;958;933;895;914;529;398;450;302;79;96;14.933999999999999;24.120999999999999;9;448;295;18;23;61;73;934.5;473.39999999999998;461.10000000000002;34.689999999999998;221;151;495;57;34;198;111;527;57;40;15;216;2884
6;131021;Sobrosa;1243;1398;1202;1379;675;552;577;472;98;80;14.519;14.493;12;569;468;16;23;82;57;561.60000000000002;264.30000000000001;297.30000000000001;37.719999999999999;227;174;704;86;52;279;158;754;105;102;15;216;2896
6;131123;Paredes;597;661;560;644;310;275;271;234;39;41;12.581;14.909000000000001;14;227;264;8;11;31;30;938.89999999999998;445.60000000000002;493.30000000000001;37.289999999999999;117;92;322;33;33;112;94;370;40;45;15;217;2922
6;170505;Mondim de Basto;1552;1721;1454;1650;717;618;640;522;77;96;10.739000000000001;15.534000000000001;30;263;869;21;23;56;73;204.90000000000001;97.200000000000003;107.8;41.390000000000001;268;209;817;144;114;234;203;897;183;204;19;273;3718
6;180413;São Cristóvão de Nogueira;936;994;814;962;453;233;392;180;61;53;13.465999999999999;22.747;18;299;255;3;20;58;33;106.3;51.600000000000001;54.799999999999997;41.210000000000001;169;118;515;60;74;136;114;525;97;122;20;286;3949
6;120104;Cunheira;182;207;180;207;72;67;57;54;15;13;20.832999999999998;19.402999999999999;35;12;64;0;2;15;11;10.5;4.9000000000000004;5.5999999999999996;53.729999999999997;21;19;83;18;41;11;18;79;23;76;14;192;2589
6;120601;Aldeia da Mata;159;215;155;212;52;48;50;44;2;4;3.8460000000000001;8.3330000000000002;13;9;72;0;3;2;1;10;4.2999999999999998;5.7999999999999998;61.579999999999998;15;7;66;25;46;7;8;71;32;97;14;197;2609
6;120803;São Saturnino;142;136;133;135;78;50;72;39;6;11;7.6920000000000002;22;42;13;56;1;2;5;9;6.7000000000000002;3.3999999999999999;3.2999999999999998;51.079999999999998;14;11;69;25;23;12;3;68;30;23;14;199;2628
6;121102;Monforte;677;707;656;678;318;303;261;251;57;52;17.925000000000001;17.161999999999999;63;46;403;23;21;34;31;6.5;3.2000000000000002;3.2999999999999998;42.93;127;61;345;63;81;109;71;342;83;102;14;202;2639
6;130108;Carneiro;152;159;132;154;73;33;68;25;5;8;6.8490000000000002;24.242000000000001;5;57;31;0;1;5;7;36.700000000000003;18;18.800000000000001;40.090000000000003;30;24;70;17;11;22;24;76;26;11;15;207;2681
6;130201;Ancede;1226;1301;1129;1262;626;394;562;303;64;91;10.224;23.096;19;431;415;13;32;51;59;199.90000000000001;97;102.90000000000001;40.340000000000003;214;159;690;77;86;181;156;719;108;137;15;208;2713
6;130202;Campelo;1507;1730;1363;1664;779;722;710;538;69;184;8.8580000000000005;25.484999999999999;17;431;800;7;59;62;125;213.80000000000001;99.5;114.2;38.640000000000001;284;191;834;85;113;287;228;911;132;172;15;208;2715
6;130220;Viariz;244;276;192;270;118;68;105;31;13;37;11.016999999999999;54.411999999999999;6;91;39;2;17;11;20;83.400000000000006;39.100000000000001;44.299999999999997;42.869999999999997;38;31;135;27;13;37;31;140;34;34;15;208;2732
6;130318;Regilde;612;672;602;667;365;320;329;288;36;32;9.8629999999999995;10;6;491;120;2;6;34;26;416.69999999999999;198.59999999999999;218.09999999999999;38.030000000000001;111;77;360;34;30;118;89;368;47;50;15;209;2751
6;130327;Torrados;1185;1185;1133;1144;702;624;640;576;62;48;8.8320000000000007;7.6920000000000002;17;899;300;6;9;56;39;699;349.5;349.5;37.140000000000001;223;181;669;60;52;197;160;676;77;75;15;209;2757
6;130509;Figueiras;677;705;640;695;393;314;354;275;39;39;9.9239999999999995;12.42;3;409;217;4;3;35;36;485.80000000000001;238;247.80000000000001;34.25;140;95;394;25;23;156;94;386;34;35;15;211;2786
6;130516;Nogueira;603;650;581;630;332;273;300;236;32;37;9.6389999999999993;13.553000000000001;15;228;293;4;9;28;28;586.20000000000005;282.10000000000002;304.10000000000002;37.939999999999998;105;81;346;38;33;115;77;366;48;44;15;211;2795
6;130607;Maia;5834;6572;5544;6341;3325;3463;2935;2995;390;468;11.728999999999999;13.513999999999999;14;1184;4732;94;107;296;361;3621.5;1703;1918.5;38.409999999999997;1066;568;3535;453;212;1088;585;4044;476;379;15;212;2810
6;130731;Vila Boa de Quires;1632;1762;1445;1679;826;546;748;448;78;98;9.4429999999999996;17.949000000000002;49;725;422;11;26;67;72;210.5;101.2;109.3;36.719999999999999;324;247;880;108;73;320;274;899;145;124;15;213;2848
6;130903;Codessos;505;506;485;497;297;256;271;218;26;38;8.7539999999999996;14.843999999999999;2;317;170;5;5;21;33;521.39999999999998;260.39999999999998;260.89999999999998;35.469999999999999;106;63;296;26;14;105;53;296;24;28;15;215;2862
6;131015;Madalena;897;946;846;928;474;429;413;359;61;70;12.869;16.317;37;216;519;14;12;47;58;1081.0999999999999;526.20000000000005;554.89999999999998;37.090000000000003;162;124;524;47;40;161;122;560;66;37;15;216;2890
6;131136;Valpedre;790;786;769;784;452;296;421;255;31;41;6.8579999999999997;13.850999999999999;9;457;210;5;5;26;36;248.80000000000001;124.7;124.09999999999999;34.560000000000002;186;130;414;30;30;157;118;411;50;50;15;217;2936
6;131303;Amorim;1350;1434;1313;1417;730;587;659;514;71;73;9.7259999999999991;12.436;85;442;646;6;11;65;62;582.10000000000002;282.30000000000001;299.80000000000001;39.030000000000001;240;192;765;92;61;209;185;825;105;110;15;219;2955
6;131602;Árvore;2609;2587;2448;2528;1428;1252;1236;1013;192;239;13.445;19.088999999999999;48;680;1521;36;43;156;196;792;397.69999999999999;394.30000000000001;38.399999999999999;513;283;1504;185;124;419;257;1513;222;176;15;223;3003
6;131604;Azurara;1091;1214;1081;1228;628;560;529;453;99;107;15.763999999999999;19.106999999999999;19;326;637;17;24;82;83;1065.2;504.19999999999999;561;39.329999999999998;184;111;676;76;44;179;136;713;96;90;15;223;3005
6;131627;Vila Chã;1473;1621;1420;1607;771;725;687;620;84;105;10.895;14.483000000000001;34;498;775;8;19;76;86;642.79999999999995;306;336.80000000000001;40.649999999999999;250;165;841;141;76;244;180;912;174;111;15;223;3028
6;131708;Lever;1365;1429;1312;1394;762;629;660;474;102;155;13.385999999999999;24.641999999999999;7;533;594;17;30;85;125;356.19999999999999;174;182.19999999999999;41.939999999999998;179;165;811;127;83;199;162;805;134;129;15;224;3039
6;131709;Madalena;4789;5251;4538;5076;2541;2394;2127;1972;414;422;16.292999999999999;17.626999999999999;14;971;3114;76;66;338;356;2140.6999999999998;1021.1;1119.5999999999999;41.640000000000001;741;514;2769;462;303;761;453;3035;518;484;15;224;3040
6;131807;Guidões;804;855;757;829;444;398;396;322;48;76;10.811;19.094999999999999;11;446;261;7;9;41;67;350.89999999999998;170.09999999999999;180.80000000000001;38.32;142;111;459;69;23;130;120;477;72;56;15;221;2995
6;140101;Aldeia do Mato;203;238;192;228;69;40;59;31;10;9;14.493;22.5;16;25;49;1;1;9;8;13.9;6.4000000000000004;7.5;57.630000000000003;17;12;94;31;49;14;11;78;51;84;16;225;3058
6;140201;Alcanena;2003;2128;1814;1975;1049;981;963;888;86;93;8.1980000000000004;9.4800000000000004;10;695;1146;15;17;71;76;398.80000000000001;193.40000000000001;205.40000000000001;42.789999999999999;318;220;1106;185;174;271;215;1171;219;252;16;226;3075
6;140704;Ulme;621;656;599;651;307;251;282;220;25;31;8.1430000000000007;12.350999999999999;144;161;197;3;1;22;30;10.5;5.0999999999999996;5.4000000000000004;47.5;55;68;337;84;77;72;61;324;89;110;16;231;3107
6;140706;Parreira;448;467;441;461;246;192;234;170;12;22;4.8780000000000001;11.458;162;101;141;1;2;11;20;6.9000000000000004;3.3999999999999999;3.5;46.359999999999999;52;42;249;55;50;47;40;244;72;64;16;231;3105
6;141108;Paio Mendes;239;256;226;247;118;88;112;84;6;4;5.085;4.5449999999999999;49;54;93;2;0;4;4;57.700000000000003;27.899999999999999;29.800000000000001;43.869999999999997;33;24;137;25;20;44;22;122;36;32;16;235;3129
6;141201;Azinhaga;790;830;776;817;375;308;324;257;51;51;13.6;16.558;67;129;385;3;4;48;47;42.399999999999999;20.699999999999999;21.699999999999999;45.399999999999999;111;96;407;98;78;97;87;412;103;131;16;236;3131
6;141410;Asseiceira;497;520;472;515;271;230;243;195;28;35;10.332000000000001;15.217000000000001;14;141;283;5;5;23;30;60.899999999999999;29.800000000000001;31.100000000000001;42.469999999999999;74;58;272;57;36;75;47;284;59;55;16;239;3162
6;141620;Santarém (São Nicolau);4501;5126;4413;5133;2361;2564;2076;2284;285;280;12.071;10.92;108;644;3608;45;47;240;233;648.10000000000002;303;345.10000000000002;39.729999999999997;866;528;2505;328;274;754;505;2926;454;487;16;241;3199
6;141701;Alcaravela;439;465;403;448;219;157;195;136;24;21;10.959;13.375999999999999;10;133;188;5;4;19;17;24.600000000000001;11.9;12.6;47;46;53;239;52;49;50;38;238;57;82;16;242;3207
6;141702;Santiago de Montalegre;111;118;108;113;39;22;36;17;3;5;7.6920000000000002;22.727;1;18;34;0;3;3;2;13.5;6.5;6.9000000000000004;53.770000000000003;10;5;53;19;24;7;10;49;19;33;16;242;3208
6;141904;Chancelaria;797;862;763;831;366;322;331;282;35;40;9.5630000000000006;12.422000000000001;28;201;384;8;6;27;34;46.899999999999999;22.5;24.399999999999999;48.009999999999998;97;99;389;100;112;90;77;402;131;162;16;244;3230
6;141917;Meia Via;816;851;770;821;399;372;355;329;44;43;11.028;11.558999999999999;7;158;519;11;9;33;34;407.60000000000002;199.5;208.09999999999999;43.140000000000001;140;69;442;92;73;124;64;457;100;106;16;244;3232
6;142005;Moita do Norte;1016;1076;954;1060;463;414;425;371;38;43;8.2070000000000007;10.385999999999999;4;111;681;6;12;32;31;307.5;149.30000000000001;158.19999999999999;43.899999999999999;155;93;548;127;93;158;86;567;142;123;16;245;3245
6;142107;Formigais;177;198;170;190;82;55;80;46;2;9;2.4390000000000001;16.364000000000001;5;66;55;0;2;2;7;28.899999999999999;13.6;15.199999999999999;49.280000000000001;21;15;91;27;23;20;17;93;31;37;16;238;3148
6;142113;Seiça;968;1108;920;1081;469;391;443;349;26;42;5.5440000000000005;10.742000000000001;10;247;535;5;9;21;33;83.400000000000006;38.899999999999999;44.5;46.969999999999999;128;101;515;117;107;132;92;534;150;200;16;238;3157
6;150601;Alhos Vedros;7380;7670;6845;7421;3913;3620;3343;3040;570;580;14.567;16.021999999999998;69;1527;4787;101;116;469;464;840.39999999999998;412.10000000000002;428.30000000000001;39.549999999999997;1352;711;4258;619;440;1224;737;4329;700;680;17;251;3282
6;150604;Gaio-Rosário;620;607;579;581;294;270;257;240;37;30;12.585000000000001;11.111000000000001;8;106;383;6;2;31;28;138.69999999999999;70.099999999999994;68.599999999999994;41.049999999999997;118;56;349;58;39;97;63;337;51;59;17;251;3284
6;150804;Quinta do Anjo;5825;6040;5534;5858;3074;2804;2668;2428;406;376;13.208;13.409000000000001;66;1226;3804;72;64;334;312;232.09999999999999;113.90000000000001;118.09999999999999;40.090000000000003;1055;533;3296;557;384;1036;510;3383;592;519;17;253;3300
6;151103;Quinta do Conde;12536;13070;11857;12692;6958;6560;6211;5563;747;997;10.736000000000001;15.198;31;2373;9370;125;193;622;804;1808.0999999999999;885.20000000000005;922.89999999999998;36.359999999999999;2615;1370;7196;857;498;2469;1333;7626;907;735;17;256;3318
6;151201;Setúbal (Nossa Senhora da Anunciada);6441;7297;6108;7146;3079;2913;2590;2365;489;548;15.882;18.812000000000001;119;1245;3591;77;101;412;447;471;220.80000000000001;250.19999999999999;45.350000000000001;904;622;3488;821;606;903;670;3710;962;1052;17;257;3325
6;160105;Cabana Maior;96;143;92;139;29;21;21;18;8;3;27.585999999999999;14.286;10;14;15;1;1;7;2;17.800000000000001;7.2000000000000002;10.699999999999999;58.270000000000003;7;8;35;23;23;9;11;47;33;43;18;259;3337
6;160118;Loureda;86;109;75;95;29;17;28;16;1;1;3.448;5.8819999999999997;4;13;27;0;0;1;1;39.899999999999999;17.600000000000001;22.300000000000001;53.18;4;10;45;18;9;4;6;66;14;19;18;259;3352
6;160202;Arga de Baixo;28;46;26;44;12;8;11;8;1;0;8.3330000000000002;0;6;6;7;0;0;1;0;6.7999999999999998;2.6000000000000001;4.2000000000000002;60.960000000000001;1;3;12;5;7;1;3;14;13;15;18;260;3383
6;160407;Cambeses;216;280;205;271;119;104;112;94;7;10;5.8819999999999997;9.6150000000000002;13;67;126;0;3;7;7;123.5;53.799999999999997;69.700000000000003;44.140000000000001;27;22;126;24;17;35;31;145;29;40;18;262;3426
6;160415;Merufe;477;620;449;600;183;140;175;132;8;8;4.3719999999999999;5.7140000000000004;39;117;151;0;1;8;7;38.5;16.699999999999999;21.800000000000001;50.740000000000002;49;34;257;71;66;47;37;300;112;124;18;262;3435
6;160421;Pinheiros;156;189;150;182;70;59;66;54;4;5;5.7140000000000004;8.4749999999999996;9;40;71;1;1;3;4;161.80000000000001;73.200000000000003;88.599999999999994;46.439999999999998;23;13;85;22;13;21;13;95;31;29;18;262;3441
6;160428;Tangil;330;438;318;431;123;75;119;68;4;7;3.2519999999999998;9.3330000000000002;18;68;101;1;0;3;7;33.600000000000001;14.4;19.100000000000001;54.219999999999999;25;22;163;62;58;36;24;184;93;101;18;262;3448
6;160511;Insalde;167;197;164;196;71;55;58;49;13;6;18.309999999999999;10.909000000000001;12;43;52;1;3;12;3;27.399999999999999;12.6;14.800000000000001;49.630000000000003;23;13;88;24;19;17;13;95;26;46;18;263;3463
6;160519;Romarigães;108;138;107;141;44;46;37;38;7;8;15.909000000000001;17.390999999999998;7;31;37;2;1;5;7;34.5;15.1;19.399999999999999;48.119999999999997;12;12;57;13;14;13;13;57;25;30;18;263;3471
6;160605;Crasto;209;249;204;244;79;73;70;64;9;9;11.391999999999999;12.329000000000001;10;57;67;0;4;9;5;92.099999999999994;42;50.100000000000001;45.039999999999999;27;30;98;32;22;25;32;121;37;34;18;264;3478
6;160610;Grovelas;99;104;92;104;40;22;28;18;12;4;30;18.181999999999999;6;21;19;3;4;9;0;74.700000000000003;36.399999999999999;38.299999999999997;44.380000000000003;13;15;48;16;7;17;6;49;20;12;18;264;3483
6;160616;Ponte da Barca;1067;1304;1018;1269;536;562;473;495;63;67;11.754;11.922000000000001;11;230;727;19;19;44;48;2583.4000000000001;1162.5999999999999;1420.8;41.490000000000002;177;146;569;89;86;187;126;716;109;166;18;264;3489
6;160727;Gemieira;277;321;252;293;131;112;116;92;15;20;11.449999999999999;17.856999999999999;20;104;84;1;5;14;15;140.80000000000001;65.200000000000003;75.599999999999994;39.530000000000001;54;35;135;36;17;59;36;161;42;23;18;265;3525
6;160738;Rendufe;86;98;80;93;36;29;29;24;7;5;19.443999999999999;17.241;7;18;28;1;0;6;5;49.5;23.100000000000001;26.399999999999999;49.229999999999997;7;11;41;18;9;5;10;46;27;10;18;265;3538
6;160742;Santa Comba;319;339;288;322;167;140;159;115;8;25;4.79;17.856999999999999;3;91;180;1;6;7;19;438.89999999999998;212.80000000000001;226.09999999999999;38.880000000000003;56;42;178;27;16;55;47;180;27;30;18;265;3542
6;160805;Fontoura;362;389;356;384;157;119;145;107;12;12;7.6429999999999998;10.084;21;105;126;2;1;10;11;81.900000000000006;39.5;42.399999999999999;44.619999999999997;53;32;195;52;30;56;37;199;40;57;18;266;3554
6;160812;São Pedro da Torre;576;691;565;686;236;258;205;233;31;25;13.135999999999999;9.6899999999999995;7;156;275;4;7;27;18;162.59999999999999;73.900000000000006;88.700000000000003;46;71;65;296;83;61;90;63;328;102;108;18;266;3561
6;160813;Silva;130;130;127;128;67;49;58;45;9;4;13.433;8.1630000000000003;9;41;53;1;0;8;4;86.900000000000006;43.399999999999999;43.399999999999999;43.259999999999998;15;19;75;13;8;17;11;80;12;10;18;266;3562
6;160910;Castelo do Neiva;1385;1545;1310;1501;685;576;626;490;59;86;8.6129999999999995;14.931000000000001;108;520;488;9;10;50;76;421.89999999999998;199.40000000000001;222.5;42.850000000000001;228;154;755;148;100;213;142;808;213;169;18;267;3575
6;160915;Lanheses;762;883;739;867;375;332;330;289;45;43;12;12.952;17;213;389;8;14;37;29;171.40000000000001;79.400000000000006;92;46.039999999999999;100;81;415;76;90;85;86;449;126;137;18;267;3582
6;160918;Meixedo;203;264;199;261;97;74;88;64;9;10;9.2780000000000005;13.513999999999999;5;71;76;1;3;8;7;60.899999999999999;26.5;34.399999999999999;45.549999999999997;31;21;105;27;19;34;23;123;44;40;18;267;3585
6;170112;Sanfins do Douro;730;765;683;728;335;214;300;181;35;33;10.448;15.420999999999999;172;82;227;7;13;28;20;87.5;42.700000000000003;44.799999999999997;47.789999999999999;78;90;375;93;94;86;79;345;116;139;19;269;3632
6;170314;Lama de Arcos;146;170;146;167;46;30;42;25;4;5;8.6959999999999997;16.667000000000002;11;9;47;1;2;3;3;23.100000000000001;10.699999999999999;12.4;53.509999999999998;10;11;70;28;27;14;12;83;32;29;19;271;3668
6;170315;Loivos;261;292;258;287;118;68;101;56;17;12;14.407;17.646999999999998;10;68;79;2;1;15;11;47;22.199999999999999;24.800000000000001;47.799999999999997;24;28;140;29;40;40;26;142;43;41;19;271;3669
6;170326;Samaiões;634;684;608;676;310;249;246;188;64;61;20.645;24.498000000000001;11;99;324;14;21;50;40;150.59999999999999;72.5;78.200000000000003;46.75;60;66;358;89;61;72;73;352;88;99;19;271;3681
6;170328;Sanjurge;166;168;167;161;68;56;57;49;11;7;16.175999999999998;12.5;2;22;82;1;1;10;6;31.800000000000001;15.800000000000001;16;46.460000000000001;23;17;91;21;14;20;18;81;21;28;19;271;3683
6;170348;Vilela Seca;143;133;133;127;48;27;39;24;9;3;18.75;11.111000000000001;12;12;39;1;0;8;3;19.699999999999999;10.199999999999999;9.5;53.990000000000002;18;10;64;28;23;6;5;59;36;27;19;271;3706
6;170807;Peso da Régua;2469;2823;2268;2758;1314;1220;1122;1024;192;196;14.612;16.065999999999999;97;329;1720;37;57;155;139;909.5;424.30000000000001;485.10000000000002;41.420000000000002;385;320;1416;177;171;379;332;1537;244;331;19;276;3773
6;171202;Alvarelhos;59;78;79;106;24;10;23;10;1;0;4.1669999999999998;0;6;10;17;0;0;1;0;10.6;4.5999999999999996;6.0999999999999996;55.240000000000002;3;3;29;15;9;5;4;38;17;14;19;280;3812
6;171205;Bouçoães;189;230;213;260;17;11;16;8;1;3;5.8819999999999997;27.273;10;5;9;0;1;1;2;16.100000000000001;7.2999999999999998;8.9000000000000004;55.710000000000001;9;16;97;37;30;13;26;98;42;51;19;280;3814
6;171208;Curros;78;82;70;74;28;14;23;11;5;3;17.856999999999999;21.428999999999998;11;7;16;1;2;4;1;7.7000000000000002;3.7999999999999998;4;54.159999999999997;3;5;40;15;15;4;7;39;18;14;19;280;3817
6;171231;Vilarandelo;459;525;430;506;191;153;182;135;9;18;4.7119999999999997;11.765000000000001;45;54;218;4;4;5;14;48.799999999999997;22.800000000000001;26;50.770000000000003;59;36;223;70;71;42;49;231;86;117;19;280;3840
6;10112;Macinhata do Vouga;1634;1772;1578;1732;833;712;747;600;86;112;10.324;15.73;23;712;612;18;12;68;100;106.59999999999999;51.100000000000001;55.5;43.579999999999998;237;176;915;148;158;225;182;960;205;200;1;1;13
6;10202;Alquerubim;1142;1239;1122;1240;604;479;538;421;66;58;10.927;12.109;39;499;421;11;14;55;44;155;74.400000000000006;80.700000000000003;42.109999999999999;178;120;640;109;95;187;130;653;128;141;1;2;22
6;10416;Santa Eulália;1088;1165;1040;1136;586;468;548;415;38;53;6.4850000000000003;11.324999999999999;35;406;522;9;12;29;41;97.799999999999997;47.200000000000003;50.600000000000001;39.909999999999997;186;140;613;77;72;177;133;667;88;100;1;4;59
6;10504;Eixo;2669;2902;2489;2795;1475;1404;1314;1266;161;138;10.914999999999999;9.8290000000000006;25;952;1603;33;23;128;115;333.5;159.80000000000001;173.69999999999999;39.670000000000002;431;336;1533;223;146;468;286;1667;228;253;1;5;67
6;10601;Bairros;980;1067;907;1027;538;416;469;307;69;109;12.824999999999999;26.202000000000002;24;422;330;8;38;61;71;238.19999999999999;114.09999999999999;124.2;37.899999999999999;178;119;557;79;47;213;125;549;94;86;1;6;78
6;10604;Pedorido;712;746;678;725;355;261;306;195;49;66;13.803000000000001;25.286999999999999;2;301;198;8;13;41;53;120.5;58.799999999999997;61.700000000000003;42.049999999999997;114;92;404;61;41;107;85;379;84;91;1;6;81
6;10908;Fornos;1656;1741;1601;1690;936;864;847;777;89;87;9.5090000000000003;10.069000000000001;7;770;847;8;17;81;70;1083.0999999999999;528;555.10000000000002;38.229999999999997;320;157;989;108;82;279;177;1028;133;124;1;15;156
6;10921;Rio Meão;2378;2553;2309;2492;1326;1194;1168;947;158;247;11.916;20.687000000000001;20;1104;991;28;38;130;209;737.79999999999995;355.80000000000001;382;40.329999999999998;370;293;1403;188;124;394;251;1490;252;166;1;15;168
6;10928;Souto;2282;2414;2182;2337;1204;1033;1060;856;144;177;11.960000000000001;17.135000000000002;14;916;986;14;31;130;146;454.30000000000001;220.80000000000001;233.5;41.850000000000001;342;267;1321;213;139;322;275;1362;239;216;1;15;175
6;11001;Gafanha do Carmo;874;884;841;877;431;374;364;326;67;48;15.545;12.834;40;259;391;14;11;53;37;248.30000000000001;123.5;124.90000000000001;39.939999999999998;148;107;479;90;50;130;117;479;93;65;1;9;101
6;11308;Nogueira do Cravo;1357;1438;1314;1406;768;696;718;630;50;66;6.5099999999999998;9.4830000000000005;2;835;511;8;14;42;52;570.29999999999995;276.89999999999998;293.39999999999998;41.18;191;159;801;119;87;217;144;824;143;110;1;12;122
6;11316;Travanca;878;926;849;902;505;396;480;355;25;41;4.9500000000000002;10.353999999999999;10;460;365;2;10;23;31;311.30000000000001;151.5;159.80000000000001;40.950000000000003;126;111;515;74;52;116;128;510;95;77;1;12;131
6;11318;São Roque;2566;2662;2485;2584;1478;1325;1359;1214;119;111;8.0510000000000002;8.3770000000000007;8;1681;884;15;22;104;89;741.29999999999995;363.80000000000001;377.39999999999998;41.789999999999999;353;301;1505;248;159;340;318;1516;263;225;1;12;130
6;11402;Mamarrosa;654;752;649;749;301;258;274;222;27;36;8.9700000000000006;13.952999999999999;33;175;288;4;7;23;29;222.59999999999999;103.5;119.09999999999999;45.840000000000003;98;63;328;84;81;106;53;367;108;118;1;13;135
6;11706;Sever do Vouga;1299;1478;1217;1416;693;671;646;603;47;68;6.782;10.134;18;495;736;13;14;34;54;239.80000000000001;112.2;127.59999999999999;41.990000000000002;208;156;709;126;100;195;171;783;141;188;1;17;186
6;11801;Calvão;1011;1003;977;988;528;438;497;407;31;31;5.8710000000000004;7.0780000000000003;61;218;625;4;7;27;24;135.69999999999999;68.099999999999994;67.599999999999994;40.799999999999997;166;128;539;109;69;155;106;539;109;94;1;18;189
6;11907;Roge;850;902;811;887;435;339;414;309;21;30;4.8280000000000003;8.8499999999999996;15;440;268;1;10;20;20;99.599999999999994;48.299999999999997;51.299999999999997;45.109999999999999;99;80;493;99;79;109;94;475;121;103;1;19;205
6;20102;Ervidel;494;511;474;497;225;169;195;141;30;28;13.333;16.568000000000001;27;96;213;1;3;29;25;25.899999999999999;12.699999999999999;13.199999999999999;51.740000000000002;48;45;243;62;96;43;39;229;74;126;3;39;366
6;20501;Albernoa;366;392;346;379;155;140;140;125;15;15;9.6769999999999996;10.714;52;45;168;2;1;13;14;6.9000000000000004;3.2999999999999998;3.6000000000000001;50.759999999999998;39;30;177;40;80;49;28;163;50;102;3;43;381
6;20904;Mértola;1392;1432;1332;1396;692;566;626;489;66;77;9.5380000000000003;13.603999999999999;115;183;817;26;23;40;54;8.8000000000000007;4.2999999999999998;4.4000000000000004;47.490000000000002;143;167;747;150;185;133;131;719;182;267;3;47;417
6;20906;São João dos Caldeireiros;275;292;267;292;125;85;123;66;2;19;1.6000000000000001;22.353000000000002;34;48;107;0;3;2;16;5.5;2.7000000000000002;2.7999999999999998;51.130000000000003;26;25;138;37;49;22;23;125;56;66;3;47;419
6;21104;Santa Clara-a-Velha;310;292;311;288;113;69;104;51;9;18;7.9649999999999999;26.087;35;32;88;0;3;9;15;6;3.1000000000000001;2.8999999999999999;52.18;21;24;158;49;58;32;21;124;53;62;3;49;441
6;21108;Odemira (São Salvador);884;934;856;879;461;409;410;368;51;41;11.063000000000001;10.023999999999999;44;87;647;12;4;39;37;29.5;14.300000000000001;15.199999999999999;47;99;87;481;122;95;96;83;497;123;135;3;49;437
6;21202;Garvão;352;379;331;360;148;112;137;88;11;24;7.4320000000000004;21.428999999999998;34;54;137;4;7;7;17;16.5;8;8.5999999999999996;52.75;32;27;163;60;70;36;29;152;71;91;3;50;449
6;21302;Brinches;500;539;488;524;241;191;185;130;56;61;23.236999999999998;31.937000000000001;79;53;183;2;5;54;56;11.199999999999999;5.4000000000000004;5.7999999999999998;49.07;61;43;254;72;70;59;38;244;91;107;3;51;455
6;30111;Fiscal;337;381;323;380;172;124;158;103;14;21;8.1400000000000006;16.934999999999999;19;94;148;2;3;12;18;184.30000000000001;86.5;97.799999999999997;40.530000000000001;53;39;203;28;14;61;46;197;29;48;4;53;477
6;30118;Rendufe;555;569;542;561;305;235;263;201;42;34;13.77;14.468;19;161;284;5;5;37;29;367;181.19999999999999;185.80000000000001;38.240000000000002;105;84;301;39;26;86;71;322;35;55;4;53;484
6;30202;Aborim;426;465;397;453;225;204;194;181;31;23;13.778;11.275;9;201;165;3;5;28;18;144.19999999999999;68.900000000000006;75.200000000000003;40.149999999999999;66;51;248;33;28;66;62;258;39;40;4;54;490
6;30206;Aldreu;436;468;394;453;248;214;218;195;30;19;12.097;8.8789999999999996;10;227;176;5;2;25;17;188.5;90.900000000000006;97.599999999999994;38.579999999999998;79;46;252;31;28;76;51;270;39;32;4;54;494
6;30221;Carvalhos;341;350;316;337;181;163;159;139;22;24;12.154999999999999;14.724;22;189;87;5;4;17;20;197.69999999999999;97.599999999999994;100.2;38.369999999999997;60;46;194;24;17;60;41;200;26;23;4;54;513
6;30228;Cristelo;913;962;866;937;496;411;463;385;33;26;6.6530000000000005;6.3259999999999996;103;381;364;3;3;30;23;243;118.3;124.7;38.280000000000001;167;145;500;55;46;156;124;527;79;76;4;54;520
6;30234;Fornelos;410;393;373;371;218;184;196;166;22;18;10.092000000000001;9.7829999999999995;30;239;93;2;3;20;15;187.09999999999999;95.5;91.599999999999994;37.600000000000001;92;48;232;26;12;61;54;223;23;32;4;54;526
6;30248;Midões;209;253;197;249;119;121;104;91;15;30;12.605;24.792999999999999;7;109;79;1;4;14;26;181.80000000000001;82.200000000000003;99.5;39.369999999999997;36;23;124;12;14;35;41;134;18;25;4;54;542
6;30403;Arco de Baúlhe;829;840;779;818;424;311;367;237;57;74;13.443;23.794;22;163;419;20;18;37;56;371.60000000000002;184.59999999999999;187;39.710000000000001;149;121;446;55;58;120;99;463;83;75;4;56;711
6;30501;Agilde;617;610;589;595;295;206;244;160;51;46;17.288;22.329999999999998;23;207;174;6;11;45;35;136.19999999999999;68.5;67.700000000000003;39.909999999999997;114;84;333;42;44;94;72;329;58;57;4;57;726
6;30609;Gandra;651;672;619;658;356;320;327;271;29;49;8.1460000000000008;15.313000000000001;78;241;279;2;8;27;41;256.69999999999999;126.3;130.40000000000001;37.979999999999997;119;80;376;49;27;112;81;392;43;44;4;58;756
6;30718;Moreira do Rei;805;862;778;848;358;336;296;285;62;51;17.318000000000001;15.179;14;350;217;9;9;53;42;96.599999999999994;46.700000000000003;50;43.520000000000003;122;119;411;80;73;101;90;439;107;125;4;59;782
6;30819;Gominhães;260;251;257;250;149;131;128;111;21;20;14.093999999999999;15.266999999999999;7;147;85;1;3;20;17;237.30000000000001;120.8;116.59999999999999;37.200000000000003;53;30;151;13;13;41;28;146;19;17;4;55;631
6;30820;Gonça;526;525;496;508;308;251;255;217;53;34;17.207999999999998;13.545999999999999;18;301;153;7;8;46;26;149.59999999999999;74.900000000000006;74.700000000000003;37.810000000000002;90;75;316;26;19;83;57;307;37;41;4;55;632
6;30839;Rendufe;356;356;342;350;203;157;173;136;30;21;14.778;13.375999999999999;3;173;133;2;1;28;20;134.90000000000001;67.5;67.5;37.119999999999997;67;55;196;23;15;53;56;198;23;26;4;55;679
6;30843;Briteiros (Santa Leocádia);390;429;377;421;208;190;180;174;28;16;13.462;8.4209999999999994;15;239;100;1;3;27;13;162.09999999999999;77.200000000000003;84.900000000000006;36.75;76;61;206;28;19;91;50;221;30;37;4;55;599
6;30850;Selho (São Cristóvão);1170;1210;1125;1188;637;596;548;499;89;97;13.972;16.274999999999999;4;651;392;8;11;81;86;886.60000000000002;435.89999999999998;450.80000000000001;40.039999999999999;181;167;679;92;51;164;164;692;101;89;4;55;689
6;30855;Sande (São Lourenço);516;581;496;568;286;264;242;227;44;37;15.385;14.015000000000001;8;257;204;7;9;37;28;366.89999999999998;172.59999999999999;194.30000000000001;38.479999999999997;82;76;311;27;20;92;77;330;36;46;4;55;683
6;30911;Friande;113;128;111;125;46;31;41;29;5;2;10.869999999999999;6.452;7;40;23;0;0;5;2;48.200000000000003;22.600000000000001;25.600000000000001;44.109999999999999;17;8;57;17;14;21;16;53;23;15;4;60;809
6;30912;Galegos;269;274;255;274;124;105;105;80;19;25;15.323;23.809999999999999;2;80;103;4;6;15;19;184.5;91.400000000000006;93.099999999999994;40.630000000000003;43;41;145;23;17;41;32;146;32;23;4;60;810
6;31003;Campo do Gerês;81;81;83;80;34;24;30;21;4;3;11.765000000000001;12.5;2;10;39;1;1;3;2;2.3999999999999999;1.2;1.2;42.229999999999997;13;8;43;7;10;10;14;40;9;8;4;61;830
6;31012;Ribeira;113;129;109;125;52;44;43;31;9;13;17.308;29.545000000000002;5;18;51;1;2;8;11;107.8;50.299999999999997;57.5;42.899999999999999;21;11;57;15;9;15;11;72;17;14;4;61;839
6;31121;Vilar do Chão;113;143;99;135;52;41;47;33;5;8;9.6150000000000002;19.512;5;28;47;1;5;4;3;32.299999999999997;14.300000000000001;18;45.100000000000001;13;11;70;10;9;15;23;70;14;21;4;62;865
6;31218;Jesufrei;302;304;292;290;168;141;147;109;21;32;12.5;22.695;6;139;111;4;2;17;30;208.80000000000001;104.09999999999999;104.8;39.920000000000002;50;43;168;22;19;46;38;171;27;22;4;63;885
6;31247;Vermoim;1435;1495;1354;1466;772;704;676;575;96;129;12.435;18.324000000000002;13;641;597;11;21;85;108;621.5;304.39999999999998;317.10000000000002;39.450000000000003;241;185;826;110;73;224;172;843;144;112;4;63;912
6;31249;Vilarinho das Cambas;680;686;653;660;384;348;346;299;38;49;9.8960000000000008;14.08;25;333;287;6;5;32;44;162.40000000000001;80.900000000000006;81.599999999999994;37.090000000000003;137;92;390;35;26;116;83;407;46;34;4;63;914
6;31304;Atiães;239;281;223;275;111;99;99;85;12;14;10.811;14.141;15;81;88;0;1;12;13;128.80000000000001;59.200000000000003;69.599999999999994;42.57;52;31;114;16;26;40;29;137;28;47;4;64;918
6;31318;Goães;271;275;263;270;146;95;131;77;15;18;10.274000000000001;18.946999999999999;18;98;92;2;5;13;13;177;87.799999999999997;89.099999999999994;42.340000000000003;42;47;137;15;30;35;33;137;31;39;4;64;936
6;31344;Carreiras (Santiago);170;207;164;205;64;55;58;52;6;3;9.375;5.4550000000000001;0;67;43;1;1;5;2;154.80000000000001;69.799999999999997;85;43.859999999999999;34;22;78;20;16;28;20;104;27;28;4;64;923
6;31348;Carreiras (São Miguel);261;292;249;286;108;90;103;69;5;21;4.6299999999999999;23.332999999999998;3;92;77;0;7;5;14;280.89999999999998;132.59999999999999;148.30000000000001;40.130000000000003;54;37;123;28;19;46;40;148;31;27;4;64;924
6;31406;Vizela (Santo Adrião);1142;1138;1094;1107;641;571;548;494;93;77;14.509;13.484999999999999;5;748;289;9;15;84;62;757.10000000000002;379.19999999999999;377.89999999999998;36.960000000000001;213;174;651;57;47;184;177;638;69;70;4;65;978
6;40202;Aveleda;96;100;92;93;45;26;36;24;9;2;20;7.6920000000000002;15;25;20;0;1;9;1;3.2000000000000002;1.5;1.6000000000000001;57.340000000000003;2;10;50;20;14;5;5;43;28;19;5;67;1001
6;40219;Grijó de Parada;150;146;140;144;67;15;64;13;3;2;4.4779999999999998;13.333;23;31;23;0;2;3;0;9.5;4.7999999999999998;4.7000000000000002;51.030000000000001;9;15;78;29;19;8;20;67;24;27;5;67;1020
6;40308;Linhares;208;213;202;209;72;18;69;14;3;4;4.1669999999999998;22.222000000000001;43;16;24;1;2;2;2;14.699999999999999;7.2999999999999998;7.4000000000000004;55.729999999999997;12;18;84;44;50;13;15;93;50;42;5;68;1056
6;40309;Marzagão;146;169;105;123;62;49;60;44;2;5;3.226;10.204000000000001;22;18;64;0;1;2;4;19.399999999999999;9;10.4;47.090000000000003;20;17;78;17;14;16;17;87;24;25;5;68;1057
6;40312;Pereiros;118;117;121;115;37;13;32;10;5;3;13.513999999999999;23.077000000000002;16;8;18;1;0;4;3;16;8;8;53.43;5;13;58;24;18;9;11;43;30;24;5;68;1060
6;40403;Lagoaça;193;218;186;216;63;50;53;41;10;9;15.872999999999999;18;19;20;55;0;3;10;6;11.6;5.4000000000000004;6.0999999999999996;53.439999999999998;17;10;83;45;38;18;11;100;47;42;5;69;1070
6;40537;Vilarinho do Monte;34;33;34;33;6;2;6;2;0;0;0;0;5;1;2;0;0;0;0;9.4000000000000004;4.7999999999999998;4.5999999999999996;61.759999999999998;5;;11;10;8;;;10;15;8;5;70;1110
6;40703;Aguieiras;133;156;136;152;55;22;47;16;8;6;14.545;27.273;28;9;26;0;3;8;3;19.600000000000001;9;10.6;55.920000000000002;9;4;72;22;26;9;11;67;27;42;5;72;1131
6;40709;Cabanelas;185;201;174;196;69;53;58;46;11;7;15.942;13.208;31;20;53;1;3;10;4;20.699999999999999;9.9000000000000004;10.800000000000001;49.009999999999998;16;25;91;21;32;16;17;104;36;28;5;72;1137
6;40712;Cedães;161;177;156;173;64;46;56;34;8;12;12.5;26.087;15;26;49;0;2;8;10;13.300000000000001;6.2999999999999998;7;52.310000000000002;13;11;77;31;29;14;13;81;45;24;5;72;1140
6;40720;Mascarenhas;243;307;234;295;108;72;98;57;10;15;9.2590000000000003;20.832999999999998;40;32;83;1;4;9;11;19.600000000000001;8.5999999999999996;10.9;50.810000000000002;21;21;123;44;34;28;26;135;57;61;5;72;1148
6;41013;Seixo de Manhoses;220;249;217;250;91;55;86;46;5;9;5.4950000000000001;16.364000000000001;25;46;61;2;2;3;7;51.899999999999999;24.399999999999999;27.600000000000001;48.640000000000001;31;19;96;45;29;27;21;101;55;45;5;75;1223
6;50516;Toulões;113;124;108;123;18;10;18;10;0;0;0;0;7;6;15;0;0;0;0;6.5;3.1000000000000001;3.3999999999999999;66.329999999999998;1;2;46;25;39;2;1;44;32;45;6;82;1386
6;50601;Álvaro;110;127;103;119;32;22;28;20;4;2;12.5;9.0909999999999993;5;14;29;1;0;3;2;8.0999999999999996;3.7000000000000002;4.2999999999999998;60.590000000000003;6;5;45;30;24;5;3;43;33;43;6;83;1388
6;50707;Meimão;139;141;131;136;46;26;39;21;7;5;15.217000000000001;19.231000000000002;13;21;26;0;0;7;5;8.5;4.2000000000000002;4.2999999999999998;59.609999999999999;7;6;61;27;38;6;4;52;32;47;6;84;1406
6;50709;Pedrógão de São Pedro;243;257;236;248;89;70;85;65;4;5;4.4939999999999998;7.1429999999999998;9;49;92;0;3;4;2;23;11.199999999999999;11.800000000000001;55.950000000000003;21;21;105;43;53;11;18;91;68;69;6;84;1408
6;50711;Salvador;237;239;231;235;68;35;60;29;8;6;11.765000000000001;17.143000000000001;7;38;44;2;2;6;4;45.399999999999999;22.600000000000001;22.800000000000001;56.5;11;26;104;33;63;13;23;78;44;81;6;84;1410
6;50802;Montes da Senhora;335;413;319;407;120;89;104;77;16;12;13.333;13.483000000000001;17;49;115;0;1;16;11;20.399999999999999;9.0999999999999996;11.199999999999999;58.469999999999999;21;17;160;55;82;26;17;146;80;144;6;85;1413
6;60104;Benfeita;182;212;177;202;55;42;52;38;3;4;5.4550000000000001;9.5240000000000009;8;30;52;1;1;2;3;18.100000000000001;8.4000000000000004;9.6999999999999993;56.770000000000003;18;11;74;38;41;9;15;73;50;65;7;89;1442
6;60113;Pombeiro da Beira;478;532;449;516;213;145;189;129;24;16;11.268000000000001;11.034000000000001;40;118;160;3;2;21;14;30.899999999999999;14.6;16.300000000000001;49.700000000000003;50;46;248;67;67;60;42;239;72;119;7;89;1451
6;60118;Vila Cova de Alva;252;261;237;248;100;59;94;53;6;6;6;10.169;11;70;66;1;0;5;6;40.299999999999997;19.800000000000001;20.5;49.469999999999999;27;24;134;37;30;25;16;132;42;46;7;89;1456
6;60218;Sanguinheira;899;1002;850;977;425;346;402;308;23;38;5.4119999999999999;10.983000000000001;60;269;381;6;11;17;27;71.5;33.799999999999997;37.700000000000003;43.890000000000001;117;97;503;102;80;124;102;532;138;106;7;90;1471
6;60323;São Paulo de Frades;2744;3080;2612;2989;1442;1506;1250;1330;192;176;13.315;11.686999999999999;13;461;2106;41;39;151;137;389;183.30000000000001;205.69999999999999;41.329999999999998;414;336;1601;252;141;415;317;1785;307;256;7;91;1499
6;60328;Torre de Vilela;607;635;567;612;308;309;268;267;40;42;12.987;13.592000000000001;2;102;431;3;7;37;35;372.80000000000001;182.19999999999999;190.59999999999999;41.329999999999998;102;64;338;69;34;92;68;358;68;49;7;91;1503
6;60511;São Julião da Figueira da Foz;4329;5357;3961;5100;2096;2227;1797;1890;299;337;14.265000000000001;15.132;39;795;2853;54;68;245;269;2490.0999999999999;1112.9000000000001;1377.2;46.659999999999997;570;437;2345;491;486;557;470;2760;681;889;7;93;1531
6;60604;Góis;1034;1137;981;1088;475;431;446;398;29;33;6.1050000000000004;7.657;45;244;555;6;12;23;21;29.800000000000001;14.199999999999999;15.6;46.350000000000001;134;106;559;124;111;125;114;557;151;190;7;94;1538
6;60903;Rio Vide;383;430;371;410;195;161;176;147;19;14;9.7439999999999998;8.6959999999999997;15;58;250;1;5;18;9;72.299999999999997;34.100000000000001;38.200000000000003;46.229999999999997;49;38;213;49;34;52;36;220;57;65;7;97;1552
6;61013;Vila Nova da Barca;135;156;124;156;69;58;64;51;5;7;7.2460000000000004;12.069000000000001;12;26;77;1;0;4;7;24.100000000000001;11.199999999999999;12.9;47.229999999999997;14;10;76;17;18;16;18;77;21;24;7;98;1568
6;61104;Bobadela;371;388;344;373;189;172;172;149;17;23;8.9949999999999992;13.372;8;163;150;4;6;13;17;133.59999999999999;65.299999999999997;68.299999999999997;42.799999999999997;61;43;203;35;29;49;45;212;37;45;7;99;1572
6;61119;Travanca de Lagos;637;659;596;624;316;262;281;226;35;36;11.076000000000001;13.74;20;267;220;9;4;26;32;81.900000000000006;40.299999999999997;41.600000000000001;43.990000000000002;105;70;346;72;44;72;61;350;95;81;7;99;1587
6;61121;Vila Franca da Beira;227;238;212;236;82;61;77;55;5;6;6.0979999999999999;9.8360000000000003;2;65;65;2;2;3;4;66.299999999999997;32.299999999999997;33.899999999999999;49.939999999999998;30;24;102;30;41;27;15;93;55;48;7;99;1588
6;61304;Lorvão;1851;2047;1771;1998;922;930;850;861;72;69;7.8090000000000002;7.4189999999999996;22;461;1228;12;16;60;53;144.59999999999999;68.700000000000003;76;44.460000000000001;241;192;1065;206;147;249;179;1123;240;256;7;101;1603
6;61507;Pombalinho;386;421;382;420;141;117;126;102;15;15;10.638;12.821;10;116;102;0;3;15;12;32;15.300000000000001;16.699999999999999;53.159999999999997;36;27;190;64;69;31;26;185;92;87;7;103;1623
6;70104;Capelins (Santo António);246;281;239;272;98;68;83;60;15;8;15.305999999999999;11.765000000000001;41;34;68;0;2;15;6;6.0999999999999996;2.7999999999999998;3.2000000000000002;54.93;18;19;119;33;57;20;19;108;58;76;8;106;1649
6;70401;Arcos;557;595;542;604;266;236;230;215;36;21;13.534000000000001;8.8979999999999997;36;101;308;2;3;34;18;48.200000000000003;23.300000000000001;24.899999999999999;50.939999999999998;51;52;283;73;98;40;55;286;89;125;8;109;1665
6;70404;Évora Monte (Santa Maria);261;308;257;303;125;108;117;93;8;15;6.4000000000000004;13.888999999999999;41;53;116;0;3;8;12;5.7000000000000002;2.6000000000000001;3.1000000000000001;51.810000000000002;24;15;139;31;52;28;27;128;48;77;8;109;1668
6;30227;Creixomil;409;425;395;414;218;208;196;185;22;23;10.092000000000001;11.058;19;241;121;6;3;16;20;197.19999999999999;96.700000000000003;100.5;40.409999999999997;72;54;232;24;27;58;50;240;36;41;4;54;519
6;30272;Galegos (São Martinho);952;978;880;949;547;466;452;388;95;78;17.367000000000001;16.738;9;530;301;10;8;85;70;618.10000000000002;304.89999999999998;313.19999999999999;37.399999999999999;154;154;548;62;34;143;141;565;72;57;4;54;529
6;30275;Vila Frescainha (São Pedro);785;808;739;776;442;374;382;324;60;50;13.574999999999999;13.369;9;338;359;7;7;53;43;595.10000000000002;293.30000000000001;301.89999999999998;39.57;117;97;488;56;27;101;101;501;65;40;4;54;574
6;30279;Silva;453;460;427;442;247;213;226;196;21;17;8.5020000000000007;7.9809999999999999;4;251;167;6;3;15;14;418.89999999999998;207.80000000000001;211;41.57;59;75;246;45;28;54;59;266;38;43;4;54;562
6;30287;Vila Seca;557;640;533;610;297;282;271;253;26;29;8.7539999999999996;10.284000000000001;67;254;203;10;12;16;17;275.69999999999999;128.30000000000001;147.40000000000001;41.270000000000003;91;75;302;53;36;94;75;330;64;77;4;54;575
6;30308;Crespos;435;464;421;461;225;191;204;164;21;27;9.3330000000000002;14.135999999999999;11;149;208;1;2;20;25;238;115.2;122.90000000000001;39.93;82;51;239;34;29;79;57;242;41;45;4;55;613
6;30357;Tebosa;554;575;499;541;315;252;284;223;31;29;9.8409999999999993;11.507999999999999;3;279;225;6;6;25;23;436.5;214.19999999999999;222.30000000000001;39.579999999999998;88;64;330;47;25;95;72;318;43;47;4;55;702
6;30361;Vimieiro;624;609;604;602;350;319;317;278;33;41;9.4290000000000003;12.853;0;331;264;12;10;21;31;429.10000000000002;217.19999999999999;211.90000000000001;37.289999999999999;108;101;366;27;22;88;89;367;32;33;4;55;708
6;31008;Covide;171;172;167;168;69;54;66;42;3;12;4.3479999999999999;22.222000000000001;11;33;64;1;1;2;11;19;9.5;9.5;49.630000000000003;15;14;85;26;31;16;16;83;28;29;4;61;835
6;31307;Barros;166;169;156;162;79;45;62;39;17;6;21.518999999999998;13.333;8;40;53;2;0;15;6;87.799999999999997;43.5;44.299999999999997;42.880000000000003;22;26;85;15;18;26;15;85;17;26;4;64;921
6;31309;Cervães;963;1018;923;1003;492;367;442;306;50;61;10.163;16.620999999999999;23;370;355;9;14;41;47;181.90000000000001;88.400000000000006;93.5;40.880000000000003;157;125;520;100;61;144;123;541;115;95;4;64;925
6;31319;Godinhaços;168;212;156;205;79;49;65;37;14;12;17.722000000000001;24.489999999999998;13;43;46;2;4;12;8;57.5;25.399999999999999;32.100000000000001;47.420000000000002;20;19;81;21;27;23;25;97;35;32;4;64;937
6;31334;Penascais;120;135;120;132;50;34;50;31;0;3;0;8.8239999999999998;3;32;46;0;1;0;2;107.7;50.700000000000003;57;46.600000000000001;19;14;55;17;15;9;20;68;14;24;4;64;954
6;31340;Sabariz;211;232;203;227;107;96;101;88;6;8;5.6070000000000002;8.3330000000000002;3;59;127;0;2;6;6;214;101.90000000000001;112.09999999999999;38.93;45;23;117;11;15;41;23;125;17;26;4;64;961
6;30701;Aboim;165;190;154;186;64;52;55;41;9;11;14.063000000000001;21.154;6;58;32;0;2;9;9;30.899999999999999;14.4;16.600000000000001;41.920000000000002;38;16;79;14;18;23;20;84;37;26;4;59;763
6;30724;Revelhe;403;446;392;438;198;166;173;142;25;24;12.625999999999999;14.458;6;153;156;6;6;19;18;172.90000000000001;82.099999999999994;90.799999999999997;38.990000000000002;72;55;215;39;22;80;53;233;34;46;4;59;788
6;30726;Arões (Santa Cristina);747;791;737;780;391;374;362;331;29;43;7.4169999999999998;11.497;4;449;240;5;7;24;36;389.30000000000001;189.09999999999999;200.19999999999999;35.93;145;86;453;40;23;154;98;450;46;43;4;59;769
6;30736;Vinhós;309;333;294;312;173;152;139;125;34;27;19.652999999999999;17.763000000000002;4;123;137;11;3;23;24;223.09999999999999;107.40000000000001;115.7;42.020000000000003;46;37;186;25;15;30;42;195;29;37;4;59;798
6;30807;Brito;2468;2471;2356;2394;1318;1251;1175;1067;143;184;10.85;14.708;5;1304;933;25;35;118;149;836.70000000000005;418.10000000000002;418.60000000000002;36.619999999999997;496;338;1412;139;83;419;304;1472;155;121;4;55;601
6;30827;Longos;644;728;633;716;350;322;314;295;36;27;10.286;8.3849999999999998;22;392;195;4;3;32;24;189.59999999999999;89;100.59999999999999;38.630000000000003;105;104;360;36;39;126;98;394;44;66;4;55;647
6;30837;Polvoreira;1708;1787;1685;1770;946;865;829;706;117;159;12.368;18.382000000000001;6;917;612;21;25;96;134;1060.8;518.39999999999998;542.39999999999998;39.700000000000003;248;259;982;132;87;266;219;1037;155;110;4;55;672
6;160107;Carralcova;50;74;49;73;16;34;16;34;0;0;0;0;27;7;16;0;0;0;0;13.300000000000001;5.4000000000000004;7.9000000000000004;56.520000000000003;4;3;21;11;11;6;2;31;15;20;18;259;3339
6;160150;Vila Fonche;488;630;486;642;246;274;218;252;28;22;11.382;8.0289999999999999;5;104;361;7;7;21;15;419.60000000000002;183.09999999999999;236.40000000000001;39.219999999999999;89;65;262;34;38;113;74;335;44;64;18;259;3380
6;160205;Argela;186;207;173;195;94;54;88;41;6;13;6.383;24.074000000000002;7;45;77;2;2;4;11;36.399999999999999;17.199999999999999;19.199999999999999;45.159999999999997;23;23;97;24;19;24;23;96;31;33;18;260;3386
6;160213;Orbacém;92;121;87;113;52;40;46;32;6;8;11.538;20;1;30;47;1;0;5;8;38.299999999999997;16.600000000000001;21.800000000000001;48.079999999999998;8;12;54;14;4;10;12;57;18;24;18;260;3394
6;160309;Lamas de Mouro;48;69;46;62;19;13;17;12;2;1;10.526;7.6920000000000002;1;9;19;0;0;2;1;6.5999999999999996;2.7000000000000002;3.8999999999999999;54.159999999999997;2;4;23;12;7;2;5;36;16;10;18;261;3410
6;160310;Paços;145;172;137;165;49;31;47;27;2;4;4.0819999999999999;12.903;5;19;50;0;1;2;3;86.299999999999997;39.5;46.799999999999997;53.869999999999997;7;13;65;35;25;12;11;76;40;33;18;261;3411
6;160314;Prado;220;232;258;235;78;76;70;70;8;6;10.256;7.8949999999999996;5;22;113;1;1;7;5;172.30000000000001;83.900000000000006;88.400000000000006;51.560000000000002;31;20;103;36;30;11;14;124;33;50;18;261;3415
6;160315;Remoães;47;51;46;48;16;15;15;14;1;1;6.25;6.6669999999999998;3;8;18;0;0;1;1;93.900000000000006;45;48.899999999999999;50.68;4;4;19;12;8;5;5;27;7;7;18;261;3416
6;160316;Roussas;496;611;482;595;219;180;191;159;28;21;12.785;11.667;16;75;259;7;6;21;15;114.7;51.399999999999999;63.299999999999997;46.990000000000002;54;54;265;64;59;76;50;300;80;105;18;261;3417
6;160405;Barroças e Taias;157;162;157;160;63;44;60;39;3;5;4.7620000000000005;11.364000000000001;4;46;49;2;2;1;3;117.3;57.700000000000003;59.600000000000001;45.770000000000003;24;22;67;21;23;20;12;86;30;14;18;262;3424
6;160412;Lordelo;60;56;60;56;25;6;24;6;1;0;4;0;1;16;13;0;0;1;0;29.199999999999999;15.1;14.1;53.270000000000003;5;5;32;10;8;3;1;32;11;9;18;262;3432
6;160418;Moreira;277;338;270;333;124;105;113;92;11;13;8.8710000000000004;12.381;10;95;100;4;6;7;7;165;74.299999999999997;90.700000000000003;48.780000000000001;32;30;137;41;37;27;22;187;53;49;18;262;3438
6;160424;Riba de Mouro;372;592;344;569;134;92;126;84;8;8;5.9699999999999998;8.6959999999999997;31;82;97;3;1;5;7;68.599999999999994;26.5;42.200000000000003;51.799999999999997;35;39;189;64;45;46;43;282;106;115;18;262;3444
6;160431;Trute;113;164;115;159;51;46;50;45;1;1;1.9609999999999999;2.1739999999999999;7;44;44;0;1;1;0;46;18.800000000000001;27.300000000000001;47;14;14;61;17;7;16;17;76;26;29;18;262;3451
6;160505;Coura;173;201;174;199;62;63;56;57;6;6;9.6769999999999996;9.5240000000000009;10;39;64;1;1;5;5;56.799999999999997;26.300000000000001;30.5;52.299999999999997;15;9;85;36;28;22;12;88;36;43;18;263;3457
6;160509;Formariz;275;298;262;289;131;105;121;99;10;6;7.6340000000000003;5.7140000000000004;13;79;128;3;1;7;5;91.799999999999997;44.100000000000001;47.700000000000003;46.450000000000003;36;27;154;36;22;34;16;159;44;45;18;263;3461
6;160510;Infesta;212;238;210;239;94;78;87;68;7;10;7.4470000000000001;12.821;10;51;94;3;1;4;9;76.400000000000006;36;40.399999999999999;48.100000000000001;30;21;98;34;29;27;22;112;34;43;18;263;3462
6;160701;Anais;501;572;449;534;265;202;228;160;37;42;13.962;20.792000000000002;17;186;185;6;19;31;23;133.09999999999999;62.100000000000001;70.900000000000006;41.039999999999999;83;57;281;48;32;77;72;311;52;60;18;265;3499
6;160708;Bertiandos;190;224;182;221;101;90;86;78;15;12;14.850999999999999;13.333;6;63;95;5;2;10;10;182.59999999999999;83.799999999999997;98.799999999999997;41.890000000000001;31;20;110;19;10;30;17;128;30;19;18;265;3506
6;160715;Cepões;263;299;240;288;148;116;134;98;14;18;9.4589999999999996;15.516999999999999;7;96;129;6;5;8;13;130.09999999999999;60.899999999999999;69.200000000000003;42.490000000000002;33;39;145;22;24;38;37;156;32;36;18;265;3513
6;160717;Estorãos;224;240;214;236;77;49;67;41;10;8;12.987;16.327000000000002;6;34;68;0;3;10;5;28.600000000000001;13.800000000000001;14.800000000000001;50.719999999999999;36;24;92;38;34;19;9;111;49;52;18;265;3515
6;160719;Feitosa;676;687;639;675;380;350;360;314;20;36;5.2629999999999999;10.286;18;213;443;1;5;19;31;506;250.90000000000001;255;34.909999999999997;131;93;397;40;15;124;77;417;39;30;18;265;3517
6;160724;Friastelas;208;242;201;240;98;65;87;59;11;6;11.224;9.2309999999999999;11;77;58;0;1;11;5;114.8;53.100000000000001;61.700000000000003;41.159999999999997;34;29;107;23;15;41;34;112;26;29;18;265;3522
6;160725;Gaifar;118;148;115;145;53;40;50;32;3;8;5.6600000000000001;20;9;42;31;1;0;2;8;116.3;51.600000000000001;64.700000000000003;46.890000000000001;18;9;59;16;16;19;11;75;22;21;18;265;3523
6;160728;Gondufe;212;238;204;236;96;74;83;66;13;8;13.542;10.811;15;73;61;0;1;13;7;80.700000000000003;38;42.700000000000003;44.32;25;29;115;25;18;34;24;122;22;36;18;265;3526
6;160731;Mato;154;158;149;156;68;54;62;50;6;4;8.8239999999999998;7.407;6;50;56;2;3;4;1;120.90000000000001;59.700000000000003;61.200000000000003;43.509999999999998;22;20;77;24;11;21;17;79;23;18;18;265;3529
6;160733;Navió;118;113;113;111;61;31;52;28;9;3;14.754;9.6769999999999996;2;54;24;1;0;8;3;135.59999999999999;69.299999999999997;66.299999999999997;36.780000000000001;22;22;61;6;7;20;20;54;9;10;18;265;3531
6;160737;Refóios do Lima;1007;1162;993;1197;451;353;419;297;32;56;7.0949999999999998;15.864000000000001;42;340;334;11;14;21;42;131.90000000000001;61.200000000000003;70.700000000000003;44.420000000000002;168;108;512;111;108;142;112;571;167;170;18;265;3537
6;160747;Rebordões (Souto);550;577;519;571;284;194;261;163;23;31;8.0990000000000002;15.978999999999999;21;249;154;4;9;19;22;152.09999999999999;74.200000000000003;77.900000000000006;40.090000000000003;90;83;280;54;43;97;67;302;55;56;18;265;3536
6;160751;Vitorino dos Piães;710;827;645;791;353;271;313;230;40;41;11.331;15.129;13;320;210;9;10;31;31;129.19999999999999;59.700000000000003;69.5;39.18;112;116;366;65;51;152;108;406;75;86;18;265;3549
6;160803;Cerdal;816;877;802;863;362;324;312;280;50;44;13.811999999999999;13.58;35;221;336;4;7;46;37;90.200000000000003;43.5;46.700000000000003;43.990000000000002;138;70;441;82;85;111;77;469;104;116;18;266;3552
6;160808;Ganfei;618;678;593;658;295;274;266;239;29;35;9.8309999999999995;12.774000000000001;16;161;328;6;7;23;28;136.80000000000001;65.200000000000003;71.599999999999994;45.340000000000003;70;65;360;74;49;85;58;375;72;88;18;266;3557
6;160906;Barroselas;1874;2053;1778;1967;973;903;859;758;114;145;11.715999999999999;16.058;13;776;828;19;26;95;119;595.79999999999995;284.30000000000001;311.5;41.859999999999999;294;219;1060;157;144;278;219;1131;210;215;18;267;3571
6;160907;Cardielos;623;686;569;655;317;266;281;231;36;35;11.356;13.157999999999999;7;191;314;4;5;32;30;297.10000000000002;141.40000000000001;155.69999999999999;43.460000000000001;92;78;336;62;55;88;65;365;82;86;18;267;3572
6;160908;Carreço;830;929;767;876;409;365;370;321;39;44;9.5350000000000001;12.055;14;147;530;11;9;28;35;123.8;58.399999999999999;65.400000000000006;46.109999999999999;104;72;478;98;78;110;77;524;95;123;18;267;3573
6;160920;Montaria;232;317;218;310;112;100;100;93;12;7;10.714;7;36;46;111;4;3;8;4;24.5;10.300000000000001;14.1;51.460000000000001;17;27;124;30;34;29;17;150;60;61;18;267;3593
6;160922;Mujães;736;814;680;781;383;318;329;256;54;62;14.099;19.497;14;283;288;13;6;41;56;316.39999999999998;150.30000000000001;166.19999999999999;43.189999999999998;108;88;406;73;61;95;94;441;96;88;18;267;3587
6;160932;Serreleis;464;539;439;523;241;222;217;205;24;17;9.9589999999999996;7.6580000000000004;10;144;268;1;2;23;15;306.30000000000001;141.69999999999999;164.59999999999999;42.719999999999999;66;56;256;47;39;77;49;290;67;56;18;267;3595
6;160933;Subportela;563;616;524;591;273;232;247;208;26;24;9.5240000000000009;10.345000000000001;15;193;247;3;9;23;15;193.5;92.400000000000006;101.09999999999999;43.689999999999998;87;64;298;63;51;74;69;326;78;69;18;267;3596
6;160939;Vilar de Murteda;92;122;89;121;42;38;35;33;7;5;16.667000000000002;13.157999999999999;5;20;43;1;1;6;4;26.699999999999999;11.5;15.199999999999999;50.479999999999997;9;9;48;11;15;9;8;61;23;21;18;267;3605
6;160940;Chafé;1369;1472;1309;1429;767;692;673;578;94;114;12.256;16.474;43;528;680;14;18;80;96;361.89999999999998;174.40000000000001;187.5;38.460000000000001;246;154;800;97;72;225;174;834;126;113;18;267;3576
6;161007;Loivo;439;446;408;434;239;220;204;195;35;25;14.644;11.364000000000001;7;141;251;3;5;32;20;172;85.299999999999997;86.700000000000003;41.210000000000001;72;62;247;39;19;50;45;268;41;42;18;268;3612
6;161014;Vila Meã;184;162;183;164;102;75;102;71;0;4;0;5.3330000000000002;3;81;89;0;0;0;4;99.200000000000003;52.700000000000003;46.399999999999999;37.579999999999998;29;24;108;12;11;27;18;90;15;12;18;268;3619
6;161015;Vila Nova de Cerveira;658;774;632;746;317;337;286;301;31;36;9.7789999999999999;10.682;4;131;452;4;11;27;25;405.19999999999999;186.19999999999999;219;45.109999999999999;97;67;358;66;70;91;63;397;87;136;18;268;3620
6;30225;Courel;240;248;227;237;129;101;123;93;6;8;4.6509999999999998;7.9210000000000003;31;114;71;2;3;4;5;115;56.600000000000001;58.5;38.240000000000002;45;33;131;16;15;40;39;128;21;20;4;54;517
6;30231;Faria;269;281;266;273;151;131;136;116;15;15;9.9339999999999993;11.449999999999999;26;108;118;4;4;11;11;149.30000000000001;73;76.299999999999997;39.869999999999997;45;37;162;18;7;36;37;163;22;23;4;54;523
6;30235;Fragoso;1074;1119;985;1081;548;435;497;368;51;67;9.3070000000000004;15.401999999999999;30;474;361;9;10;42;57;174.19999999999999;85.299999999999997;88.900000000000006;37.840000000000003;198;145;602;84;45;198;133;610;98;80;4;54;527
6;30255;Palme;523;550;477;529;277;239;249;211;28;28;10.108000000000001;11.715;24;327;109;4;1;24;27;129.09999999999999;62.899999999999999;66.200000000000003;38.280000000000001;98;76;280;35;34;78;90;293;44;45;4;54;549
6;30263;Remelhe;627;682;594;666;374;325;337;290;37;35;9.8930000000000007;10.769;46;365;216;6;6;31;29;213.69999999999999;102.40000000000001;111.40000000000001;37.219999999999999;116;83;372;39;17;103;112;388;42;37;4;54;557
6;30271;Alvito (São Martinho);227;224;211;219;135;99;116;85;19;14;14.074;14.141;19;126;56;2;3;17;11;356.80000000000001;179.59999999999999;177.19999999999999;36.450000000000003;40;32;130;17;8;45;21;130;15;13;4;54;497
6;30273;Vila Frescainha (São Martinho);1109;1263;1054;1250;602;552;524;453;78;99;12.957000000000001;17.934999999999999;13;440;524;9;12;69;87;772.70000000000005;361.30000000000001;411.39999999999998;41.729999999999997;159;137;641;100;72;178;125;692;145;123;4;54;573
6;30277;Tamel (São Veríssimo);1448;1577;1371;1542;798;678;683;566;115;112;14.411;16.518999999999998;10;807;432;20;19;95;93;909.60000000000002;435.39999999999998;474.19999999999999;40.359999999999999;220;199;841;118;70;236;202;862;147;130;4;54;566
6;30302;Arcos;372;392;348;375;222;188;198;166;24;22;10.811;11.702;3;126;235;3;7;21;15;870;423.60000000000002;446.39999999999998;38.869999999999997;60;49;222;19;22;55;60;225;21;31;4;55;583
6;30314;Ferreiros;3726;3981;3561;3883;2142;2114;1902;1757;240;357;11.204000000000001;16.887;11;1427;2221;41;68;199;289;2988.3000000000002;1444.7;1543.5999999999999;36.280000000000001;718;430;2234;218;126;695;463;2405;240;178;4;55;623
6;30318;Gondizalves;706;735;665;712;386;343;347;297;39;46;10.103999999999999;13.411;0;224;420;6;9;33;37;859.20000000000005;421;438.30000000000001;40.020000000000003;103;92;419;66;26;106;99;426;54;50;4;55;634
6;30321;Lamaçães;1228;1297;1165;1247;740;734;677;648;63;86;8.5139999999999993;11.717000000000001;4;269;1052;19;18;44;68;1294.8;629.70000000000005;665.10000000000002;35.530000000000001;231;122;779;63;33;235;137;825;56;44;4;55;643
6;30329;Nogueiró;1618;2131;1586;2111;958;1074;886;965;72;109;7.516;10.148999999999999;7;298;1546;19;27;53;82;1357.9000000000001;586;771.79999999999995;37.609999999999999;325;206;983;68;36;318;219;1284;134;176;4;55;659
6;30335;Pousada;225;223;212;219;126;99;118;89;8;10;6.3490000000000002;10.101000000000001;7;57;143;4;4;4;6;125.8;63.200000000000003;62.600000000000001;41.280000000000001;25;53;113;24;10;25;34;116;20;28;4;55;674
6;30336;Priscos;654;687;624;672;369;322;334;281;35;41;9.4849999999999994;12.733000000000001;8;287;320;2;8;33;33;367.5;179.19999999999999;188.30000000000001;39.859999999999999;105;63;399;41;46;111;69;405;50;52;4;55;677
6;30349;Braga (São Vicente);6252;6984;5958;6729;3341;3594;2917;3026;424;568;12.691000000000001;15.804;14;1228;4701;89;135;335;433;5189.6999999999998;2451.4000000000001;2738.4000000000001;37.950000000000003;1199;796;3613;344;300;1079;750;4152;460;543;4;55;595
6;30355;Sobreposta;648;653;593;633;346;317;304;282;42;35;12.138999999999999;11.041;8;241;337;3;7;39;28;217.59999999999999;108.40000000000001;109.2;36.100000000000001;114;102;367;35;30;128;88;361;30;46;4;55;697
6;30601;Antas;1033;1188;994;1170;563;524;513;454;50;70;8.8810000000000002;13.359;32;462;473;9;2;41;68;245;113.90000000000001;131;41.350000000000001;150;144;582;85;72;175;124;644;123;122;4;58;748
6;30602;Apúlia;1985;2213;1893;2158;1078;1031;978;918;100;113;9.2759999999999998;10.960000000000001;269;738;889;18;26;82;87;398.80000000000001;188.59999999999999;210.19999999999999;38.539999999999999;367;247;1129;141;101;363;243;1262;188;157;4;58;749
6;30604;Curvos;382;429;338;400;218;179;205;148;13;31;5.9630000000000001;17.318000000000001;12;179;162;3;6;10;25;189.30000000000001;89.200000000000003;100.09999999999999;38.439999999999998;58;58;218;28;20;74;68;218;35;34;4;58;751
6;30605;Esposende;1702;1893;1650;1857;936;972;841;834;95;138;10.15;14.198;31;467;1177;22;26;73;112;2074.6999999999998;982.29999999999995;1092.5;38.950000000000003;286;203;1018;127;68;273;211;1126;151;132;4;58;752
6;30615;Vila Chã;678;741;604;721;364;291;336;248;28;43;7.6920000000000002;14.776999999999999;13;372;199;2;10;26;33;166.90000000000001;79.799999999999997;87.200000000000003;39.359999999999999;114;108;370;49;37;112;90;397;66;76;4;58;762
6;31007;Cibões;176;195;169;191;62;42;53;34;9;8;14.516;19.047999999999998;16;20;51;1;2;8;6;21.199999999999999;10;11.1;52.25;15;11;91;27;32;16;16;80;35;48;4;61;834
6;31017;Vilar da Veiga;610;676;640;711;271;191;236;134;35;57;12.914999999999999;29.843;7;118;245;8;2;27;55;16.5;7.7999999999999998;8.6999999999999993;43.659999999999997;86;75;338;48;63;86;75;359;57;99;4;61;843
6;31314;Duas Igrejas;588;703;533;675;262;184;241;150;21;34;8.0150000000000006;18.478000000000002;31;191;169;3;13;18;21;90.099999999999994;41;49;43.799999999999997;98;84;273;76;57;102;81;301;101;118;4;64;930
6;31324;Lanhas;289;292;283;290;150;120;137;89;13;31;8.6669999999999998;25.832999999999998;8;88;130;2;7;11;24;317.60000000000002;158;159.59999999999999;39.189999999999998;49;42;160;25;13;48;24;168;25;27;4;64;942
6;31325;Loureira;557;595;533;583;293;252;260;210;33;42;11.263;16.667000000000002;10;181;279;4;10;29;32;654.70000000000005;316.60000000000002;338.19999999999999;38.789999999999999;102;68;305;56;26;98;70;322;56;49;4;64;943
6;31335;Pico;291;319;288;317;142;120;117;99;25;21;17.606000000000002;17.5;9;75;132;6;7;19;14;217.69999999999999;103.90000000000001;113.90000000000001;40.600000000000001;43;41;152;25;30;52;46;151;35;35;4;64;956
6;31342;Vila de Prado;2164;2308;2029;2251;1173;1008;1034;837;139;171;11.85;16.963999999999999;24;730;1117;28;26;111;145;810.89999999999998;392.39999999999998;418.5;39.310000000000002;371;303;1237;151;102;348;297;1269;192;202;4;64;970
6;31349;Oriz (São Miguel);111;124;112;125;49;31;43;25;6;6;12.244999999999999;19.355;4;30;34;1;2;5;4;98.400000000000006;46.5;51.899999999999999;42.380000000000003;19;14;55;9;14;21;14;55;13;21;4;64;950
6;31352;Soutelo;990;1112;966;1116;564;469;514;390;50;79;8.8650000000000002;16.844000000000001;14;327;563;5;18;45;61;503.89999999999998;237.30000000000001;266.60000000000002;38.909999999999997;158;118;595;66;53;187;119;633;87;86;4;64;963
6;31356;Valões;91;104;85;102;27;21;26;18;1;3;3.7039999999999997;14.286;3;16;25;1;0;0;3;50.600000000000001;23.600000000000001;27;46.780000000000001;13;12;42;12;12;10;10;49;12;23;4;64;969
6;31358;Vilarinho;201;209;188;204;104;91;83;70;21;21;20.192;23.077000000000002;7;50;96;3;4;18;17;313.19999999999999;153.59999999999999;159.69999999999999;38.079999999999998;41;33;102;12;13;26;33;111;15;24;4;64;972
6;30706;Arnozela;112;153;107;149;56;38;54;36;2;2;3.5709999999999997;5.2629999999999999;9;52;29;0;0;2;2;72;30.399999999999999;41.600000000000001;44.68;13;20;59;11;9;17;19;75;16;26;4;59;768
6;30728;São Gens;798;905;764;871;388;378;331;316;57;62;14.691000000000001;16.402000000000001;14;349;284;4;8;53;54;115.09999999999999;53.899999999999999;61.200000000000003;41.850000000000001;136;90;425;75;72;125;108;487;104;81;4;59;790
6;30730;Arões (São Romão);1603;1692;1552;1659;862;768;778;678;84;90;9.7449999999999992;11.718999999999999;12;884;560;9;11;75;79;575.89999999999998;280.19999999999999;295.69999999999999;37.590000000000003;296;196;947;106;58;290;211;952;122;117;4;59;770
6;30731;Seidões;237;275;232;273;117;87;98;71;19;16;16.239000000000001;18.390999999999998;5;93;71;2;1;17;15;129.19999999999999;59.799999999999997;69.400000000000006;40.340000000000003;41;36;130;18;12;45;32;140;27;31;4;59;791
6;30815;Fermentões;2768;2939;2645;2860;1516;1490;1301;1237;215;253;14.182;16.98;4;1042;1492;46;51;169;202;1516.7;735.60000000000002;781.10000000000002;36.07;543;389;1596;153;87;511;374;1726;187;141;4;55;622
6;30822;Gondomar;238;257;241;258;104;89;86;73;18;16;17.308;17.978000000000002;2;102;55;3;3;15;13;109.90000000000001;52.799999999999997;57;41.710000000000001;40;30;125;25;18;32;32;141;30;22;4;55;635
6;30823;Guardizela;1206;1268;1175;1241;646;608;572;510;74;98;11.455;16.117999999999999;10;698;374;7;13;67;85;622.29999999999995;303.30000000000001;318.89999999999998;40.909999999999997;191;161;687;99;68;170;149;711;120;118;4;55;637
6;30826;Leitões;268;300;258;291;141;144;130;126;11;18;7.8010000000000002;12.5;7;137;112;7;4;4;14;157.30000000000001;74.200000000000003;83.099999999999994;38.310000000000002;53;38;148;15;14;48;43;160;23;26;4;55;645
6;30832;Nespereira;1282;1296;1255;1276;735;659;637;552;98;107;13.333;16.236999999999998;2;689;498;10;13;88;94;699;347.60000000000002;351.39999999999998;39.329999999999998;189;181;777;95;40;165;174;799;95;63;4;55;657
6;30854;Selho (São Jorge);2723;2902;2580;2806;1494;1473;1306;1242;188;231;12.584;15.682;13;1312;1223;33;27;155;204;1076.9000000000001;521.29999999999995;555.60000000000002;39.43;465;299;1631;189;139;435;319;1700;230;218;4;55;690
6;30858;Sande (São Martinho);1210;1323;1186;1298;625;590;542;511;83;79;13.279999999999999;13.390000000000001;6;600;447;17;7;66;72;766.60000000000002;366.19999999999999;400.39999999999998;39.579999999999998;201;179;682;86;62;190;165;763;103;102;4;55;684
6;30865;São Torcato;1643;1730;1586;1698;917;855;810;726;107;129;11.667999999999999;15.087999999999999;33;782;721;18;23;89;106;324.80000000000001;158.19999999999999;166.59999999999999;40.090000000000003;236;232;958;132;85;237;214;986;169;124;4;55;688
6;30871;Urgezes;2496;2763;2435;2703;1319;1323;1140;1100;179;223;13.571;16.856000000000002;17;884;1339;24;41;155;182;1586.5;753;833.5;41.299999999999997;391;325;1446;195;139;330;312;1589;272;260;4;55;705
6;30873;Sande (Vila Nova);834;905;806;882;444;407;389;360;55;47;12.387;11.548;9;429;311;18;17;37;30;729.29999999999995;349.69999999999999;379.5;39.710000000000001;122;120;508;43;41;118;141;504;80;62;4;55;685
6;30908;Ferreiros;203;213;205;217;111;82;99;70;12;12;10.811;14.634;14;88;67;0;6;12;6;82.5;40.200000000000003;42.200000000000003;39.810000000000002;34;33;105;15;16;36;23;115;16;23;4;60;806
6;30914;Geraz do Minho;258;263;259;262;130;108;122;90;8;18;6.1539999999999999;16.667000000000002;22;91;99;1;5;7;13;114.59999999999999;56.799999999999997;57.899999999999999;41.600000000000001;40;38;131;25;24;38;36;135;25;29;4;60;812
6;30916;Louredo;205;234;190;231;111;96;104;89;7;7;6.306;7.2919999999999998;3;128;62;2;2;5;5;243;113.5;129.5;37.280000000000001;46;29;111;9;10;41;33;122;15;23;4;60;814
6;30917;Monsul;363;410;359;405;192;158;170;124;22;34;11.458;21.518999999999998;18;143;133;8;13;14;21;234.59999999999999;110.2;124.5;41.170000000000002;55;46;202;34;26;58;53;220;35;44;4;60;815
6;30924;Serzedelo;335;388;332;389;145;108;128;87;17;21;11.724;19.443999999999999;3;101;111;3;8;14;13;75;34.700000000000003;40.200000000000003;43.899999999999999;50;46;170;32;37;45;52;183;42;66;4;60;822
6;31106;Cova;150;151;141;138;48;32;47;26;1;6;2.0830000000000002;18.75;3;20;50;0;3;1;3;68.900000000000006;34.299999999999997;34.600000000000001;47.25;25;13;68;15;29;21;15;62;18;35;4;62;850
6;31108;Guilhofrei;452;509;410;489;190;131;163;116;27;15;14.211;11.449999999999999;25;130;124;3;2;24;13;85.599999999999994;40.200000000000003;45.299999999999997;43.640000000000001;74;56;227;57;38;64;64;259;69;53;4;62;852
6;31111;Parada do Bouro;246;223;228;221;91;52;76;38;15;14;16.484000000000002;26.923000000000002;3;41;70;2;2;13;12;60.799999999999997;31.899999999999999;28.899999999999999;45.490000000000002;37;32;120;25;32;23;18;123;30;29;4;62;855
6;31118;Tabuaças;446;473;439;466;226;181;190;141;36;40;15.929;22.099;9;98;224;10;7;26;33;92.900000000000006;45.100000000000001;47.799999999999997;39.810000000000002;73;51;256;34;32;78;56;262;37;40;4;62;862
6;31119;Ventosa;170;188;156;186;79;49;72;37;7;12;8.8610000000000007;24.489999999999998;5;39;65;1;3;6;9;82.599999999999994;39.200000000000003;43.399999999999999;43.670000000000002;29;21;89;13;18;24;23;96;17;28;4;62;863
6;31120;Vieira do Minho;1068;1171;1025;1139;486;444;410;379;76;65;15.638;14.640000000000001;12;176;601;13;12;63;53;311.60000000000002;148.59999999999999;163;39.869999999999997;196;167;556;73;76;179;131;625;96;140;4;62;864
6;31203;Avidos;855;887;808;848;459;428;387;344;72;84;15.686;19.626000000000001;3;343;385;8;8;64;76;621.89999999999998;305.19999999999999;316.69999999999999;39.549999999999997;142;99;499;62;53;137;98;509;69;74;4;63;870
6;31205;Bente;459;466;453;464;234;194;206;167;28;27;11.965999999999999;13.917999999999999;16;214;143;3;5;25;22;676.20000000000005;335.5;340.69999999999999;39.380000000000003;81;63;245;47;23;72;51;261;58;24;4;63;872
6;31207;Cabeçudos;746;720;714;706;406;365;352;317;54;48;13.300000000000001;13.151;3;409;257;4;7;50;41;443;225.5;217.59999999999999;38.530000000000001;131;98;426;59;32;97;81;440;62;40;4;63;874
6;31208;Calendário;5566;6101;5303;5934;3022;2953;2654;2434;368;519;12.177;17.574999999999999;19;2135;2934;63;76;305;443;1731.8;826.20000000000005;905.60000000000002;38.520000000000003;968;680;3290;391;237;967;689;3606;459;380;4;63;875
6;31209;Carreira;799;863;770;840;423;391;346;312;77;79;18.202999999999999;20.204999999999998;7;395;256;10;10;67;69;751.79999999999995;361.39999999999998;390.39999999999998;42.640000000000001;117;93;474;69;46;97;106;488;87;85;4;63;876
6;31244;Seide (São Paio);177;194;181;193;97;89;88;75;9;14;9.2780000000000005;15.73;3;69;91;2;1;7;13;274.10000000000002;130.80000000000001;143.30000000000001;39.329999999999998;25;22;108;12;10;42;20;98;18;16;4;63;907
6;31246;Telhado;869;915;824;900;481;449;415;366;66;83;13.721;18.486000000000001;9;516;256;8;6;58;77;377.69999999999999;184;193.69999999999999;38.920000000000002;150;118;499;63;39;141;109;522;78;65;4;63;909
6;31407;Vizela (São Paio);762;741;736;723;464;390;422;347;42;43;9.0519999999999996;11.026;10;508;251;6;6;36;37;606.5;307.5;299;34;150;124;431;36;21;149;111;412;45;24;4;65;979
6;131407;Carreira;526;584;512;566;300;288;259;228;41;60;13.667;20.832999999999998;4;192;291;8;6;33;54;371.69999999999999;176.09999999999999;195.59999999999999;40.880000000000003;73;51;329;50;23;91;66;325;48;54;15;220;2971
6;131413;Monte Córdova;1957;2001;1877;1955;1105;972;963;770;142;202;12.850999999999999;20.782;19;979;735;19;17;123;185;235.59999999999999;116.5;119.09999999999999;38.979999999999997;335;251;1128;138;105;314;241;1146;161;139;15;220;2977
6;131424;Negrelos (São Mamede);1058;1087;1023;1078;562;534;460;442;102;92;18.149000000000001;17.228000000000002;5;657;240;8;13;94;79;384.39999999999998;189.59999999999999;194.80000000000001;39.340000000000003;162;161;611;77;47;154;153;622;81;77;15;220;2978
6;131804;Coronado (São Mamede);2106;2186;2010;2139;1191;1019;1037;789;154;230;12.93;22.571000000000002;44;815;967;19;29;135;201;548.60000000000002;269.19999999999999;279.39999999999998;38.710000000000001;367;271;1218;168;82;332;255;1283;174;142;15;221;2992
6;130404;Jovim;3546;3600;3411;3550;1955;1610;1635;1327;320;283;16.367999999999999;17.577999999999999;15;860;2087;44;50;276;233;997.5;495;502.5;40.119999999999997;581;408;2123;274;160;513;420;2124;295;248;15;210;2770
6;130405;Lomba;730;775;710;747;359;238;318;162;41;76;11.420999999999999;31.933;11;264;205;6;20;35;56;109.90000000000001;53.299999999999997;56.600000000000001;43.25;105;84;407;67;67;111;98;385;78;103;15;210;2771
6;130407;Melres;1872;1819;1778;1801;1012;680;855;565;157;115;15.513999999999999;16.911999999999999;11;541;868;29;24;128;91;212.90000000000001;108;104.90000000000001;39.509999999999998;297;264;1094;133;84;271;214;1057;152;125;15;210;2773
6;130410;São Pedro da Cova;8155;8323;7823;8150;4212;3437;3247;2629;965;808;22.911000000000001;23.509;25;2099;3752;129;119;836;689;1186.3;587.10000000000002;599.20000000000005;39.93;1314;1077;4731;689;344;1204;997;4793;782;547;15;210;2775
6;130616;Vila Nova da Telha;2839;3047;2688;2937;1578;1460;1418;1257;160;203;10.138999999999999;13.904;22;648;2005;32;35;128;168;990.39999999999998;477.69999999999999;512.70000000000005;39.93;486;320;1662;248;123;472;302;1798;259;216;15;212;2818
6;130807;Perafita;6571;7036;6244;6909;3532;3193;2958;2570;574;623;16.251000000000001;19.510999999999999;35;1533;3960;93;118;481;505;1573.8;760;813.79999999999995;40.25;1066;767;3848;581;309;1020;798;4103;648;467;15;214;2856
6;131206;Lordelo do Ouro;10337;11933;10158;11910;5040;5106;4159;4268;881;838;17.48;16.411999999999999;31;1240;7156;204;188;677;650;6114.6999999999998;2838.1999999999998;3276.4000000000001;42.700000000000003;1584;1295;5695;976;787;1584;1273;6457;1274;1345;15;218;2943
6;131210;Paranhos;20045;24253;21748;26052;9680;10444;7910;8753;1770;1691;18.285;16.190999999999999;35;2391;14237;350;338;1420;1353;6179.8999999999996;2796.4000000000001;3383.5;45.369999999999997;2510;2352;11178;2188;1817;2256;2293;13213;3088;3403;15;218;2947
6;131505;Valongo;11486;12439;10786;12003;6587;6442;5715;5220;872;1222;13.238;18.969000000000001;29;2786;8120;140;199;732;1023;992.79999999999995;476.60000000000002;516.20000000000005;36.030000000000001;2269;1265;6927;659;366;2207;1348;7538;770;576;15;222;3001
6;131615;Malta;686;699;647;692;405;357;357;295;48;62;11.852;17.367000000000001;16;328;308;10;8;38;54;651.79999999999995;322.89999999999998;329;38.979999999999997;115;76;422;47;26;100;84;409;61;45;15;223;3016
6;131616;Mindelo;1646;1845;1535;1785;920;852;805;701;115;151;12.5;17.722999999999999;58;468;980;20;19;95;132;608.29999999999995;286.80000000000001;321.5;41.18;236;170;977;163;100;288;177;1063;172;145;15;223;3017
6;131619;Outeiro Maior;179;190;168;181;104;95;99;84;5;11;4.8079999999999998;11.579000000000001;38;85;60;0;2;5;9;77.400000000000006;37.600000000000001;39.899999999999999;38.990000000000002;33;20;99;11;16;33;24;98;22;13;15;223;3020
6;131629;Vilar;801;837;757;818;416;357;373;303;43;54;10.337;15.125999999999999;30;323;323;5;8;38;46;382.60000000000002;187.09999999999999;195.5;43.380000000000003;110;87;459;86;59;97;91;455;101;93;15;223;3031
6;131715;Sandim;2866;3072;2857;3042;1547;1180;1312;930;235;250;15.191000000000001;21.186;9;940;1293;33;35;202;215;437.89999999999998;211.40000000000001;226.59999999999999;40.670000000000002;462;359;1621;275;149;461;361;1674;338;238;15;224;3046
6;10602;Fornos;666;773;588;743;319;241;278;183;41;58;12.853;24.065999999999999;9;225;227;2;11;39;47;350.10000000000002;162;188.09999999999999;41.450000000000003;90;87;385;63;41;121;87;413;85;67;1;6;79
6;10607;Santa Maria de Sardoura;1257;1281;1134;1233;687;403;614;327;73;76;10.625999999999999;18.859000000000002;20;592;329;8;27;65;49;252.19999999999999;124.90000000000001;127.3;39.579999999999998;202;169;738;74;74;187;149;713;121;111;1;6;84
6;30409;Gondiães;104;123;99;119;41;30;36;26;5;4;12.195;13.333;15;13;34;1;3;4;1;10.6;4.9000000000000004;5.7000000000000002;52.020000000000003;5;10;43;20;26;11;21;47;23;21;4;56;717
6;30505;Caçarilhe;229;237;223;231;114;83;98;35;16;48;14.035;57.831000000000003;15;78;40;2;38;14;10;78.400000000000006;38.5;39.899999999999999;42.829999999999998;27;28;135;18;21;28;29;128;32;20;4;57;732
6;30516;Ourilhe;220;239;202;227;105;58;98;50;7;8;6.6669999999999998;13.792999999999999;13;67;68;3;6;4;2;85.5;41;44.5;38.490000000000002;38;32;116;16;18;45;33;118;24;19;4;57;743
6;130118;Jazente;266;276;257;265;133;94;122;81;11;13;8.2710000000000008;13.83;14;72;117;1;4;10;9;161.59999999999999;79.299999999999997;82.299999999999997;45.43;36;35;144;26;25;21;26;159;32;38;15;207;2694
6;130120;Louredo;314;324;289;317;169;133;157;103;12;30;7.101;22.556000000000001;4;143;113;1;5;11;25;177.30000000000001;87.299999999999997;90.099999999999994;38.460000000000001;55;42;174;26;17;51;54;169;34;16;15;207;2696
6;130127;Real;1528;1614;1381;1567;833;566;750;421;83;145;9.9640000000000004;25.617999999999999;29;616;526;18;44;65;101;491.30000000000001;239;252.40000000000001;40.200000000000003;247;230;846;127;78;228;197;907;144;138;15;207;2703
6;130131;Figueiró (Santa Cristina);667;703;633;691;326;252;295;194;31;58;9.5090000000000003;23.015999999999998;12;319;158;2;9;29;49;321;156.30000000000001;164.69999999999999;37.920000000000002;135;92;344;53;43;121;92;386;66;38;15;207;2685
6;130132;Figueiró (Santiago);1173;1285;1130;1257;606;503;533;400;73;103;12.045999999999999;20.477;10;490;433;11;41;62;62;639;305;334.10000000000002;40.350000000000001;203;160;657;84;69;171;160;721;120;113;15;207;2686
6;130134;Gouveia (São Simão);315;318;297;312;138;88;116;66;22;22;15.942;25;18;60;104;4;16;18;6;50.700000000000003;25.199999999999999;25.5;42.490000000000002;41;47;167;26;34;46;38;171;26;37;15;207;2693
6;130135;Telões;2042;2190;1926;2131;1096;870;955;687;141;183;12.865;21.033999999999999;64;765;813;12;40;129;143;291.80000000000001;140.80000000000001;151;39.479999999999997;355;261;1131;166;129;356;281;1196;190;167;15;207;2707
6;130203;São Tomé de Covelas;287;289;247;279;143;67;132;45;11;22;7.6920000000000002;32.835999999999999;8;104;65;1;11;10;11;97.700000000000003;48.700000000000003;49;39.939999999999998;45;57;155;15;15;37;36;157;27;32;15;208;2727
6;130205;Gestaçô;600;663;533;627;305;186;271;121;34;65;11.148;34.945999999999998;46;164;182;1;23;33;42;87.5;41.600000000000001;46;43.600000000000001;83;76;324;65;52;87;80;331;70;95;15;208;2717
6;130208;Loivos do Monte;173;200;150;196;67;18;67;17;0;1;0;5.556;5;55;24;0;1;0;0;42.600000000000001;19.800000000000001;22.899999999999999;41.119999999999997;39;20;86;15;13;34;18;103;21;24;15;208;2721
6;130210;Mesquinhata;142;159;129;153;66;45;54;26;12;19;18.181999999999999;42.222000000000001;1;45;34;0;12;12;7;87.5;41.299999999999997;46.200000000000003;41.770000000000003;21;26;70;10;15;20;25;76;22;16;15;208;2722
6;130306;Idães;1198;1298;1209;1334;676;666;637;621;39;45;5.7690000000000001;6.7569999999999997;33;900;325;7;14;32;31;351;168.5;182.5;35.630000000000003;244;169;683;65;37;235;196;720;73;74;15;209;2738
6;130325;Sernande;461;480;448;471;258;238;242;218;16;20;6.202;8.4030000000000005;7;339;114;2;5;14;15;696.39999999999998;341.19999999999999;355.19999999999999;35.32;105;67;248;28;13;87;66;266;32;29;15;209;2755
6;130333;Vila Verde;380;429;345;416;218;181;206;145;12;36;5.5049999999999999;19.890000000000001;2;192;157;1;7;11;29;648.5;304.60000000000002;343.89999999999998;37.670000000000002;61;58;220;28;13;83;49;240;32;25;15;209;2763
6;130506;Cernadelo;474;506;430;486;253;211;224;194;29;17;11.462;8.0570000000000004;14;272;132;2;2;27;15;487.69999999999999;235.90000000000001;251.80000000000001;35.93;107;65;250;32;20;87;76;285;28;30;15;211;2783
6;130508;Cristelos;1484;1556;1395;1518;822;752;715;639;107;113;13.016999999999999;15.026999999999999;17;577;760;13;23;94;90;1042.3;508.80000000000001;533.5;37.25;276;214;854;88;52;237;195;930;113;81;15;211;2785
6;130512;Macieira;634;710;585;691;341;304;291;266;50;38;14.663;12.5;7;301;249;3;5;47;33;868.5;409.69999999999999;458.80000000000001;37.530000000000001;118;89;352;49;26;116;103;395;56;40;15;211;2791
6;130517;Ordem;580;621;562;610;334;283;295;244;39;39;11.677;13.781000000000001;4;308;227;9;13;30;26;297.89999999999998;143.90000000000001;154.09999999999999;37.710000000000001;97;86;331;51;15;108;88;340;53;32;15;211;2796
6;130526;Vilar do Torno e Alentém;643;699;595;689;359;288;332;252;27;36;7.5209999999999999;12.5;5;329;250;5;10;22;26;355.5;170.40000000000001;185.19999999999999;38.18;104;96;379;39;25;110;82;404;63;40;15;211;2801
6;130706;Favões;587;647;500;606;324;214;274;165;50;49;15.432;22.896999999999998;6;238;195;8;12;42;37;419.89999999999998;199.80000000000001;220.19999999999999;36.409999999999997;117;79;332;33;26;132;86;342;47;40;15;213;2824
6;130708;Fornos;1753;1861;1568;1826;930;809;826;639;104;170;11.183;21.013999999999999;4;453;1008;14;44;90;126;1062.5999999999999;515.39999999999998;547.20000000000005;38.219999999999999;335;211;1018;110;79;297;201;1094;124;145;15;213;2826
6;130713;Paços de Gaiolo;488;507;422;488;252;97;228;69;24;28;9.5240000000000009;28.866;10;201;86;4;15;20;13;135.30000000000001;66.299999999999997;68.900000000000006;40.109999999999999;80;73;263;45;27;85;49;277;49;47;15;213;2831
6;130720;São Lourenço do Douro;486;501;420;487;254;147;228;113;26;34;10.236000000000001;23.129000000000001;12;232;97;6;14;20;20;242;119.2;122.8;37.670000000000002;89;68;264;38;27;90;69;264;35;43;15;213;2838
6;130725;Torrão;387;420;360;414;198;152;170;110;28;42;14.141;27.632000000000001;3;159;118;2;10;26;32;539.39999999999998;258.69999999999999;280.69999999999999;40.859999999999999;60;47;221;43;16;67;45;224;47;37;15;213;2843
6;130730;Vila Boa do Bispo;1540;1700;1349;1637;801;541;682;398;119;143;14.856;26.433;19;585;476;15;38;104;105;259.5;123.40000000000001;136.19999999999999;37.409999999999997;335;209;831;93;72;310;216;877;122;175;15;213;2849
6;130901;Arreigada;1002;997;939;982;547;413;448;295;99;118;18.099;28.571000000000002;4;450;289;13;24;86;94;1150.5999999999999;576.70000000000005;573.79999999999995;36.57;205;155;554;57;31;166;130;578;71;52;15;215;2860
6;130908;Freamunde;3821;3968;3665;3868;2166;1875;1824;1602;342;273;15.789;14.56;5;1863;1558;66;52;276;221;1511.9000000000001;741.70000000000005;770.20000000000005;37.609999999999999;693;551;2186;243;148;672;492;2250;284;270;15;215;2867
6;130914;Raimonda;1253;1323;1213;1301;739;649;630;560;109;89;14.75;13.712999999999999;4;777;409;13;15;96;74;765.20000000000005;372.19999999999999;393;37.280000000000001;238;158;735;78;44;208;187;757;99;72;15;215;2873
6;130915;Sanfins de Ferreira;1513;1626;1456;1601;875;730;749;606;126;124;14.4;16.986000000000001;8;954;393;39;36;87;88;521.5;251.40000000000001;270.19999999999999;35.32;285;217;877;89;45;354;221;886;88;77;15;215;2874
6;131004;Beire;995;1045;1134;1205;530;458;468;401;62;57;11.698;12.445;23;444;402;11;14;51;43;616.5;300.69999999999999;315.80000000000001;37.859999999999999;190;130;555;63;57;169;144;594;72;66;15;216;2879
6;131014;Louredo;747;767;740;766;379;330;323;271;56;59;14.776;17.879000000000001;3;321;270;14;13;42;46;523.39999999999998;258.19999999999999;265.10000000000002;37.009999999999998;148;96;420;45;38;143;95;423;55;51;15;216;2889
6;131022;Vandoma;1185;1178;1106;1146;694;508;596;391;98;117;14.121;23.030999999999999;14;519;454;12;19;86;98;461.10000000000002;231.19999999999999;229.90000000000001;35.140000000000001;252;149;696;49;39;234;133;700;56;55;15;216;2897
6;131105;Canelas;825;824;760;813;451;242;394;177;57;65;12.638999999999999;26.859999999999999;14;295;262;5;21;52;44;140.09999999999999;70.099999999999994;70;38.020000000000003;133;115;481;48;48;154;105;451;54;60;15;217;2904
6;131112;Fonte Arcada;784;822;745;806;424;317;396;266;28;51;6.6040000000000001;16.088000000000001;7;303;352;6;9;22;42;327.5;159.90000000000001;167.59999999999999;37.579999999999998;148;117;436;40;43;140;115;451;51;65;15;217;2911
6;131118;Marecos;542;526;523;523;295;245;269;219;26;26;8.8140000000000001;10.612;12;210;266;2;12;24;14;259.69999999999999;131.80000000000001;127.90000000000001;38.079999999999998;107;72;301;35;27;76;62;312;46;30;15;217;2917
6;131127;Portela;623;643;559;641;303;197;277;154;26;43;8.5809999999999995;21.826999999999998;3;258;170;3;10;23;33;320.5;157.69999999999999;162.80000000000001;36.719999999999999;153;78;331;36;25;109;88;348;58;40;15;217;2926
6;131128;Rans;944;963;867;949;529;437;482;372;47;65;8.8849999999999998;14.874000000000001;15;533;306;8;15;39;50;632.60000000000002;313.19999999999999;319.5;34.590000000000003;209;136;524;39;36;186;137;544;51;45;15;217;2927
6;170503;Campanhó;126;142;111;136;50;11;41;8;9;3;18;27.273;14;20;15;0;0;9;3;19.600000000000001;9.1999999999999993;10.4;49.369999999999997;11;12;69;22;12;16;13;68;20;25;19;273;3716
6;170902;Canedo;194;196;167;181;57;39;49;24;8;15;14.035;38.462000000000003;20;19;34;1;2;7;13;10.800000000000001;5.4000000000000004;5.4000000000000004;53.729999999999997;14;19;86;34;41;11;18;87;35;45;19;277;3779
6;180404;Espadanedo;642;676;578;657;314;159;284;117;30;42;9.5540000000000003;26.414999999999999;7;229;165;0;26;30;16;248.5;121;127.5;40.299999999999997;112;87;354;49;40;91;86;365;79;55;20;286;3940
6;180407;Gralheira;82;83;79;78;36;24;28;20;8;4;22.222000000000001;16.667000000000002;13;11;24;0;0;8;4;16.199999999999999;8.0999999999999996;8.1999999999999993;46.810000000000002;10;7;47;6;12;9;9;46;7;12;20;286;3943
6;180411;Ramires;56;63;53;60;18;12;7;6;11;6;61.110999999999997;50;5;5;3;3;5;8;1;12.800000000000001;6;6.7999999999999998;52.079999999999998;6;8;21;15;6;2;7;29;13;12;20;286;3947
6;10409;Escariz;1082;1140;1008;1095;582;463;535;433;47;30;8.0760000000000005;6.4790000000000001;50;554;364;3;4;44;26;123.59999999999999;60.200000000000003;63.399999999999999;39.119999999999997;195;149;597;83;58;193;143;606;98;100;1;4;52
6;10413;Mansores;529;552;516;542;313;247;293;225;20;22;6.3899999999999997;8.907;30;289;199;2;2;18;20;76.799999999999997;37.600000000000001;39.200000000000003;40.390000000000001;91;72;299;26;41;85;61;296;41;69;1;4;56
6;10907;Fiães;3860;4131;3670;3979;2041;1752;1749;1415;292;337;14.307;19.234999999999999;36;1454;1674;49;52;243;285;1252.9000000000001;605.20000000000005;647.70000000000005;41.18;596;477;2199;353;235;550;452;2370;423;336;1;15;155
6;10909;Gião;861;954;823;922;480;402;428;327;52;75;10.833;18.657;7;360;388;8;15;44;60;518.89999999999998;246.19999999999999;272.69999999999999;36.640000000000001;163;102;498;60;38;182;144;528;51;49;1;15;157
6;10911;Lobão;2689;2794;2602;2734;1452;1159;1258;919;194;240;13.361000000000001;20.707999999999998;20;1017;1140;27;48;167;192;718.70000000000005;352.5;366.19999999999999;39.119999999999997;517;316;1541;190;125;457;283;1594;249;211;1;15;159
6;10917;Nogueira da Regedoura;2798;2992;2702;2921;1547;1390;1312;1084;235;306;15.191000000000001;22.013999999999999;10;1076;1310;26;30;209;276;1135.5;548.70000000000005;586.79999999999995;38.729999999999997;489;318;1644;235;112;499;331;1740;248;174;1;15;165
6;21206;Santana da Serra;416;434;403;421;152;94;142;85;10;9;6.5789999999999997;9.5739999999999998;42;49;136;0;0;10;9;4.5;2.2000000000000002;2.2999999999999998;56.93;22;26;191;82;95;25;26;169;103;111;3;50;453
6;21403;Vidigueira;1439;1520;1380;1470;698;619;600;548;98;71;14.039999999999999;11.470000000000001;88;169;891;26;16;72;55;106.3;51.700000000000003;54.600000000000001;42.789999999999999;238;179;735;135;152;207;186;751;153;223;3;52;463
6;30109;Ferreiros;1543;1669;1476;1619;797;741;686;599;111;142;13.927;19.163;38;363;884;24;27;87;115;1211.7;582.10000000000002;629.60000000000002;37.439999999999998;317;185;855;110;76;281;200;927;123;138;4;53;475
6;30117;Prozelo;400;385;397;380;187;176;165;152;22;24;11.765000000000001;13.635999999999999;15;95;207;3;4;19;20;293.89999999999998;149.80000000000001;144.09999999999999;37.259999999999998;93;54;201;25;27;67;38;216;30;34;4;53;483
6;30204;Aguiar;269;277;244;262;127;110;115;99;12;11;9.4489999999999998;10;6;115;93;1;1;11;10;158.69999999999999;78.200000000000003;80.5;39.530000000000001;43;39;144;28;15;37;45;148;28;19;4;54;492
6;30208;Alvelos;1047;1098;986;1074;578;512;494;448;84;64;14.532999999999999;12.5;21;546;375;15;18;69;46;634.29999999999995;309.60000000000002;324.69999999999999;38.909999999999997;174;150;609;65;49;170;127;640;79;82;4;54;496
6;30222;Chavão;360;386;327;369;173;156;160;130;13;26;7.5140000000000002;16.667000000000002;26;151;113;2;7;11;19;297.39999999999998;143.5;153.90000000000001;36.700000000000003;86;39;192;26;17;69;56;204;33;24;4;54;514
6;30229;Durrães;347;376;323;371;174;156;161;139;13;17;7.4710000000000001;10.897;10;178;112;2;3;11;14;289.19999999999999;138.80000000000001;150.40000000000001;40.119999999999997;70;41;181;28;27;53;44;200;41;38;4;54;521
6;30230;Encourados;260;254;242;243;143;108;121;101;22;7;15.385;6.4809999999999999;7;120;95;4;2;18;5;116.7;59;57.700000000000003;37.740000000000002;49;36;150;14;11;37;26;160;19;12;4;54;522
6;30232;Feitos;268;270;227;266;159;119;144;110;15;9;9.4339999999999993;7.5629999999999997;6;174;74;1;3;14;6;164.40000000000001;81.900000000000006;82.5;37.049999999999997;50;31;166;15;6;45;33;157;14;21;4;54;524
6;30243;Lijó;1087;1219;1038;1193;608;540;547;471;61;69;10.032999999999999;12.778;31;657;330;10;13;51;56;521.79999999999995;246;275.80000000000001;37.590000000000003;195;173;616;57;46;192;181;668;80;98;4;54;537
6;30249;Milhazes;428;484;393;457;222;223;208;195;14;28;6.306;12.556000000000001;23;243;137;3;6;11;22;251.5;118;133.5;39.439999999999998;71;66;236;26;29;58;81;264;36;45;4;54;543
6;30253;Negreiros;781;837;744;811;413;323;388;284;25;39;6.0529999999999999;12.074;54;393;225;3;8;22;31;363.19999999999999;175.30000000000001;187.90000000000001;37.869999999999997;155;96;447;55;28;152;90;470;59;66;4;54;547
6;30256;Panque;330;350;322;348;167;133;150;115;17;18;10.18;13.534000000000001;16;165;84;2;6;15;12;108.09999999999999;52.5;55.700000000000003;39.170000000000002;58;43;186;26;17;49;44;201;27;29;4;54;550
6;30278;Sequeade;388;407;361;404;224;180;204;151;20;29;8.9290000000000003;16.111000000000001;9;224;122;2;6;18;23;341;166.40000000000001;174.59999999999999;38.149999999999999;66;67;207;26;22;65;56;225;22;39;4;54;561
6;30284;Viatodos;891;949;864;923;479;443;451;391;28;52;5.8460000000000001;11.738;31;343;468;3;7;25;45;436.80000000000001;211.5;225.30000000000001;42.039999999999999;108;108;550;75;50;116;100;558;94;81;4;54;570
6;30303;Arentim;432;452;421;441;241;209;222;183;19;26;7.8840000000000003;12.44;5;155;245;2;7;17;19;367.19999999999999;179.40000000000001;187.80000000000001;41.909999999999997;62;39;270;35;26;59;50;264;40;39;4;55;584
6;30312;Espinho;593;588;545;562;308;291;279;259;29;32;9.4160000000000004;10.997;7;194;337;4;3;25;29;263.89999999999998;132.5;131.40000000000001;38.939999999999998;101;102;311;47;32;77;76;336;56;43;4;55;618
6;30328;Nogueira;2918;3006;2831;2922;1645;1606;1473;1425;172;181;10.456;11.27;13;769;2116;31;38;141;143;1134.8;559;575.79999999999995;36.710000000000001;505;369;1786;172;86;517;364;1818;183;124;4;55;658
6;30341;Braga (São João do Souto);244;481;505;669;87;112;77;99;10;13;11.494;11.606999999999999;2;24;150;3;3;7;10;2823.0999999999999;950.10000000000002;1873;62.68;25;17;101;25;76;7;26;130;54;264;4;55;593
6;30405;Bucos;261;293;225;279;115;68;99;57;16;11;13.913;16.175999999999998;18;62;76;1;3;15;8;31.100000000000001;14.699999999999999;16.5;46.609999999999999;31;35;138;25;32;28;37;133;40;55;4;56;713
6;30517;Rego;614;627;548;602;310;238;268;194;42;44;13.548;18.486999999999998;29;231;202;8;13;34;31;72.599999999999994;35.899999999999999;36.700000000000003;41.299999999999997;99;72;336;61;46;90;74;319;71;73;4;57;744
6;30722;Quinchães;1090;1188;1077;1182;550;491;473;422;77;69;14;14.053000000000001;5;499;391;12;10;65;59;214.69999999999999;102.8;112;41.189999999999998;202;127;603;91;67;156;134;648;110;140;4;59;786
6;30729;Silvares (São Martinho);634;691;611;669;327;294;271;247;56;47;17.125;15.986000000000001;5;280;233;7;2;49;45;210.59999999999999;100.8;109.8;41.689999999999998;85;92;361;58;38;105;66;395;71;54;4;59;794
6;30810;Castelões;149;161;147;157;70;44;59;37;11;7;15.714;15.909000000000001;7;45;44;2;3;9;4;86.5;41.600000000000001;44.899999999999999;44.719999999999999;20;14;81;22;12;23;16;83;26;13;4;55;607
6;30811;Conde;664;714;655;706;377;363;344;316;33;47;8.7530000000000001;12.948;1;472;187;2;7;31;40;715.29999999999995;344.69999999999999;370.60000000000002;40.280000000000001;81;100;399;52;32;86;111;415;53;49;4;55;609
6;30828;Lordelo;2080;2207;2005;2153;1058;1012;903;858;155;154;14.65;15.217000000000001;11;1046;704;22;26;133;128;862.10000000000002;418.30000000000001;443.80000000000001;42.049999999999997;319;261;1176;200;124;267;261;1245;236;198;4;55;648
6;30834;Guimarães (Oliveira do Castelo);1515;1750;1514;1724;740;770;641;646;99;124;13.378;16.103999999999999;2;360;925;14;23;85;101;4711.5;2186.1999999999998;2525.3000000000002;43.32;228;149;864;163;111;222;174;947;228;179;4;55;638
6;30851;São Faustino;501;497;482;486;287;256;254;209;33;47;11.497999999999999;18.359000000000002;9;272;182;7;12;26;35;510.30000000000001;256.19999999999999;254.09999999999999;36.649999999999999;92;68;292;32;17;89;70;280;37;21;4;55;687
6;30903;Brunhais;151;162;140;162;51;34;45;27;6;7;11.765000000000001;20.588000000000001;3;36;33;1;1;5;6;118.7;57.299999999999997;61.399999999999999;48.130000000000003;24;13;66;15;33;18;16;74;24;30;4;60;801
6;30920;Oliveira;179;218;169;209;84;82;76;68;8;14;9.5240000000000009;17.073;13;64;67;1;0;7;14;75.299999999999997;34;41.299999999999997;39.82;34;16;96;25;8;39;26;109;26;18;4;60;817
6;31006;Chorense;215;239;198;232;104;73;92;57;12;16;11.538;21.917999999999999;11;36;102;1;5;11;11;54.700000000000003;25.899999999999999;28.800000000000001;44.630000000000003;26;31;117;25;16;27;27;118;35;32;4;61;833
6;31016;Vilar;77;72;71;67;25;20;22;12;3;8;12;40;2;9;23;0;2;3;6;32.600000000000001;16.800000000000001;15.699999999999999;48.539999999999999;9;11;37;7;13;3;13;31;11;14;4;61;844
6;31104;Caniçada;211;244;206;240;100;85;87;62;13;23;13;27.059000000000001;10;39;100;1;3;12;20;65.799999999999997;30.5;35.299999999999997;42.469999999999999;38;29;104;23;17;38;26;125;25;30;4;62;848
6;31116;Soengas;72;76;67;85;32;17;30;9;2;8;6.25;47.058999999999997;1;16;22;1;3;1;5;71.299999999999997;34.700000000000003;36.600000000000001;44.340000000000003;6;12;38;10;6;7;12;36;12;9;4;62;860
6;31204;Bairro;1716;1882;1658;1855;884;868;749;690;135;178;15.271000000000001;20.507000000000001;4;788;647;26;31;109;147;1073.2;511.80000000000001;561.29999999999995;42.119999999999997;266;206;990;152;102;226;204;1075;198;179;4;63;871
6;31310;Codeceda;83;89;79;84;32;26;32;23;0;3;0;11.538;4;26;25;0;1;0;2;51;24.600000000000001;26.399999999999999;46.840000000000003;17;10;37;9;10;4;12;38;15;20;4;64;926
6;31322;Gondomar;34;37;30;37;13;5;11;4;2;1;15.385;20;2;7;6;1;0;1;1;32.200000000000003;15.4;16.800000000000001;48.439999999999998;4;7;12;6;5;3;3;15;10;6;4;64;940
6;31323;Laje;1382;1513;1305;1455;760;653;697;562;63;91;8.2889999999999997;13.936;20;488;751;14;13;49;78;620.20000000000005;296.10000000000002;324.10000000000002;36.509999999999998;280;168;784;85;65;297;174;829;92;121;4;64;941
6;31343;Oriz (Santa Marinha);173;163;168;156;78;53;62;33;16;20;20.513000000000002;37.735999999999997;15;24;56;1;6;15;14;91.599999999999994;47.200000000000003;44.399999999999999;43.25;24;24;90;27;8;24;16;85;16;22;4;64;949
6;40234;Rabal;75;96;71;89;28;28;26;25;2;3;7.1429999999999998;10.714;8;7;36;1;2;1;1;7.2999999999999998;3.2000000000000002;4.0999999999999996;53.609999999999999;3;5;39;18;10;7;11;42;22;14;5;67;1035
6;40310;Mogo de Malta;49;62;49;63;19;16;18;15;1;1;5.2629999999999999;6.25;5;4;24;0;1;1;0;11.800000000000001;5.2000000000000002;6.5999999999999996;54.68;5;3;25;7;9;5;5;26;6;20;5;68;1058
6;40502;Amendoeira;214;213;207;206;113;66;101;55;12;11;10.619;16.667000000000002;27;45;84;0;4;12;7;27.199999999999999;13.6;13.6;46.189999999999998;22;24;117;29;22;26;24;106;27;30;5;70;1075
6;40506;Burga;23;30;22;27;11;5;10;5;1;0;9.0909999999999993;0;4;4;7;0;0;1;0;7.4000000000000004;3.2000000000000002;4.2000000000000002;53.469999999999999;2;3;11;5;2;2;1;13;8;6;5;70;1079
6;40508;Castelãos;180;263;149;262;67;63;59;55;8;8;11.94;12.698;6;21;87;0;5;8;3;35.100000000000001;14.300000000000001;20.899999999999999;47.710000000000001;26;9;86;24;35;43;37;90;40;53;5;70;1081
6;40531;Talhinhas;79;94;80;91;19;14;16;9;3;5;15.789;35.713999999999999;13;2;10;1;4;2;1;6.7999999999999998;3.1000000000000001;3.7000000000000002;56.020000000000003;6;6;36;18;13;5;5;40;18;26;5;70;1104
6;40535;Vilar do Monte;49;55;35;51;22;15;22;13;0;2;0;13.333;6;9;20;0;1;0;1;16.699999999999999;7.9000000000000004;8.8000000000000007;50.829999999999998;5;6;25;10;3;3;3;31;6;12;5;70;1108
6;40601;Atenor;58;63;50;65;21;8;18;7;3;1;14.286;12.5;3;11;11;0;1;3;0;5.9000000000000004;2.7999999999999998;3.1000000000000001;56.229999999999997;2;3;31;7;15;5;2;28;14;14;5;71;1113
6;40606;Ifanes;76;84;75;83;29;20;29;18;0;2;0;10;20;10;17;0;0;0;2;5.5999999999999996;2.7000000000000002;2.8999999999999999;56.780000000000001;7;5;36;15;13;1;3;37;22;21;5;71;1118
6;40715;Franco;120;124;118;120;39;28;28;16;11;12;28.204999999999998;42.856999999999999;4;7;33;4;2;7;10;14.300000000000001;7;7.2000000000000002;52.229999999999997;13;12;61;15;19;6;13;49;19;37;5;72;1143
6;40717;Freixeda;43;46;41;46;13;14;12;12;1;2;7.6920000000000002;14.286;12;5;7;0;0;1;2;7.7999999999999998;3.7999999999999998;4.0999999999999996;50.93;4;8;14;8;9;5;3;17;12;9;5;72;1145
6;40719;Marmelos;66;79;64;77;34;18;27;10;7;8;20.588000000000001;44.444000000000003;10;9;18;1;2;6;6;6.4000000000000004;2.8999999999999999;3.5;50.740000000000002;6;7;37;6;10;7;6;34;13;19;5;72;1147
6;40728;São Salvador;109;114;107;114;47;29;36;22;11;7;23.404;24.138000000000002;13;10;35;1;1;10;6;15.699999999999999;7.7000000000000002;8;51.259999999999998;7;14;55;15;18;12;9;47;22;24;5;72;1156
6;41004;Carvalho de Egas;50;64;49;60;21;14;20;9;1;5;4.7620000000000005;35.713999999999999;5;14;10;0;1;1;4;39.399999999999999;17.300000000000001;22.100000000000001;51.799999999999997;3;3;29;8;7;5;7;32;7;13;5;75;1214
6;50423;Salgueiro;329;361;321;349;121;92;103;71;18;21;14.875999999999999;22.826000000000001;22;56;96;5;4;13;17;12.199999999999999;5.7999999999999998;6.4000000000000004;53.609999999999999;36;15;156;64;58;26;28;152;66;89;6;81;1364
6;50425;Soalheira;439;452;420;447;172;139;155;126;17;13;9.8840000000000003;9.3529999999999998;6;75;200;2;2;15;11;71.700000000000003;35.299999999999997;36.399999999999999;52.170000000000002;42;46;209;60;82;28;37;190;77;120;6;81;1366
6;50513;Salvaterra do Extremo;79;91;80;89;24;22;17;13;7;9;29.167000000000002;40.908999999999999;7;2;21;2;4;5;5;2.1000000000000001;1;1.1000000000000001;56.090000000000003;6;3;37;15;18;4;6;37;23;21;6;82;1383
6;50704;Aranhas;180;173;177;169;57;34;48;29;9;5;15.789;14.706;13;20;44;0;1;9;4;64.5;32.899999999999999;31.600000000000001;55.219999999999999;25;10;76;27;42;7;7;70;34;55;6;84;1403
6;50708;Meimoa;179;194;170;181;63;40;50;34;13;6;20.635000000000002;15;11;25;48;0;3;13;3;13;6.2000000000000002;6.7000000000000002;55.200000000000003;14;16;84;31;34;11;18;69;41;55;6;84;1407
6;50912;Sertã;2946;3250;2784;3115;1447;1351;1363;1209;84;142;5.8049999999999997;10.510999999999999;85;716;1771;20;48;64;94;76.5;36.399999999999999;40.200000000000003;42.689999999999998;490;325;1553;294;284;469;345;1636;360;440;6;86;1429
6;60405;Condeixa-a-Velha;1670;1802;1563;1768;873;907;791;833;82;74;9.3930000000000007;8.1590000000000007;29;282;1313;16;16;66;58;143.59999999999999;69.099999999999994;74.5;39.299999999999997;329;153;978;130;80;295;157;1057;153;140;7;92;1511
6;60508;Marinha das Ondas;1551;1628;1401;1564;806;608;737;541;69;67;8.5609999999999999;11.02;165;551;562;9;9;60;58;116;56.600000000000001;59.399999999999999;43.670000000000002;224;173;850;174;130;229;137;860;199;203;7;93;1526
6;60518;Moinhos da Gândara;594;671;555;650;276;236;259;210;17;26;6.1589999999999998;11.016999999999999;31;169;269;4;9;13;17;118.5;55.700000000000003;62.899999999999999;45.420000000000002;70;69;320;75;60;79;63;342;90;97;7;93;1527
6;60803;Carapelhos;358;359;352;356;183;153;172;139;11;14;6.0110000000000001;9.1500000000000004;26;116;169;2;5;9;9;163.69999999999999;81.700000000000003;81.900000000000006;42.340000000000003;65;33;198;30;32;41;50;183;38;47;7;96;1546
6;60904;Semide;1417;1446;1330;1411;713;597;642;552;71;45;9.9580000000000002;7.5380000000000003;92;277;825;10;10;61;35;109.90000000000001;54.399999999999999;55.5;44.039999999999999;173;206;788;131;119;175;130;755;185;201;7;97;1553
6;60905;Vila Nova;473;497;447;482;216;184;196;159;20;25;9.2590000000000003;13.587;9;116;230;2;7;18;18;36.100000000000001;17.600000000000001;18.5;47.82;61;48;248;56;60;44;41;252;71;89;7;97;1554
6;61011;Tentúgal;1056;1085;984;1047;530;468;477;424;53;44;10;9.4019999999999992;79;247;575;10;9;43;35;62.399999999999999;30.800000000000001;31.600000000000001;44.770000000000003;139;122;580;112;103;109;112;557;154;153;7;98;1566
6;61112;Oliveira do Hospital;2275;2442;2158;2401;1213;1170;1097;1027;116;143;9.5630000000000006;12.222;30;688;1406;20;28;96;115;509.10000000000002;245.59999999999999;263.60000000000002;39.149999999999999;426;276;1270;172;131;388;256;1386;208;204;7;99;1580
6;61205;Machio;59;67;55;63;8;5;7;5;1;0;12.5;0;2;4;6;0;0;1;0;8.4000000000000004;3.8999999999999999;4.5;66.769999999999996;;3;13;25;18;2;2;18;19;26;7;100;1594
6;61501;Alfarelos;699;740;657;731;309;303;276;273;33;30;10.68;9.9009999999999998;7;111;431;5;9;28;21;102.90000000000001;50;52.899999999999999;47.100000000000001;83;70;380;86;80;77;58;384;99;122;7;103;1617
6;70304;Borba (São Bartolomeu);357;401;332;380;153;135;129;111;24;24;15.686;17.777999999999999;20;48;172;1;3;23;21;3720.1999999999998;1752.0999999999999;1968.0999999999999;51.619999999999997;33;34;171;57;62;30;29;180;70;92;8;108;1662
6;70411;São Domingos de Ana Loura;164;177;159;171;72;62;68;54;4;8;5.556;12.903;28;29;65;0;2;4;6;20.899999999999999;10.1;10.9;48.560000000000002;12;17;84;20;31;16;26;78;33;24;8;109;1675
6;70501;Nossa Senhora da Boa Fé;156;166;153;171;77;60;72;58;5;2;6.4939999999999998;3.3330000000000002;23;28;79;0;1;5;1;9.9000000000000004;4.7999999999999998;5.0999999999999996;51.140000000000001;16;24;73;16;27;12;13;72;23;46;8;110;1684
6;70502;Nossa Senhora da Graça do Divor;228;258;222;258;131;112;119;102;12;10;9.1600000000000001;8.9290000000000003;27;42;152;0;2;12;8;5.7999999999999998;2.7000000000000002;3.1000000000000001;43.280000000000001;29;21;129;20;29;45;26;125;29;33;8;110;1685
6;70902;Amieira;186;176;186;173;96;57;76;45;20;12;20.832999999999998;21.053000000000001;28;28;65;2;0;18;12;3.7000000000000002;1.8999999999999999;1.8;52.009999999999998;8;20;100;24;34;15;13;68;34;46;8;114;1715
6;71001;Montoito;636;662;624;651;289;227;241;161;48;66;16.609000000000002;29.074999999999999;88;80;234;2;8;46;58;21;10.300000000000001;10.699999999999999;49.240000000000002;81;71;291;65;128;73;58;271;98;162;8;115;1722
6;80301;Aljezur;1653;1712;1635;1693;687;596;611;535;76;61;11.063000000000001;10.234999999999999;68;242;836;9;9;67;52;20.199999999999999;9.9000000000000004;10.300000000000001;47.200000000000003;191;136;883;253;190;216;140;899;211;246;9;122;1758
6;80506;Montenegro;4043;4106;4047;4214;2313;2204;2045;1990;268;214;11.587;9.7100000000000009;73;456;3506;37;35;231;179;350.69999999999999;174;176.69999999999999;37.939999999999998;738;382;2422;325;176;699;362;2501;283;261;9;124;1770
6;81101;Alvor;3011;3143;3768;3603;1553;1430;1293;1200;260;230;16.742000000000001;16.084;74;291;2128;31;31;229;199;403.39999999999998;197.40000000000001;206.09999999999999;42.659999999999997;489;289;1678;308;247;475;263;1737;322;346;9;130;1802
6;90223;Porto de Ovelha;21;26;21;26;4;0;3;0;1;0;25;0;1;1;1;0;0;1;0;3.1000000000000001;1.3999999999999999;1.7;66.430000000000007;;1;7;11;2;;;7;11;8;10;136;1857
6;90304;Carrapichana;99;117;95;113;45;34;41;30;4;4;8.8889999999999993;11.765000000000001;5;21;45;1;0;3;4;38.600000000000001;17.699999999999999;20.899999999999999;50.100000000000001;4;14;47;22;12;17;8;47;27;18;10;137;1867
6;90314;Ratoeira;139;164;132;160;65;60;58;46;7;14;10.769;23.332999999999998;5;35;64;1;1;6;13;39.100000000000001;18;21.199999999999999;49.780000000000001;16;10;67;17;29;24;11;70;19;40;10;137;1880
6;90404;Cinco Vilas;45;49;43;46;20;4;17;2;3;2;15;50;6;8;5;2;2;1;0;5.2000000000000002;2.5;2.7000000000000002;57.18;2;3;20;7;13;5;1;18;8;17;10;138;1889
6;90417;Vilar Torpim;106;107;105;107;50;24;40;17;10;7;20;29.167000000000002;20;10;27;3;3;7;4;6.7000000000000002;3.2999999999999998;3.2999999999999998;48.340000000000003;20;8;55;11;12;9;7;48;18;25;10;138;1902
6;90604;Figueiró da Serra;116;147;110;138;49;46;46;36;3;10;6.1219999999999999;21.739000000000001;5;35;42;1;2;2;8;32.399999999999999;14.300000000000001;18.100000000000001;49.640000000000001;13;9;59;19;16;14;16;65;27;25;10;140;1922
6;90613;Paços da Serra;293;308;272;295;130;120;102;99;28;21;21.538;17.5;13;84;104;3;2;25;19;57.799999999999997;28.199999999999999;29.600000000000001;47;35;36;151;44;27;28;33;150;49;48;10;140;1933
6;90622;Vinhó;261;317;253;302;111;112;99;87;12;25;10.811;22.321000000000002;10;41;135;0;6;12;19;73.599999999999994;33.200000000000003;40.299999999999997;48.259999999999998;37;23;126;29;46;40;32;140;47;58;10;140;1940
6;90724;Marmeleiro;187;174;176;166;66;47;56;42;10;5;15.151999999999999;10.638;11;28;59;4;2;6;3;12.199999999999999;6.2999999999999998;5.9000000000000004;56.780000000000001;10;15;84;37;41;7;7;79;38;43;10;141;1968
6;90727;Monte Margarida;18;18;18;18;5;2;4;2;1;0;20;0;1;0;5;0;0;1;0;8.0999999999999996;4.0999999999999996;4.0999999999999996;66.75;;;6;6;6;;;5;5;8;10;141;1971
6;91017;Pinhel;1688;1830;1594;1737;860;820;805;631;55;189;6.3949999999999996;23.048999999999999;53;329;1054;13;34;42;155;78.799999999999997;37.799999999999997;41;42.68;290;161;936;162;139;244;193;981;198;214;10;144;2032
6;91020;Póvoa d' El-Rei;28;25;27;26;13;12;10;10;3;2;23.077000000000002;16.667000000000002;12;0;8;2;0;1;2;8.8000000000000007;4.5999999999999996;4.0999999999999996;53.229999999999997;2;4;10;9;3;1;1;15;7;1;10;144;2035
6;91104;Aldeia da Ribeira;67;64;65;62;15;7;15;7;0;0;0;0;12;2;8;0;0;0;0;4.4000000000000004;2.2000000000000002;2.1000000000000001;61.600000000000001;3;4;29;15;16;1;2;24;16;21;10;145;2045
6;91214;Santa Eulália;125;146;122;143;74;59;69;53;5;6;6.7569999999999997;10.169;7;67;48;0;1;5;5;66.5;30.699999999999999;35.799999999999997;44.039999999999999;15;13;76;15;6;23;13;73;16;21;10;146;2097
6;91222;Torrozelo;228;253;206;239;110;97;95;79;15;18;13.635999999999999;18.556999999999999;2;73;99;3;1;12;17;73.5;34.899999999999999;38.700000000000003;48.990000000000002;27;19;127;31;24;17;21;127;40;48;10;146;2105
6;91226;Várzea de Meruge;122;127;118;128;52;42;49;37;3;5;5.7690000000000001;11.904999999999999;4;30;52;0;0;3;5;40.600000000000001;19.899999999999999;20.699999999999999;46.420000000000002;15;10;69;10;18;17;9;61;21;19;10;146;2109
6;100102;Alfeizerão;1867;1987;1806;1940;842;744;760;667;82;77;9.7390000000000008;10.349;148;400;879;7;9;75;68;137.69999999999999;66.700000000000003;71;44.649999999999999;291;187;959;222;208;275;159;1011;273;269;11;149;2159
6;100205;Pelmá;356;380;338;374;139;89;127;77;12;12;8.6329999999999991;13.483000000000001;6;94;104;2;4;10;8;24.199999999999999;11.699999999999999;12.5;53.810000000000002;33;33;169;44;77;23;35;147;79;96;11;150;2180
6;100916;Monte Real;1397;1539;1432;1582;748;688;689;609;59;79;7.8879999999999999;11.483000000000001;23;369;906;14;16;45;63;214;101.8;112.2;41.740000000000002;205;164;799;122;107;225;158;839;145;172;11;157;2243
6;100921;Regueira de Pontes;1097;1124;1051;1109;582;509;541;459;41;50;7.0449999999999999;9.8230000000000004;53;333;614;4;7;37;43;192.40000000000001;95;97.400000000000006;41.969999999999999;177;123;609;112;76;145;133;624;119;103;11;157;2248
6;101202;Amoreira;478;511;588;601;206;201;181;173;25;28;12.135999999999999;13.93;25;81;248;3;0;22;28;49.700000000000003;24;25.699999999999999;46.43;71;47;246;68;46;56;50;254;74;77;11;160;2259
6;101504;Carnide;795;852;742;829;381;278;362;238;19;40;4.9870000000000001;14.388;22;313;265;4;9;15;31;73.599999999999994;35.5;38.100000000000001;43.43;124;98;404;90;79;124;103;416;100;109;11;163;2279
6;101516;Guia;1320;1352;1248;1308;672;554;622;504;50;50;7.4400000000000004;9.0250000000000004;41;433;652;6;4;44;46;72.900000000000006;36;36.899999999999999;42.979999999999997;197;156;717;146;104;177;137;721;184;133;11;163;2281
6;101606;Juncal;1622;1694;1553;1642;845;771;781;689;64;82;7.5739999999999998;10.635999999999999;59;691;720;16;15;48;67;124.5;60.899999999999999;63.600000000000001;41.68;275;179;874;169;125;248;169;934;182;161;11;164;2298
6;110101;Abrigada;1593;1727;1531;1675;843;701;774;625;69;76;8.1850000000000005;10.842000000000001;64;492;843;14;22;55;54;84.400000000000006;40.5;43.899999999999999;43.439999999999998;228;159;906;173;127;227;188;928;186;198;12;165;2306
6;110203;Cardosas;400;436;385;430;206;183;181;170;25;13;12.135999999999999;7.1040000000000001;8;69;274;7;1;18;12;139;66.5;72.5;43.579999999999998;69;37;223;41;30;64;39;232;45;56;12;167;2335
6;110304;Azambuja;3954;4236;3756;4123;2119;2043;1902;1789;217;254;10.241;12.433;144;711;2836;29;43;188;211;98.200000000000003;47.399999999999999;50.799999999999997;39.280000000000001;773;382;2255;312;232;704;404;2375;385;368;12;168;2340
6;110902;Carvoeira;1062;1093;978;1026;578;523;509;465;69;58;11.938000000000001;11.09;16;203;755;11;12;58;46;262.39999999999998;129.30000000000001;133.09999999999999;38.990000000000002;196;100;615;99;52;187;105;641;91;69;12;174;2444
6;110909;Mafra;8673;9313;8280;9038;4895;4744;4515;4292;380;452;7.7629999999999999;9.5280000000000005;132;1730;6945;77;94;303;358;375.10000000000002;180.90000000000001;194.19999999999999;36.990000000000002;1747;918;4998;621;389;1785;874;5381;707;566;12;174;2451
6;110913;Santo Isidoro;1902;1912;1806;1842;1015;807;921;719;94;88;9.2609999999999992;10.904999999999999;49;451;1140;19;19;75;69;153.59999999999999;76.599999999999994;77;40.340000000000003;320;203;1088;172;119;338;170;1063;180;161;12;174;2455
6;41014;Trindade;75;87;51;65;29;22;27;19;2;3;6.8970000000000002;13.635999999999999;17;10;19;2;2;0;1;10.800000000000001;5;5.7999999999999998;51.030000000000001;6;10;32;16;11;6;9;41;15;16;5;75;1224
6;41208;Ervedosa;178;198;171;192;66;28;55;25;11;3;16.667000000000002;10.714;10;22;48;2;1;9;2;12.5;5.9000000000000004;6.5999999999999996;57.859999999999999;9;15;79;33;42;12;12;70;44;60;5;77;1251
6;41223;Sobreiro de Baixo;155;152;155;147;56;30;52;26;4;4;7.1429999999999998;13.333;3;20;55;2;1;2;3;15.800000000000001;8;7.7999999999999998;49.75;17;16;79;30;13;10;12;71;29;30;5;77;1266
6;41234;Vilar Seco de Lomba;112;123;107;116;36;4;36;4;0;0;0;0;18;7;15;0;0;0;0;10.5;5;5.5;58.979999999999997;5;7;45;24;31;5;9;49;27;33;5;77;1277
6;50218;Póvoa de Rio de Moinhos;330;333;306;317;168;136;148;122;20;14;11.904999999999999;10.294;15;82;173;3;5;17;9;25.899999999999999;12.9;13;46.509999999999998;48;26;174;45;37;34;26;178;46;49;6;79;1301
6;50320;Covilhã (São Pedro);1056;1169;1019;1143;512;472;440;406;72;66;14.063000000000001;13.983000000000001;10;136;700;17;16;55;50;835.20000000000005;396.39999999999998;438.80000000000001;45.439999999999998;119;118;600;127;92;127;128;604;168;142;6;80;1321
6;50414;Donas;419;444;435;470;219;167;194;154;25;13;11.416;7.7839999999999998;21;87;240;6;2;19;11;108.8;52.799999999999997;56;45.359999999999999;51;43;240;38;47;59;46;218;53;68;6;81;1353
6;171317;Sabroso de Aguiar;344;340;328;330;149;104;130;85;19;19;12.752000000000001;18.268999999999998;2;94;119;4;9;15;10;78;39.200000000000003;38.799999999999997;44.700000000000003;60;27;190;38;29;45;35;166;46;48;19;281;3850
6;171318;Lixa do Alvão;212;212;205;200;111;63;102;50;9;13;8.1080000000000005;20.635000000000002;28;58;66;3;8;6;5;29.300000000000001;14.6;14.6;47.600000000000001;14;32;115;30;21;17;22;112;35;26;19;281;3847
6;171403;Andrães;656;733;635;716;298;234;262;195;36;39;12.081;16.667000000000002;46;95;316;6;15;30;24;67.799999999999997;32;35.799999999999997;43.219999999999999;90;84;373;63;46;88;87;401;73;84;19;282;3861
6;171411;Justes;167;166;157;161;54;45;49;38;5;7;9.2590000000000003;15.556000000000001;2;16;69;0;4;5;3;38.600000000000001;19.300000000000001;19.199999999999999;52.710000000000001;15;17;79;24;32;8;11;78;33;36;19;282;3869
6;171414;Lordelo;1562;1607;1669;1697;794;839;729;767;65;72;8.1859999999999999;8.5820000000000007;23;251;1222;15;20;50;52;613.79999999999995;302.5;311.30000000000001;38.710000000000001;295;188;892;107;80;240;167;977;99;124;19;282;3872
6;180308;Gafanhão;59;69;60;70;17;11;16;11;1;0;5.8819999999999997;0;5;4;18;1;0;0;0;17.399999999999999;8;9.4000000000000004;60.490000000000002;2;5;21;13;18;4;4;23;17;21;20;285;3922
6;180315;Moura Morta;64;70;57;65;24;11;24;10;0;1;0;9.0909999999999993;8;9;17;0;0;0;1;12.699999999999999;6.0999999999999996;6.7000000000000002;48.509999999999998;4;8;29;9;14;10;10;30;8;12;20;285;3929
6;180320;Reriz;365;390;356;383;162;105;147;92;15;13;9.2590000000000003;12.381;11;64;164;2;1;13;12;49.5;23.899999999999999;25.600000000000001;42.899999999999999;58;46;188;47;26;56;39;187;47;61;20;285;3934
6;180321;Ribolhos;123;143;114;139;60;42;56;32;4;10;6.6669999999999998;23.809999999999999;8;30;50;1;2;3;8;110;50.799999999999997;59.100000000000001;46.68;14;12;68;19;10;13;15;76;19;20;20;285;3935
6;180322;São Joaninho;172;188;162;170;81;44;72;37;9;7;11.111000000000001;15.909000000000001;2;49;58;1;3;8;4;44.700000000000003;21.399999999999999;23.300000000000001;43.420000000000002;28;20;89;19;16;25;28;79;28;28;20;285;3936
6;180515;Parada do Bispo;73;76;73;76;35;26;32;23;3;3;8.5709999999999997;11.538;9;10;36;1;0;2;3;73.200000000000003;35.899999999999999;37.299999999999997;46.369999999999997;9;12;40;4;8;6;6;40;13;11;20;287;3969
6;180602;Alcafache;441;480;405;452;223;163;197;126;26;37;11.659000000000001;22.699000000000002;24;114;185;5;8;21;29;71.5;34.200000000000003;37.299999999999997;46.25;54;52;234;52;49;56;46;246;61;71;20;288;3979
6;180613;Póvoa de Cervães;96;92;85;84;33;26;29;23;4;3;12.121;11.538;7;21;24;0;0;4;3;24.699999999999999;12.6;12.1;51.759999999999998;14;9;40;20;13;7;3;48;18;16;20;288;3990
6;181006;Reigoso;156;185;153;178;87;66;81;56;6;10;6.8970000000000002;15.151999999999999;18;66;53;0;2;6;8;34.899999999999999;16;18.899999999999999;43.659999999999997;21;20;84;15;16;25;23;86;23;28;20;292;4040
6;181401;Couto do Mosteiro;565;621;539;606;270;236;239;206;31;30;11.481;12.712;10;158;277;6;5;25;25;79.599999999999994;37.899999999999999;41.700000000000003;45.289999999999999;73;61;297;70;64;95;36;318;88;84;20;296;4084
6;181403;Pinheiro de Ázere;444;493;391;478;209;186;181;162;28;24;13.397;12.903;14;146;183;3;2;25;22;78.799999999999997;37.399999999999999;41.5;46.259999999999998;61;44;227;63;49;55;50;250;71;67;20;296;4087
6;181405;São Joaninho;497;578;465;560;238;182;223;163;15;19;6.3029999999999999;10.44;38;129;219;5;2;10;17;110.59999999999999;51.100000000000001;59.5;47;70;47;269;63;48;62;56;277;81;102;20;296;4089
6;181610;Santa Cruz da Trapa;608;705;560;680;319;254;300;229;19;25;5.9559999999999995;9.843;61;192;276;4;3;15;22;58.100000000000001;26.899999999999999;31.199999999999999;43.280000000000001;94;74;320;63;57;101;64;352;89;99;20;298;4116
6;181619;Vila Maior;466;496;430;474;202;150;186;127;16;23;7.9210000000000003;15.333;59;89;165;2;5;14;18;81;39.200000000000003;41.799999999999997;46.219999999999999;54;63;240;50;59;58;59;233;67;79;20;298;4125
6;181801;Arnas;106;114;90;109;45;27;41;23;4;4;8.8889999999999993;14.815;5;21;38;0;0;4;4;10.4;5;5.4000000000000004;48.390000000000001;10;12;56;13;15;9;13;53;16;23;20;300;4138
6;181803;Chosendo;127;127;130;130;35;26;30;20;5;6;14.286;23.077000000000002;7;28;15;3;5;2;1;22.5;11.199999999999999;11.199999999999999;45.289999999999999;16;12;66;22;11;17;14;63;14;19;20;300;4140
6;181911;Pinheiros;88;90;83;89;38;12;28;9;10;3;26.315999999999999;25;8;13;16;0;1;10;2;25.5;12.6;12.9;47.619999999999997;7;9;55;10;7;12;9;41;11;17;20;301;4165
6;182009;Várzea da Serra;129;132;123;128;38;26;32;23;6;3;15.789;11.538;16;10;29;1;0;5;3;12.300000000000001;6.0999999999999996;6.2000000000000002;58.259999999999998;8;10;50;29;32;4;9;49;33;37;20;302;4180
6;182118;Santiago de Besteiros;657;674;632;655;301;243;264;224;37;19;12.292;7.819;54;194;240;1;7;36;12;84.5;41.700000000000003;42.799999999999997;44.740000000000002;95;77;338;85;62;84;73;335;102;80;20;303;4199
6;182205;Touro;425;493;389;474;176;125;154;101;22;24;12.5;19.199999999999999;64;54;137;3;8;19;16;18.300000000000001;8.5;9.8000000000000007;44.539999999999999;67;50;207;49;52;69;68;225;65;66;20;304;4212
6;182318;Mundão;1190;1195;1138;1160;625;607;573;544;52;63;8.3200000000000003;10.379;13;286;818;9;10;43;53;165.09999999999999;82.400000000000006;82.700000000000003;35.840000000000003;286;122;651;78;53;245;93;695;92;70;20;305;4230
6;182333;Vila Chã de Sá;982;1027;916;975;515;431;460;375;55;56;10.68;12.993;12;267;556;14;12;41;44;224.69999999999999;109.8;114.90000000000001;37.600000000000001;192;128;536;78;48;184;123;568;90;62;20;305;4245
6;160115;Gondoriz;429;529;407;509;168;127;157;117;11;10;6.548;7.8739999999999997;53;86;135;5;3;6;7;28.199999999999999;12.6;15.6;51.380000000000003;41;36;222;78;52;43;40;236;102;108;18;259;3347
6;160125;Padroso;106;128;103;128;38;17;35;16;3;1;7.8949999999999996;5.8819999999999997;4;28;19;0;1;3;0;29.5;13.4;16.100000000000001;54.229999999999997;8;6;53;18;21;10;8;53;24;33;18;259;3360
6;160133;Sabadim;220;248;214;243;75;58;68;50;7;8;9.3330000000000002;13.792999999999999;3;52;63;0;2;7;6;56.200000000000003;26.399999999999999;29.800000000000001;51.810000000000002;24;31;103;44;18;12;16;116;54;50;18;259;3368
6;160138;Santar;79;85;78;82;34;29;32;27;2;2;5.8819999999999997;6.8970000000000002;3;30;26;0;0;2;2;178.59999999999999;86;92.599999999999994;42.270000000000003;11;12;37;7;12;14;10;40;14;7;18;259;3369
6;160140;São Jorge;325;389;318;387;101;77;95;75;6;2;5.9409999999999998;2.597;15;59;96;0;0;6;2;61.200000000000003;27.800000000000001;33.299999999999997;51.030000000000001;44;25;156;46;54;41;20;160;73;95;18;259;3371
6;160141;Arcos de Valdevez (São Paio);529;618;498;596;275;285;258;261;17;24;6.1820000000000004;8.4209999999999994;15;99;405;4;7;13;17;322.69999999999999;148.80000000000001;173.90000000000001;42.090000000000003;88;51;302;52;36;81;63;338;74;62;18;259;3334
6;160143;Távora (São Vicente);123;142;122;141;36;31;30;25;6;6;16.667000000000002;19.355;0;25;30;1;2;5;4;109.8;51;58.899999999999999;53.270000000000003;12;7;57;25;22;11;8;61;36;26;18;259;3378
6;160148;Tabaçô;173;182;173;181;85;60;81;59;4;1;4.7059999999999995;1.667;5;80;55;1;1;3;0;395.69999999999999;192.90000000000001;202.90000000000001;42.43;26;16;105;18;8;25;20;91;28;18;18;259;3376
6;160215;Seixas;698;804;657;784;334;315;286;260;48;55;14.371;17.460000000000001;24;122;400;10;17;38;38;180.30000000000001;83.799999999999997;96.5;45.289999999999999;103;87;367;78;63;89;75;402;94;144;18;260;3396
6;160303;Chaviães;172;213;167;201;70;58;65;51;5;7;7.1429999999999998;12.069000000000001;18;20;78;3;2;2;5;80.099999999999994;35.799999999999997;44.299999999999997;53.409999999999997;13;14;84;33;28;10;23;90;47;43;18;261;3404
6;160404;Barbeita;475;541;454;517;236;171;210;150;26;21;11.016999999999999;12.281000000000001;15;115;230;1;4;25;17;147.59999999999999;69;78.599999999999994;48.780000000000001;44;52;261;55;63;45;46;273;75;102;18;262;3423
6;160406;Bela;327;371;317;359;132;93;118;83;14;10;10.606;10.753;7;75;119;4;2;10;8;184.09999999999999;86.200000000000003;97.799999999999997;48.460000000000001;40;31;168;50;38;41;34;172;59;65;18;262;3425
6;160416;Messegães;119;134;116;133;46;38;39;34;7;4;15.217000000000001;10.526;7;15;51;2;1;5;3;115.3;54.200000000000003;61.100000000000001;52.299999999999997;10;10;62;23;14;8;8;64;30;24;18;262;3436
6;160419;Parada;48;59;46;54;24;17;24;16;0;1;0;5.8819999999999997;4;14;22;0;1;0;0;87.900000000000006;39.399999999999999;48.399999999999999;46.409999999999997;2;10;26;4;6;6;7;31;6;9;18;262;3439
6;160504;Cossourado;150;169;146;171;73;60;61;53;12;7;16.437999999999999;11.667;6;48;60;3;1;9;6;64.299999999999997;30.199999999999999;34.100000000000001;45.149999999999999;17;20;86;14;13;18;15;87;23;26;18;263;3456
6;160514;Padornelo;205;232;198;229;100;84;90;73;10;11;10;13.095000000000001;11;57;95;1;2;9;9;65.599999999999994;30.800000000000001;34.799999999999997;46.490000000000002;26;20;113;22;24;30;22;109;30;41;18;263;3466
6;160613;Nogueira;195;215;186;208;85;82;78;72;7;10;8.2349999999999994;12.195;6;56;88;1;2;6;8;205.69999999999999;97.799999999999997;107.90000000000001;42.560000000000002;31;21;106;27;10;25;29;110;35;16;18;264;3486
6;160615;Paço Vedro de Magalhães;471;496;457;481;216;212;202;188;14;24;6.4809999999999999;11.321;2;118;270;4;2;10;22;374.30000000000001;182.30000000000001;192;41.350000000000001;80;52;266;54;19;58;51;284;62;41;18;264;3488
6;160618;Touvedo (Salvador);85;82;79;75;39;24;28;16;11;8;28.204999999999998;33.332999999999998;0;24;20;1;3;10;5;55.399999999999999;28.199999999999999;27.199999999999999;47.689999999999998;8;13;40;15;9;10;7;37;15;13;18;264;3492
6;160702;Arca;427;458;396;433;238;213;213;179;25;34;10.504;15.962;6;85;301;7;7;18;27;391;188.69999999999999;202.40000000000001;38.710000000000001;77;58;239;31;22;65;66;257;36;34;18;265;3500
6;160705;Ardegão;118;115;107;113;51;40;44;35;7;5;13.725;12.5;7;40;32;0;0;7;5;78;39.5;38.5;44.43;19;16;59;10;14;13;12;62;15;13;18;265;3503
6;160713;Calheiros;463;528;421;509;253;170;231;144;22;26;8.6959999999999997;15.294;18;195;162;2;3;20;23;116.59999999999999;54.5;62.100000000000001;40.850000000000001;65;52;273;37;36;93;51;277;53;54;18;265;3511
6;160720;Fojo Lobal;137;143;111;139;64;31;59;27;5;4;7.8129999999999997;12.903;3;56;27;0;0;5;4;84.799999999999997;41.5;43.299999999999997;38.759999999999998;30;18;70;13;6;29;10;72;20;12;18;265;3518
6;160736;Queijada;131;143;125;142;64;49;59;38;5;11;7.8129999999999997;22.449000000000002;0;43;54;1;0;4;11;116.90000000000001;55.899999999999999;61;39.670000000000002;22;17;72;12;8;27;13;75;17;11;18;265;3534
6;160741;Sandiães;211;224;199;219;93;92;83;71;10;21;10.753;22.826000000000001;5;63;86;1;5;9;16;131.30000000000001;63.700000000000003;67.599999999999994;44.530000000000001;38;28;92;29;24;22;18;122;28;34;18;265;3541
6;160745;Seara;349;365;332;363;203;154;186;123;17;31;8.3740000000000006;20.129999999999999;11;163;135;2;6;15;25;196.40000000000001;96;100.40000000000001;37.229999999999997;62;48;202;22;15;60;48;207;24;26;18;265;3544
6;160802;Boivão;105;134;104;134;37;21;30;21;7;0;18.919;0;5;23;23;1;0;6;0;30;13.199999999999999;16.800000000000001;49.670000000000002;12;13;51;11;18;15;7;59;27;26;18;266;3551
6;160809;Gondomil;127;174;125;172;53;42;47;40;6;2;11.321;4.7620000000000005;9;38;40;1;0;5;2;31.699999999999999;13.4;18.300000000000001;53.57;11;7;63;21;25;16;9;72;33;44;18;266;3558
6;160816;Verdoejo;292;316;277;304;141;112;132;106;9;6;6.383;5.3570000000000002;9;77;152;1;2;8;4;143.59999999999999;69;74.599999999999994;47.100000000000001;27;27;177;34;27;30;26;167;42;51;18;266;3565
6;160904;Anha;1136;1279;1072;1245;577;535;498;441;79;94;13.692;17.57;20;370;549;13;17;66;77;256.89999999999998;120.90000000000001;136.09999999999999;45.009999999999998;134;139;623;127;113;148;132;673;147;179;18;267;3569
6;160911;Darque;3772;4045;3527;3931;1890;1808;1649;1492;241;316;12.750999999999999;17.478000000000002;61;997;2083;41;60;200;256;867.10000000000002;418.39999999999998;448.69999999999999;39.090000000000003;685;461;2132;299;195;605;457;2302;362;319;18;267;3577
6;160913;Deocriste;384;392;361;380;199;149;185;127;14;22;7.0350000000000001;14.765000000000001;6;144;162;2;4;12;18;104.5;51.700000000000003;52.799999999999997;40.219999999999999;78;48;198;36;24;54;43;212;47;36;18;267;3579
6;160914;Freixieiro de Soutelo;245;266;224;264;124;92;109;82;15;10;12.097;10.869999999999999;12;78;101;1;0;14;10;43.399999999999999;20.800000000000001;22.600000000000001;44.659999999999997;40;25;139;22;19;25;28;138;34;41;18;267;3580
6;160923;Neiva;570;655;552;633;302;297;264;236;38;61;12.583;20.539000000000001;11;248;241;7;5;31;56;174.40000000000001;81.200000000000003;93.299999999999997;41.520000000000003;89;72;324;41;44;94;65;357;78;61;18;267;3588
6;160924;Nogueira;415;501;391;489;202;183;179;157;23;26;11.385999999999999;14.208;11;127;198;4;4;19;22;78.099999999999994;35.399999999999999;42.700000000000003;43.600000000000001;67;48;214;41;45;74;56;230;63;78;18;267;3589
6;160929;Geraz do Lima (Santa Leocádia);423;493;403;482;203;167;192;137;11;30;5.4189999999999996;17.963999999999999;6;175;148;1;1;10;29;110.59999999999999;51.100000000000001;59.5;42.710000000000001;71;52;206;51;43;76;50;248;57;62;18;267;3581
6;160934;Torre;299;316;296;315;152;132;135;113;17;19;11.183999999999999;14.394;5;87;156;4;3;13;16;177.09999999999999;86.099999999999994;91;41.200000000000003;57;38;160;22;22;36;41;165;35;39;18;267;3597
6;161004;Covas;313;362;307;355;128;104;117;96;11;8;8.5939999999999994;7.6920000000000002;18;89;106;1;0;10;8;23.600000000000001;10.9;12.699999999999999;49.25;35;35;155;52;36;36;30;170;45;81;18;268;3609
6;161012;Sapardos;187;179;189;176;91;58;70;48;21;10;23.077000000000002;17.241;7;50;61;2;1;19;9;54.5;27.899999999999999;26.699999999999999;48.020000000000003;25;18;99;26;19;14;13;85;35;32;18;268;3617
6;30104;Bico;368;409;348;397;200;189;183;162;17;27;8.5;14.286;5;114;226;5;4;12;23;338.80000000000001;160.5;178.30000000000001;33.829999999999998;87;38;209;19;15;92;52;227;21;17;4;53;468
6;30105;Caires;414;454;399;454;211;161;190;124;21;37;9.9529999999999994;22.981000000000002;15;146;153;1;11;20;26;184.09999999999999;87.799999999999997;96.299999999999997;39.960000000000001;77;47;227;38;25;73;58;233;43;47;4;53;471
6;30110;Figueiredo;534;570;522;563;284;229;254;194;30;35;10.563000000000001;15.284000000000001;13;165;270;6;6;24;29;346.10000000000002;167.40000000000001;178.69999999999999;38.5;90;57;322;40;25;100;65;328;43;34;4;53;476
6;30115;Paredes Secas;78;88;77;89;40;23;34;19;6;4;15;17.390999999999998;6;15;32;0;2;6;2;94.5;44.399999999999999;50.100000000000001;41.719999999999999;15;13;36;4;10;15;11;34;15;13;4;53;481
6;30212;Balugães;400;441;363;433;221;187;203;164;18;23;8.1449999999999996;12.298999999999999;12;224;131;5;5;13;18;308.5;146.69999999999999;161.80000000000001;40.049999999999997;70;53;225;27;25;68;60;235;31;47;4;54;502
6;30215;Barqueiros;919;1038;858;1004;457;449;413;406;44;43;9.6280000000000001;9.577;63;342;414;6;9;38;34;242.59999999999999;113.90000000000001;128.69999999999999;39.969999999999999;176;125;496;72;50;149;115;581;92;101;4;54;505
6;30226;Couto;178;170;167;167;91;72;86;65;5;7;5.4950000000000001;9.7219999999999995;3;78;70;1;2;4;5;221.90000000000001;113.5;108.40000000000001;39.219999999999999;36;28;95;6;13;20;20;101;7;22;4;54;518
6;30238;Góios;278;270;270;267;141;113;131;97;10;16;7.0919999999999996;14.159000000000001;21;114;93;2;5;8;11;185.09999999999999;93.900000000000006;91.200000000000003;39.100000000000001;63;33;147;20;15;39;25;146;36;24;4;54;532
6;30240;Gueral;184;196;181;194;97;76;95;69;2;7;2.0619999999999998;9.2110000000000003;43;70;51;0;1;2;6;199.19999999999999;96.400000000000006;102.7;40.590000000000003;33;29;89;20;13;34;16;106;25;15;4;54;534
6;30241;Igreja Nova;181;203;171;196;82;71;73;67;9;4;10.975999999999999;5.6340000000000003;4;58;78;5;0;4;4;141;66.5;74.599999999999994;44.659999999999997;27;27;90;16;21;24;21;103;19;36;4;54;535
6;30242;Lama;603;668;576;652;325;289;285;247;40;42;12.308;14.532999999999999;10;304;218;11;6;29;36;389;184.59999999999999;204.5;38.969999999999999;100;91;340;41;31;108;79;376;48;57;4;54;536
6;30244;Macieira de Rates;1029;1054;867;959;581;428;535;372;46;56;7.9169999999999998;13.084;99;403;405;10;13;36;43;265.39999999999998;131.09999999999999;134.30000000000001;36.869999999999997;189;166;578;52;44;194;137;570;76;77;4;54;538
6;30245;Manhente;825;878;756;862;476;445;422;381;54;64;11.345000000000001;14.382;17;430;356;10;12;44;52;435.5;211;224.5;37.75;148;110;479;57;31;154;87;531;64;42;4;54;539
6;30246;Mariz;190;184;173;174;96;85;84;82;12;3;12.5;3.5289999999999999;7;108;51;0;0;12;3;136.09999999999999;69.200000000000003;67;41.789999999999999;27;35;103;14;11;18;20;110;18;18;4;54;540
6;30262;Quintiães;317;327;269;318;174;144;161;130;13;14;7.4710000000000001;9.7219999999999995;15;182;94;1;3;12;11;164.19999999999999;80.799999999999997;83.400000000000006;37.359999999999999;58;45;178;28;8;52;53;172;32;18;4;54;556
6;30270;Bastuço (São João);329;332;307;320;173;149;154;125;19;24;10.983000000000001;16.106999999999999;11;186;82;4;3;15;21;347.19999999999999;172.80000000000001;174.40000000000001;36.539999999999999;70;49;179;21;10;57;41;189;25;20;4;54;507
6;30282;Ucha;681;739;650;728;379;329;339;286;40;43;10.554;13.07;25;363;237;10;6;30;37;332.60000000000002;159.5;173.09999999999999;37.369999999999997;136;98;380;38;29;116;96;421;54;52;4;54;568
6;30283;Várzea;940;964;899;952;518;483;447;418;71;65;13.707000000000001;13.458;9;441;415;10;15;61;50;645;318.39999999999998;326.60000000000002;37.350000000000001;178;120;542;67;33;159;101;575;79;50;4;54;569
6;30285;Vila Boa;1335;1148;1302;1101;633;616;577;549;56;67;8.8469999999999995;10.877000000000001;15;528;583;10;9;46;58;1102.8;592.89999999999998;509.89999999999998;35.530000000000001;262;108;846;76;43;238;132;689;53;36;4;54;571
6;30286;Vila Cova;937;1089;901;1071;491;471;445;429;46;42;9.3689999999999998;8.9169999999999998;44;548;282;8;10;38;32;162.69999999999999;75.200000000000003;87.400000000000006;39.450000000000003;173;119;515;68;62;175;142;567;107;98;4;54;572
6;30289;Vilar do Monte;336;331;304;314;195;167;182;151;13;16;6.6669999999999998;9.5809999999999995;6;218;109;1;2;12;14;136.40000000000001;68.700000000000003;67.700000000000003;36.960000000000001;61;59;186;18;12;51;41;197;26;16;4;54;577
6;30316;Fraião;2206;2399;2061;2312;1344;1387;1242;1261;102;126;7.5890000000000004;9.0839999999999996;6;505;1992;13;22;89;104;3759.9000000000001;1801.2;1958.8;35.600000000000001;407;209;1394;124;72;416;206;1547;118;112;4;55;627
6;30327;Navarra;229;231;218;227;130;121;117;112;13;9;10;7.4379999999999997;13;96;120;3;2;10;7;206.09999999999999;102.59999999999999;103.5;39.780000000000001;30;38;133;13;15;33;31;129;16;22;4;55;656
6;30339;Santa Lucrécia de Algeriz;252;282;246;271;144;128;133;114;11;14;7.6390000000000002;10.938000000000001;6;101;140;5;2;6;12;134;63.200000000000003;70.799999999999997;39.609999999999999;36;31;147;19;19;46;37;149;22;28;4;55;686
6;30344;Este (São Mamede);856;933;828;928;455;446;404;386;51;60;11.209;13.452999999999999;7;232;551;8;6;43;54;272.80000000000001;130.5;142.30000000000001;38.859999999999999;154;93;499;60;50;161;123;532;55;62;4;55;620
6;30345;Merelim (São Paio);1188;1263;1129;1220;644;596;562;498;82;98;12.733000000000001;16.443000000000001;5;446;609;12;12;70;86;1141.5999999999999;553.29999999999995;588.29999999999995;39.329999999999998;192;161;689;86;60;182;164;730;94;93;4;55;650
6;30346;Este (São Pedro);995;1053;950;1042;553;495;503;433;50;62;9.0419999999999998;12.525;6;290;640;11;12;39;50;632.79999999999995;307.39999999999998;325.39999999999998;39.5;170;140;560;78;47;162;113;609;90;79;4;55;621
6;30352;Braga (Sé);1544;1814;1451;1739;830;873;703;728;127;145;15.301;16.609000000000002;0;344;1087;27;29;100;116;9141.7000000000007;4203.3999999999996;4938.3999999999996;41.340000000000003;237;197;912;110;88;214;225;1032;167;176;4;55;597
6;30356;Tadim;553;590;535;569;297;308;269;276;28;32;9.4280000000000008;10.390000000000001;4;208;333;5;12;23;20;426.39999999999998;206.30000000000001;220.09999999999999;38.149999999999999;108;68;307;35;35;96;59;349;31;55;4;55;701
6;30358;Tenões;666;714;648;707;409;390;376;343;33;47;8.0679999999999996;12.051;2;147;570;5;10;28;37;828.20000000000005;399.69999999999999;428.5;39.399999999999999;89;84;424;46;23;87;78;445;56;48;4;55;703
6;30360;Vilaça;395;399;388;395;210;195;184;166;26;29;12.381;14.872;2;153;195;8;4;18;25;505.5;251.5;254;41.829999999999998;47;47;238;40;23;53;34;243;43;26;4;55;707
6;30603;Belinho;981;1036;899;1007;512;433;460;358;52;75;10.156000000000001;17.321000000000002;33;393;392;9;12;43;63;306.10000000000002;148.90000000000001;157.19999999999999;38.719999999999999;193;124;525;80;59;170;137;534;106;89;4;58;750
6;30608;Forjães;1307;1460;1218;1414;722;669;660;574;62;95;8.5869999999999997;14.199999999999999;20;620;594;9;21;53;74;333.19999999999999;157.40000000000001;175.80000000000001;39.689999999999998;217;157;761;96;76;247;137;810;127;139;4;58;755
6;31009;Gondoriz;147;148;148;152;49;44;43;29;6;15;12.244999999999999;34.091000000000001;13;15;44;1;1;5;14;39.899999999999999;19.899999999999999;20;45.979999999999997;29;8;70;20;20;21;11;75;12;29;4;61;836
6;31302;Arcozelo;187;218;182;216;89;80;77;68;12;12;13.483000000000001;15;9;89;47;3;5;9;7;124;57.299999999999997;66.799999999999997;39.130000000000003;39;20;104;18;6;39;24;125;15;15;4;64;916
6;31328;Moure;681;740;645;722;356;270;325;230;31;40;8.7080000000000002;14.815;22;270;263;5;14;26;26;315.69999999999999;151.30000000000001;164.40000000000001;38.079999999999998;134;107;358;47;35;122;85;405;67;61;4;64;946
6;31337;Ponte;229;254;221;248;121;82;99;69;22;13;18.181999999999999;15.853999999999999;9;53;106;9;3;13;10;141.59999999999999;67.099999999999994;74.400000000000006;42.240000000000002;32;34;129;22;12;41;20;127;28;38;4;64;957
6;31353;Travassós;108;110;102;109;53;40;50;35;3;5;5.6600000000000001;12.5;3;35;47;1;2;2;3;215.69999999999999;106.8;108.8;38.530000000000001;16;21;55;7;9;20;15;53;10;12;4;64;964
6;30707;Cepães;681;729;664;709;331;315;280;263;51;52;15.407999999999999;16.507999999999999;7;348;188;9;10;42;42;338.30000000000001;163.40000000000001;174.90000000000001;41.210000000000001;113;80;395;49;44;92;91;393;65;88;4;59;771
6;30713;Freitas;266;319;263;318;100;103;83;95;17;8;17;7.7670000000000003;10;101;67;2;1;15;7;88.5;40.200000000000003;48.200000000000003;43.100000000000001;43;44;130;22;27;42;34;161;42;40;4;59;777
6;30716;Medelo;773;829;737;809;398;374;352;308;46;66;11.558;17.646999999999998;1;309;350;6;4;40;62;636.39999999999998;307.10000000000002;329.30000000000001;38.759999999999998;146;95;438;68;26;129;101;478;67;54;4;59;780
6;30719;Passos;531;545;504;550;273;199;242;169;31;30;11.355;15.074999999999999;13;287;111;7;9;24;21;262.69999999999999;129.59999999999999;133;38.18;102;80;284;35;30;98;71;276;46;54;4;59;783
6;30723;Regadas;805;861;795;855;383;318;342;280;41;38;10.705;11.949999999999999;9;361;252;5;3;36;35;285.10000000000002;137.69999999999999;147.30000000000001;39.990000000000002;149;96;462;55;43;132;89;481;90;69;4;59;787
6;30734;Várzea Cova;172;186;164;184;72;42;52;31;20;11;27.777999999999999;26.190000000000001;6;38;39;3;4;17;7;30.100000000000001;14.4;15.6;46.240000000000002;24;21;91;20;16;19;18;85;35;29;4;59;796
6;30801;Aldão;629;664;614;656;359;366;318;314;41;52;11.420999999999999;14.208;2;268;362;7;10;34;42;833.39999999999998;405.39999999999998;428;34.359999999999999;121;84;369;38;17;127;97;395;29;16;4;55;582
6;30805;Balazar;211;229;197;228;113;99;101;89;12;10;10.619;10.101000000000001;4;100;86;2;0;10;10;126.90000000000001;60.899999999999999;66;39.479999999999997;34;22;126;18;11;38;29;119;17;26;4;55;589
6;30818;Gémeos;214;228;209;228;123;99;108;81;15;18;12.195;18.181999999999999;3;142;44;4;4;11;14;290;140.40000000000001;149.59999999999999;36.43;41;30;117;19;7;47;30;116;18;17;4;55;630
6;30821;Gondar;1408;1460;1340;1422;750;743;617;590;133;153;17.733000000000001;20.591999999999999;7;663;537;12;20;121;133;1165.4000000000001;572.10000000000002;593.20000000000005;39.189999999999998;234;171;839;110;54;208;167;882;131;72;4;55;633
6;30833;Oleiros;221;241;217;238;111;108;101;92;10;16;9.0090000000000003;14.815;3;113;77;2;5;8;11;139.59999999999999;66.799999999999997;72.799999999999997;40.109999999999999;34;40;116;15;16;38;34;125;23;21;4;55;660
6;30836;Pinheiro;603;631;592;618;331;319;287;252;44;67;13.292999999999999;21.003;6;288;245;7;10;37;57;638.5;312;326.5;38.049999999999997;104;87;344;41;27;95;101;353;49;33;4;55;671
6;30845;Souto (Santa Maria);400;371;394;367;210;181;186;156;24;25;11.429;13.811999999999999;13;221;108;2;1;22;24;175;90.799999999999997;84.200000000000003;36.799999999999997;91;53;212;22;22;61;40;216;32;22;4;55;698
6;30857;Candoso (São Martinho);657;683;633;666;343;312;290;245;53;67;15.452;21.474;18;301;216;11;3;42;64;606.79999999999995;297.5;309.30000000000001;43.829999999999998;73;92;388;51;53;68;80;401;61;73;4;55;606
6;30907;Esperança;149;190;147;192;41;34;33;28;8;6;19.512;17.646999999999998;3;25;33;2;0;6;6;77.799999999999997;34.200000000000003;43.600000000000001;48.109999999999999;16;20;72;19;22;19;25;89;23;34;4;60;805
6;30913;Garfe;458;542;455;535;220;212;179;170;41;42;18.635999999999999;19.811;8;166;175;7;8;34;34;184;84.299999999999997;99.700000000000003;42.009999999999998;75;62;239;41;41;79;58;289;53;63;4;60;811
6;30926;Taíde;776;837;735;817;374;337;334;284;40;53;10.695;15.727;5;339;274;8;19;32;34;243.30000000000001;117.09999999999999;126.3;39.829999999999998;149;95;423;55;54;132;98;457;55;95;4;60;824
6;30928;Verim;169;184;169;189;73;50;64;43;9;7;12.329000000000001;14;10;43;54;2;3;7;4;131.5;62.899999999999999;68.5;44.950000000000003;21;26;77;25;20;26;19;92;24;23;4;60;826
6;30929;Vilela;284;331;270;322;136;136;118;121;18;15;13.234999999999999;11.029;8;114;117;2;8;16;7;134.5;62.100000000000001;72.400000000000006;39.469999999999999;53;39;152;20;20;56;49;162;29;35;4;60;827
6;31101;Anissó;99;116;90;115;38;36;35;25;3;11;7.8949999999999996;30.556000000000001;12;23;25;0;0;3;11;60.399999999999999;27.800000000000001;32.600000000000001;46.329999999999998;12;12;45;15;15;14;17;51;19;15;4;62;845
6;31105;Cantelães;396;432;380;421;190;136;159;108;31;28;16.315999999999999;20.588000000000001;11;66;190;2;3;29;25;71.700000000000003;34.299999999999997;37.399999999999999;43.560000000000002;42;67;214;42;31;55;61;210;48;58;4;62;849
6;31110;Mosteiro;388;386;364;376;178;118;146;96;32;22;17.978000000000002;18.643999999999998;8;99;135;7;4;25;18;70.400000000000006;35.299999999999997;35.100000000000001;42.32;62;47;218;34;27;50;44;208;43;41;4;62;854
6;31211;Cavalões;743;796;721;773;408;364;366;299;42;65;10.294;17.856999999999999;23;337;305;4;4;38;61;282.19999999999999;136.19999999999999;146;38.509999999999998;126;106;419;58;34;126;107;439;73;51;4;63;878
6;31228;Novais;554;570;537;549;314;284;270;244;44;40;14.013;14.085000000000001;6;280;228;7;5;37;35;774.39999999999998;381.69999999999999;392.69999999999999;37.420000000000002;108;60;342;28;16;94;58;347;39;32;4;63;895
6;31230;Pedome;1052;1068;997;1034;551;520;445;423;106;97;19.238;18.654;3;541;324;9;15;97;82;805.79999999999995;399.89999999999998;406;39.869999999999997;173;122;617;78;62;145;136;602;106;79;4;63;899
6;31232;Pousada de Saramagos;1084;1150;1042;1130;569;562;482;462;87;100;15.289999999999999;17.794;4;525;415;17;23;70;77;1053.5999999999999;511.30000000000001;542.39999999999998;37.420000000000002;212;138;603;83;48;216;110;673;88;63;4;63;901
6;31243;Seide (São Miguel);565;606;544;600;292;266;244;221;48;45;16.437999999999999;16.917000000000002;6;266;193;10;10;38;35;780.10000000000002;376.39999999999998;403.69999999999999;40.329999999999998;95;64;321;51;34;90;57;349;71;39;4;63;906
6;31248;Vila Nova de Famalicão;3947;4531;3856;4468;2273;2399;1993;2040;280;359;12.319000000000001;14.965;19;1180;2834;50;62;230;297;3855.4000000000001;1794.9000000000001;2060.5;38.710000000000001;666;464;2408;256;153;677;511;2736;297;310;4;63;913
6;131402;Água Longa;1081;1126;1036;1115;605;520;518;428;87;92;14.380000000000001;17.692;28;411;507;13;15;74;77;171.40000000000001;84;87.5;39.850000000000001;190;140;617;77;57;178;102;660;100;86;15;220;2966
6;131410;Guimarei;358;380;343;370;204;183;173;154;31;29;15.196;15.847;8;141;178;5;5;26;24;92.299999999999997;44.799999999999997;47.5;42.859999999999999;41;49;209;29;30;53;33;228;26;40;15;220;2974
6;131415;Palmeira;617;704;602;699;327;311;283;266;44;45;13.456;14.468999999999999;2;270;277;8;3;36;42;415.19999999999999;193.90000000000001;221.30000000000001;40.909999999999997;97;68;360;55;37;104;77;399;67;57;15;220;2980
6;130402;Fânzeres;11232;11876;10750;11603;6147;5684;5174;4665;973;1019;15.829000000000001;17.928000000000001;39;2372;7428;164;157;809;862;2862.8000000000002;1391.5;1471.3;38.460000000000001;2044;1337;6558;774;519;1929;1284;6971;937;755;15;210;2767
6;130406;Medas;1053;1076;985;1055;556;425;483;342;73;83;13.129;19.529;1;327;497;11;18;62;65;203.40000000000001;100.59999999999999;102.8;41.810000000000002;149;136;614;88;66;130;129;616;110;91;15;210;2772
6;130411;Valbom;6880;7527;6645;7397;3621;3424;2979;2806;642;618;17.73;18.048999999999999;17;1239;4529;103;91;539;527;3284;1568.3;1715.7;41.719999999999999;1069;782;3993;633;403;1034;756;4340;733;664;15;210;2776
6;130805;Leça da Palmeira;8716;9786;8532;9474;4696;4643;4052;4013;644;630;13.714;13.568999999999999;41;1551;6473;117;136;527;494;2589.9000000000001;1220;1369.8;41.560000000000002;1332;995;5074;782;533;1306;980;5769;886;845;15;214;2853
6;130806;Matosinhos;14429;16555;13666;16028;7689;7719;6506;6605;1183;1114;15.385999999999999;14.432;93;2329;10689;207;207;976;907;6182.3000000000002;2879;3303.1999999999998;41.259999999999998;2306;1589;8429;1267;838;2273;1582;9535;1655;1510;15;214;2855
6;130809;São Mamede de Infesta;10745;12377;10786;12590;5710;5875;4825;4962;885;913;15.499000000000001;15.539999999999999;35;1826;7926;171;167;714;746;4623.3999999999996;2148.5;2474.9000000000001;42.280000000000001;1505;1249;6298;1003;690;1529;1188;7197;1222;1241;15;214;2858
6;131304;Argivai;1002;1161;962;1154;539;474;465;381;74;93;13.728999999999999;19.620000000000001;34;293;519;5;9;69;84;762.89999999999998;353.39999999999998;409.5;39.310000000000002;166;126;578;95;37;184;145;655;103;74;15;219;2956
6;131308;Laundos;976;1079;933;1064;526;400;465;363;61;37;11.597;9.25;53;420;355;13;3;48;34;241;114.5;126.5;37.899999999999999;171;139;558;79;29;198;131;603;85;62;15;219;2960
6;131310;Póvoa de Varzim;13243;15177;12403;14719;6968;6909;5948;5649;1020;1260;14.638;18.236999999999998;586;2510;8501;175;184;845;1076;5808.1000000000004;2706.4000000000001;3101.6999999999998;40.380000000000003;2182;1678;7519;1100;764;2181;1658;8586;1449;1303;15;219;2962
6;131311;Rates;1234;1271;1188;1254;679;583;625;512;54;71;7.9530000000000003;12.178000000000001;139;494;504;8;15;46;56;180.30000000000001;88.799999999999997;91.5;38.289999999999999;245;167;687;79;56;204;149;713;87;118;15;219;2963
6;131501;Alfena;7372;7839;6964;7618;4077;3679;3457;2976;620;703;15.207000000000001;19.108000000000001;35;2037;4361;92;116;528;587;1369.7;663.79999999999995;705.89999999999998;38.649999999999999;1344;848;4302;547;331;1241;862;4580;609;547;15;222;2997
6;131603;Aveleda;633;681;599;670;344;300;287;249;57;51;16.57;17;8;200;328;9;7;48;44;355;171;184;43.579999999999998;78;65;380;58;52;81;68;386;82;64;15;223;3004
6;131612;Junqueira;977;1042;920;1021;520;469;450;400;70;69;13.462;14.712;45;430;375;9;12;61;57;295.69999999999999;143.09999999999999;152.59999999999999;40.299999999999997;159;122;564;85;47;169;115;569;94;95;15;223;3013
6;131622;Rio Mau;900;962;845;935;515;425;455;369;60;56;11.65;13.176;91;372;361;7;9;53;47;188.40000000000001;91.099999999999994;97.299999999999997;38.82;162;114;521;57;46;155;122;535;80;70;15;223;3023
6;131624;Touguinha;970;1030;891;1011;511;477;453;396;58;81;11.35;16.981000000000002;35;303;511;10;8;48;73;621.60000000000002;301.5;320.10000000000002;36.829999999999998;188;109;572;59;42;195;111;588;66;70;15;223;3025
6;131628;Vila do Conde;13730;14906;12466;14701;7394;6762;6531;5574;863;1188;11.672000000000001;17.568999999999999;1535;2859;7711;154;162;709;1026;4224.3999999999996;2025.5;2198.9000000000001;38.75;2414;1832;7929;974;581;2357;1654;8584;1182;1129;15;223;3029
6;131630;Vilar de Pinheiro;1233;1304;1186;1279;661;617;570;512;91;105;13.766999999999999;17.018000000000001;19;407;656;12;19;79;86;670.5;325.89999999999998;344.69999999999999;41.759999999999998;205;142;688;118;80;170;124;756;141;113;15;223;3030
6;131707;Gulpilhares;5432;5909;5122;5748;2973;2877;2564;2440;409;437;13.757;15.189;31;1261;3712;52;66;357;371;2071.6999999999998;992.29999999999995;1079.4000000000001;39.200000000000003;1031;492;3208;427;274;984;543;3465;444;473;15;224;3038
6;131711;Olival;2807;3005;2724;2959;1500;1289;1242;1024;258;265;17.199999999999999;20.559000000000001;15;974;1277;37;43;221;222;720;347.80000000000001;372.30000000000001;39.530000000000001;485;359;1605;229;129;468;339;1721;287;190;15;224;3042
6;131724;Vilar do Paraíso;6652;7226;6302;7019;3651;3602;3100;2933;551;669;15.092000000000001;18.573;16;1384;4633;79;92;472;577;2620.1999999999998;1255.9000000000001;1364.3;39.979999999999997;1157;746;3923;500;326;1023;721;4338;604;540;15;224;3055
6;30407;Cavez;623;645;606;630;279;196;248;152;31;44;11.111000000000001;22.449000000000002;81;112;207;9;23;22;21;47.299999999999997;23.300000000000001;24.100000000000001;46.850000000000001;80;75;314;79;75;72;62;313;85;113;4;56;715
6;30510;Fervença;701;744;653;728;362;264;321;201;41;63;11.326000000000001;23.864000000000001;34;236;252;8;35;33;28;119.90000000000001;58.200000000000003;61.799999999999997;39.909999999999997;103;100;392;55;51;120;104;390;63;67;4;57;737
6;30514;Molares;291;330;299;320;145;120;119;100;26;20;17.931000000000001;16.667000000000002;7;64;148;3;6;23;14;202.30000000000001;94.799999999999997;107.5;42.039999999999999;48;39;151;25;28;49;40;156;32;53;4;57;741
6;30518;Ribas;494;574;452;550;234;162;204;129;30;33;12.821;20.370000000000001;14;180;139;7;6;23;27;129;59.700000000000003;69.299999999999997;42.82;66;70;275;38;45;72;81;280;55;86;4;57;745
6;130104;Ataíde;470;532;432;515;244;192;220;171;24;21;9.8360000000000003;10.938000000000001;6;161;224;2;4;22;17;624;292.69999999999999;331.30000000000001;39.920000000000002;79;58;261;42;30;84;64;298;45;41;15;207;2677
6;130105;Bustelo;246;275;213;255;128;98;105;74;23;24;17.969000000000001;24.489999999999998;22;78;79;2;7;21;17;67.799999999999997;32;35.799999999999997;43.289999999999999;35;29;130;30;22;36;38;138;37;26;15;207;2678
6;130107;Candemil;367;404;351;394;174;102;147;68;27;34;15.516999999999999;33.332999999999998;12;110;93;4;21;23;13;64.200000000000003;30.600000000000001;33.600000000000001;44.609999999999999;57;42;195;34;39;48;42;199;53;62;15;207;2680
6;130112;Fregim;1345;1491;1244;1435;718;526;659;444;59;82;8.2170000000000005;15.589;22;591;490;11;19;48;63;273.5;129.69999999999999;143.80000000000001;39.009999999999998;251;153;752;111;78;275;175;773;112;156;15;207;2687
6;130123;Mancelos;1522;1592;1437;1557;818;553;758;437;60;116;7.335;20.975999999999999;23;731;441;18;24;42;92;256.69999999999999;125.40000000000001;131.19999999999999;39.020000000000003;263;201;851;117;90;243;216;903;125;105;15;207;2699
6;130130;Sanche;238;271;232;266;127;90;115;59;12;31;9.4489999999999998;34.444000000000003;15;69;90;0;9;12;22;140.90000000000001;65.900000000000006;75;38.960000000000001;45;39;124;21;9;47;38;129;26;31;15;207;2706
6;130314;Pinheiro;522;520;531;533;269;228;247;202;22;26;8.1780000000000008;11.404;11;284;154;3;4;19;22;291.5;146;145.5;36.909999999999997;116;64;287;32;23;87;62;289;41;41;15;209;2747
6;130316;Rande;446;536;421;517;254;252;227;231;27;21;10.630000000000001;8.3330000000000002;11;296;151;7;2;20;19;476.19999999999999;216.30000000000001;259.89999999999998;37.789999999999999;67;67;266;28;18;84;89;293;37;33;15;209;2749
6;130323;Vizela (São Jorge);284;290;279;289;156;132;148;122;8;10;5.1280000000000001;7.5759999999999996;4;226;40;3;5;5;5;528;261.19999999999999;266.80000000000001;37.549999999999997;51;40;157;25;11;54;33;165;26;12;15;209;2764
6;130324;Sendim;781;846;751;823;464;425;424;388;40;37;8.6210000000000004;8.7059999999999995;18;545;249;5;10;35;27;231.40000000000001;111.09999999999999;120.3;37.090000000000003;150;102;464;35;30;142;124;472;51;57;15;209;2754
6;130502;Aveleda;1004;1069;936;1048;555;476;484;410;71;66;12.792999999999999;13.866;16;530;348;12;10;59;56;544;263.5;280.5;34.170000000000002;221;146;560;51;26;211;177;594;50;37;15;211;2778
6;130510;Lodares;959;1043;885;1014;529;473;472;416;57;57;10.775;12.051;9;496;383;8;14;49;43;515.39999999999998;246.90000000000001;268.5;35.899999999999999;194;131;540;59;35;202;126;588;65;62;15;211;2787
6;130514;Nespereira;1033;1052;980;1034;583;491;506;407;77;84;13.208;17.108000000000001;7;460;446;12;14;65;70;944.70000000000005;468.10000000000002;476.69999999999999;37.369999999999997;202;125;598;67;41;161;123;635;73;60;15;211;2793
6;130515;Nevogilde;1310;1307;1236;1282;733;589;617;494;116;95;15.824999999999999;16.129000000000001;9;744;358;16;6;100;89;761.29999999999995;381.10000000000002;380.19999999999999;35.670000000000002;279;174;729;82;46;241;188;729;90;59;15;211;2794
6;130520;Lousada (Santa Margarida);144;163;138;161;84;72;71;61;13;11;15.475999999999999;15.278;5;72;55;3;2;10;9;110.2;51.700000000000003;58.5;39.960000000000001;22;22;78;17;5;23;24;92;14;10;15;211;2788
6;130727;Tuias;1971;2123;1761;2030;1177;1021;1038;822;139;199;11.81;19.491;21;667;1172;29;47;110;152;633.70000000000005;305.10000000000002;328.60000000000002;34.890000000000001;410;242;1176;87;56;415;249;1261;102;96;15;213;2845
6;130911;Modelos;758;836;731;827;437;344;355;285;82;59;18.763999999999999;17.151;4;422;214;15;18;67;41;744.29999999999995;353.89999999999998;390.39999999999998;36.659999999999997;120;121;436;59;22;161;123;435;74;43;15;215;2870
6;131006;Bitarães;1395;1473;1328;1432;778;656;719;595;59;61;7.5839999999999996;9.2989999999999995;19;536;759;15;19;44;42;717.39999999999998;349;368.5;36.030000000000001;264;202;800;83;46;256;204;841;109;63;15;216;2881
6;131010;Duas Igrejas;1943;1936;1805;1900;1065;776;910;630;155;146;14.554;18.814;27;977;536;26;31;129;115;1026.3;514.10000000000002;512.20000000000005;33.460000000000001;496;278;1025;98;46;382;320;1042;127;65;15;216;2885
6;131013;Lordelo;4993;5032;4802;4938;2862;2191;2374;1708;488;483;17.050999999999998;22.045000000000002;10;2296;1776;51;72;437;411;1027.3;511.69999999999999;515.70000000000005;37.5;878;640;2961;331;183;888;655;2795;383;311;15;216;2888
6;131018;Rebordosa;4458;4648;4310;4591;2496;2013;2155;1625;341;388;13.662000000000001;19.274999999999999;26;1862;1892;56;99;285;289;846.10000000000002;414.19999999999999;431.89999999999998;37.520000000000003;835;608;2520;316;179;835;538;2605;387;283;15;216;2893
6;131024;Vilela;2524;2636;2344;2565;1405;1060;1145;824;260;236;18.504999999999999;22.263999999999999;18;1270;681;29;52;231;184;1101.7;538.89999999999998;562.79999999999995;34.350000000000001;533;386;1390;131;84;551;403;1422;142;118;15;216;2899
6;131110;Eja;531;579;477;568;290;181;246;149;44;32;15.172000000000001;17.68;21;205;169;2;4;42;28;219.69999999999999;105.09999999999999;114.59999999999999;40.619999999999997;77;66;313;40;35;98;73;299;52;57;15;217;2909
6;170907;Santo Aleixo de Além-Tâmega;175;193;169;187;58;46;56;34;2;12;3.448;26.087;7;29;54;1;4;1;8;29.800000000000001;14.199999999999999;15.6;50.149999999999999;25;6;91;32;21;17;10;110;24;32;19;277;3784
6;180402;Bustelo;56;59;54;56;35;17;24;14;11;3;31.428999999999998;17.646999999999998;22;8;8;0;0;11;3;17.600000000000001;8.5999999999999996;9;44.030000000000001;6;11;30;4;5;9;3;29;8;10;20;286;3938
6;180405;Ferreiros de Tendais;343;352;317;329;102;49;83;35;19;14;18.626999999999999;28.571000000000002;26;35;57;5;7;14;7;43.5;21.399999999999999;22;46.439999999999998;48;45;157;46;47;42;37;149;54;70;20;286;3941
6;180412;Santiago de Piães;877;920;766;885;469;208;369;139;100;69;21.321999999999999;33.173000000000002;28;299;181;5;38;95;31;102.2;49.899999999999999;52.299999999999997;40.200000000000003;144;124;484;75;50;121;124;483;114;78;20;286;3948
6;181301;Anreade;529;585;507;566;252;169;230;124;22;45;8.7300000000000004;26.626999999999999;31;130;193;1;13;21;32;196.19999999999999;93.200000000000003;103;38.909999999999997;103;74;287;35;30;91;87;292;57;58;20;295;4069
6;181309;Panchorra;65;67;66;65;29;10;26;8;3;2;10.345000000000001;20;6;15;13;0;1;3;1;11.300000000000001;5.5999999999999996;5.7000000000000002;50.289999999999999;9;;34;9;13;7;1;35;9;15;20;295;4077
6;181315;São Romão de Aregos;180;177;182;185;66;29;54;27;12;2;18.181999999999999;6.8970000000000002;7;35;39;1;1;11;1;86;43.399999999999999;42.600000000000001;44.670000000000002;30;28;81;21;20;28;9;84;31;25;20;295;4083
6;10408;Covelo de Paivó;45;58;46;58;17;14;17;10;0;4;0;28.571000000000002;12;6;9;0;1;0;3;3.8999999999999999;1.7;2.2000000000000002;54.659999999999997;2;3;23;7;10;7;5;22;12;12;1;4;51
6;10417;São Miguel do Mato;281;317;279;314;137;101;128;93;9;8;6.569;7.9210000000000003;23;133;65;3;0;6;8;35;16.399999999999999;18.5;42.289999999999999;55;23;160;17;26;49;27;162;33;46;1;4;60
6;10418;Tropeço;554;596;517;559;303;189;284;164;19;25;6.2709999999999999;13.228;60;220;168;2;11;17;14;64.5;31.100000000000001;33.399999999999999;40.299999999999997;92;81;305;46;30;90;72;318;63;53;1;4;61
6;10419;Urrô;512;517;475;494;249;174;243;153;6;21;2.4100000000000001;12.069000000000001;30;150;216;1;8;5;13;95.400000000000006;47.5;47.899999999999999;42.920000000000002;77;62;274;43;56;75;52;272;56;62;1;4;62
6;10420;Várzea;261;279;245;290;145;123;137;112;8;11;5.5170000000000003;8.9429999999999996;16;110;123;0;1;8;10;301.5;145.69999999999999;155.80000000000001;39.299999999999997;50;23;153;24;11;50;19;169;26;15;1;4;63
6;10919;Paços de Brandão;2365;2502;2286;2443;1266;1195;1098;1003;168;192;13.27;16.067;12;987;1102;23;43;145;149;1368.5999999999999;665;703.60000000000002;42.100000000000001;361;284;1343;208;169;317;226;1464;244;251;1;15;166
6;10924;Sanguedo;1735;1865;1636;1801;887;724;751;587;136;137;15.333;18.923000000000002;5;598;735;24;28;112;109;788.5;380;408.5;38.259999999999998;345;225;945;138;82;309;245;1031;155;125;1;15;171
6;11301;Carregosa;1664;1755;1608;1731;956;793;894;728;62;65;6.4850000000000003;8.1969999999999992;19;1059;544;13;10;49;55;289.30000000000001;140.80000000000001;148.5;41.460000000000001;231;226;950;148;109;246;182;978;177;172;1;12;115
6;11309;Oliveira de Azeméis;5778;6426;5447;6206;3219;3103;2977;2792;242;311;7.5179999999999998;10.023;22;2576;3171;51;69;191;242;1318.8;624.39999999999998;694.39999999999998;40.5;874;706;3379;463;356;941;713;3658;529;585;1;12;123
6;11314;Santiago de Riba-Ul;1897;2047;1811;1995;1058;947;984;850;74;97;6.9939999999999998;10.243;10;1001;823;15;19;59;78;646.60000000000002;311;335.60000000000002;41.700000000000003;277;194;1113;186;127;274;219;1166;207;181;1;12;128
6;11319;Vila de Cucujães;5216;5489;4955;5294;2842;2509;2585;2242;257;267;9.0429999999999993;10.641999999999999;24;2836;1967;46;39;211;228;1027.2;500.5;526.70000000000005;42.390000000000001;752;572;3021;508;363;725;569;3110;606;479;1;12;133
6;40304;Carrazeda de Ansiães;820;881;776;850;407;353;369;313;38;40;9.3369999999999997;11.331;52;128;502;9;9;29;31;189.80000000000001;91.5;98.299999999999997;41.600000000000001;114;102;477;68;59;145;85;473;77;101;5;68;1052
6;40306;Fonte Longa;152;149;147;147;66;36;58;32;8;4;12.121;11.111000000000001;27;20;43;0;1;8;3;22.600000000000001;11.4;11.199999999999999;54.149999999999999;15;11;78;17;31;7;7;58;32;45;5;68;1054
6;40902;Adeganha;169;174;161;173;71;50;69;47;2;3;2.8170000000000002;6;51;22;43;0;0;2;3;7.0999999999999996;3.5;3.6000000000000001;54.439999999999998;13;16;80;28;32;8;9;82;35;40;5;74;1195
6;40904;Cardanha;104;127;102;126;32;30;30;27;2;3;6.25;10;13;17;27;0;0;2;3;14.4;6.5;7.9000000000000004;55.090000000000003;9;6;43;24;22;11;7;57;17;35;5;74;1197
6;40908;Felgueiras;127;164;120;159;40;32;36;30;4;2;10;6.25;14;18;34;1;1;3;1;12.6;5.5;7.0999999999999996;61.439999999999998;4;12;47;26;38;1;15;52;32;64;5;74;1201
6;41002;Benlhevai;120;114;108;106;61;51;58;47;3;4;4.9180000000000001;7.843;57;10;38;1;2;2;2;20.600000000000001;10.6;10;43.18;16;16;66;13;9;15;7;61;19;12;5;75;1212
6;41010;Samões;167;171;166;164;90;50;75;40;15;10;16.667000000000002;20;15;34;66;4;2;11;8;25.100000000000001;12.4;12.699999999999999;44.759999999999998;20;16;98;22;11;19;14;99;20;19;5;75;1220
6;170104;Casal de Loivos;86;97;78;93;50;34;44;23;6;11;12;32.353000000000002;13;24;30;1;2;5;9;37.899999999999999;17.800000000000001;20.100000000000001;45.299999999999997;11;10;49;10;6;12;6;48;11;20;19;269;3624
6;171004;Gouvinhas;130;137;127;134;71;40;67;36;4;4;5.6340000000000003;10;79;7;17;0;1;4;3;18.199999999999999;8.9000000000000004;9.3000000000000007;45.990000000000002;12;19;73;18;8;13;17;75;16;16;19;278;3788
6;171005;Parada de Pinhão;151;158;146;155;56;43;45;37;11;6;19.643000000000001;13.952999999999999;9;14;59;3;0;8;6;54;26.399999999999999;27.600000000000001;49.859999999999999;15;16;76;21;23;15;11;77;29;26;19;278;3790
6;171009;Sabrosa;609;593;588;589;313;250;281;220;32;30;10.224;12;40;82;379;12;5;20;25;138.40000000000001;70.099999999999994;68.299999999999997;43.130000000000003;90;87;338;47;47;80;58;308;58;89;19;278;3793
6;171012;São Martinho de Antas;427;483;412;467;175;143;163;118;12;25;6.8570000000000002;17.483000000000001;30;52;199;3;6;9;19;57.100000000000001;26.800000000000001;30.300000000000001;46.479999999999997;64;41;212;57;53;61;42;218;66;96;19;278;3796
6;171110;Sever;342;372;319;360;167;100;141;79;26;21;15.568999999999999;21;74;26;120;7;8;19;13;115.8;55.399999999999999;60.299999999999997;48.57;39;40;192;43;28;26;23;197;55;71;19;279;3809
6;171410;Guiães;234;244;214;234;112;52;110;49;2;3;1.786;5.7690000000000001;88;22;49;1;1;1;2;55.799999999999997;27.300000000000001;28.5;45.009999999999998;28;38;129;21;18;24;24;128;31;37;19;282;3868
6;180105;Coura;25;24;24;24;11;7;11;7;0;0;0;0;3;3;12;0;0;0;0;9;4.5999999999999996;4.4000000000000004;48.710000000000001;3;6;12;1;3;;1;14;1;8;20;283;3893
6;180109;Queimada;142;143;139;142;53;29;50;23;3;6;5.6600000000000001;20.690000000000001;15;23;35;1;1;2;5;66.900000000000006;33.299999999999997;33.600000000000001;51.420000000000002;18;18;62;17;27;9;8;60;26;40;20;283;3897
6;180110;Queimadela;125;123;111;115;65;44;58;41;7;3;10.769;6.8179999999999996;17;21;61;2;0;5;3;99.900000000000006;50.399999999999999;49.600000000000001;45.32;17;20;64;12;12;12;11;64;16;20;20;283;3898
6;180505;Cambres;975;1091;878;1041;491;363;410;287;81;76;16.497;20.937000000000001;121;194;382;10;15;71;61;183.19999999999999;86.400000000000006;96.700000000000003;44.090000000000003;139;134;522;106;74;135;107;563;154;132;20;287;3957
6;180517;Penude;801;865;767;833;415;331;352;279;63;52;15.180999999999999;15.710000000000001;33;218;380;13;13;50;39;130;62.5;67.5;41.399999999999999;128;113;445;57;58;117;110;459;67;112;20;287;3971
6;180524;Vila Nova de Souto d' El-Rei;386;438;357;433;171;159;146;131;25;28;14.619999999999999;17.609999999999999;16;61;200;6;14;19;14;93.799999999999997;43.899999999999999;49.799999999999997;46.590000000000003;65;48;183;41;49;52;40;199;47;100;20;287;3977
6;180707;Caria;238;269;239;260;92;77;81;60;11;17;11.957000000000001;22.077999999999999;34;30;77;1;6;10;11;30.300000000000001;14.199999999999999;16.100000000000001;48.32;33;30;114;28;33;27;27;126;40;49;20;289;4002
6;180708;Castelo;117;128;104;117;41;20;38;17;3;3;7.3170000000000002;15;5;25;25;0;0;3;3;26.399999999999999;12.6;13.800000000000001;51.439999999999998;11;9;59;24;14;11;11;60;22;24;20;289;4003
6;180710;Moimenta da Beira;1398;1490;1327;1446;689;671;636;570;53;101;7.6920000000000002;15.052;55;210;941;12;27;41;74;311.69999999999999;150.90000000000001;160.80000000000001;37.289999999999999;283;197;751;82;85;268;191;810;105;116;20;289;4005
6;180713;Passô;159;184;154;182;66;53;64;49;2;4;3.0299999999999998;7.5469999999999997;22;27;64;0;0;2;4;78.799999999999997;36.5;42.299999999999997;45.509999999999998;25;15;79;17;23;21;27;88;25;23;20;289;4008
6;181207;Penela da Beira;174;179;167;173;64;44;56;42;8;2;12.5;4.5449999999999999;17;23;58;4;2;4;0;19.199999999999999;9.5;9.6999999999999993;54.009999999999998;15;23;79;16;41;12;14;70;26;57;20;294;4066
6;181501;Castanheiro do Sul;234;205;231;201;110;51;107;45;3;6;2.7269999999999999;11.765000000000001;84;28;40;0;2;3;4;21.5;11.5;10.1;47.130000000000003;34;21;119;27;33;12;21;117;24;31;20;297;4093
6;181504;Nagozelo do Douro;214;200;200;198;117;59;110;40;7;19;5.9829999999999997;32.203000000000003;105;12;33;6;18;1;1;52.5;27.100000000000001;25.399999999999999;46.259999999999998;31;20;124;18;21;14;21;102;34;29;20;297;4096
6;181507;Riodades;220;242;217;236;95;43;88;37;7;6;7.3680000000000003;13.952999999999999;33;39;53;1;1;6;5;23;11;12.1;48.659999999999997;24;19;111;36;30;31;22;115;32;42;20;297;4099
6;181904;Chavães;191;194;150;153;50;29;49;28;1;1;2;3.448;23;21;33;0;1;1;0;40.799999999999997;20.199999999999999;20.5;41.299999999999997;27;31;101;19;13;35;26;93;18;22;20;301;4158
6;181909;Paradela;61;62;62;63;29;12;29;11;0;1;0;8.3330000000000002;9;10;21;0;0;0;1;19;9.4000000000000004;9.5999999999999996;43.710000000000001;8;5;38;6;4;9;7;29;12;5;20;301;4163
6;181913;Sendim;327;378;280;334;116;70;105;50;11;20;9.4830000000000005;28.571000000000002;9;53;93;0;6;11;14;33.200000000000003;15.4;17.800000000000001;51.340000000000003;29;37;154;54;53;31;35;171;58;83;20;301;4167
6;181914;Tabuaço;824;958;734;907;442;389;397;338;45;51;10.180999999999999;13.111000000000001;32;168;535;11;19;34;32;165.90000000000001;76.700000000000003;89.200000000000003;42.149999999999999;115;90;483;70;66;147;100;524;76;111;20;301;4168
6;181915;Távora;176;198;166;196;80;51;71;47;9;4;11.25;7.843;37;30;51;1;0;8;4;54.200000000000003;25.5;28.699999999999999;42.32;20;26;105;15;10;28;29;99;14;28;20;301;4169
6;181917;Valença do Douro;174;189;137;173;89;56;83;50;6;6;6.742;10.714;45;32;56;0;2;6;4;39.100000000000001;18.800000000000001;20.399999999999999;44.270000000000003;18;27;105;15;9;18;18;104;25;24;20;301;4171
6;182001;Dálvares;335;354;318;343;164;128;151;111;13;17;7.9269999999999996;13.281000000000001;24;56;182;0;2;13;15;247.19999999999999;120.2;127;39.689999999999998;67;35;191;26;16;48;33;221;24;28;20;302;4172
6;40104;Eucisia;68;60;49;45;33;11;30;8;3;3;9.0909999999999993;27.273;15;9;14;0;0;3;3;6;3.2000000000000002;2.7999999999999998;49.619999999999997;5;9;35;13;6;6;3;30;13;8;5;66;983
6;40111;Sambade;235;240;221;224;78;59;68;50;10;9;12.821;15.254;23;28;67;0;2;10;7;15.1;7.5;7.5999999999999996;55.700000000000003;18;12;112;44;49;10;20;91;58;61;5;66;990
6;40114;Soeima;72;70;68;65;24;20;20;10;4;10;16.667000000000002;50;6;8;16;0;1;4;9;10.6;5.4000000000000004;5.2999999999999998;51.25;7;11;28;17;9;4;7;29;15;15;5;66;993
6;40118;Vilar Chão;127;132;123;128;61;34;59;29;2;5;3.2789999999999999;14.706;38;16;34;0;1;2;4;10.6;5.2000000000000002;5.4000000000000004;53.289999999999999;7;12;69;21;18;9;15;62;14;32;5;66;997
6;40201;Alfaião;86;87;80;84;34;20;30;16;4;4;11.765000000000001;20;4;14;28;1;2;3;2;9.8000000000000007;4.9000000000000004;5;52.939999999999998;8;7;41;11;19;7;5;37;18;20;5;67;1000
6;40203;Babe;107;131;98;116;37;30;34;29;3;1;8.1080000000000005;3.3330000000000002;14;10;39;0;1;3;0;9.3000000000000007;4.2000000000000002;5.0999999999999996;55.68;3;12;49;23;20;7;12;47;36;29;5;67;1002
6;40207;Carrazedo;45;69;44;69;17;13;15;8;2;5;11.765000000000001;38.462000000000003;8;4;11;0;0;2;5;3.6000000000000001;1.3999999999999999;2.2000000000000002;54.130000000000003;1;7;21;10;6;7;3;30;13;16;5;67;1008
6;40222;Meixedo;75;88;74;92;29;27;29;24;0;3;0;11.111000000000001;5;13;35;0;1;0;2;14.199999999999999;6.5;7.7000000000000002;49.850000000000001;8;8;38;10;11;7;10;42;10;19;5;67;1023
6;40228;Paradinha Nova;53;56;49;54;13;4;13;3;0;1;0;25;9;2;5;0;1;0;0;6.7999999999999998;3.2999999999999998;3.5;55.649999999999999;4;6;20;12;11;6;4;18;16;12;5;67;1029
6;40242;Bragança (Santa Maria);1905;2035;1861;1967;975;990;870;908;105;82;10.769;8.2829999999999995;23;278;1477;26;28;79;54;292;141.19999999999999;150.80000000000001;40.799999999999997;314;217;1091;147;136;283;178;1181;176;217;5;67;1004
6;40247;Serapicos;100;108;93;105;24;8;22;8;2;0;8.3330000000000002;0;7;12;11;0;0;2;0;7.4000000000000004;3.5;3.7999999999999998;55.359999999999999;9;11;37;21;22;9;6;41;29;23;5;67;1046
6;40509;Chacim;123;142;122;157;45;45;41;41;4;4;8.8889999999999993;8.8889999999999993;20;2;60;1;3;3;1;13.6;6.2999999999999998;7.2999999999999998;53.390000000000001;8;14;64;16;21;6;14;65;24;33;5;70;1082
6;40516;Lagoa;148;164;144;163;60;18;56;17;4;1;6.6669999999999998;5.556;36;13;24;0;1;4;0;8.9000000000000004;4.2000000000000002;4.7000000000000002;57.619999999999997;12;11;76;22;27;8;4;60;34;58;5;70;1089
6;40520;Macedo de Cavaleiros;2933;3324;2798;3220;1562;1559;1437;1356;125;203;8.0030000000000001;13.021000000000001;81;391;2321;27;65;98;138;419.60000000000002;196.69999999999999;222.90000000000001;40.359999999999999;495;306;1685;269;178;516;388;1845;283;292;5;70;1093
6;40533;Vale da Porca;131;155;117;145;59;33;50;24;9;9;15.254;27.273;10;21;43;2;2;7;7;16.399999999999999;7.5;8.9000000000000004;49.700000000000003;11;12;71;22;15;18;13;69;27;28;5;70;1106
6;40615;Silva;121;116;120;110;58;28;54;26;4;2;6.8970000000000002;7.1429999999999998;40;16;24;2;1;2;1;7.5999999999999996;3.8999999999999999;3.7000000000000002;56.649999999999999;5;10;59;25;22;7;5;45;30;29;5;71;1127
6;40702;Abreiro;138;119;137;118;51;13;44;9;7;4;13.725;30.768999999999998;20;16;17;1;1;6;3;10.699999999999999;5.7000000000000002;5;50.630000000000003;19;13;69;16;21;6;13;49;25;26;5;72;1130
6;40718;Lamas de Orelhão;190;204;181;192;76;52;69;40;7;12;9.2110000000000003;23.077000000000002;40;11;58;1;1;6;11;20.5;9.9000000000000004;10.6;46.539999999999999;25;20;92;33;20;18;26;105;38;17;5;72;1146
6;40730;Torre de Dona Chama;504;601;479;567;207;174;190;154;17;20;8.2129999999999992;11.494;19;80;245;1;3;16;17;39.899999999999999;18.199999999999999;21.699999999999999;52.5;39;50;249;87;79;44;56;268;99;134;5;72;1158
6;40737;Vila Verde;40;41;40;39;18;9;13;8;5;1;27.777999999999999;11.111000000000001;10;6;5;0;0;5;1;8.1999999999999993;4.0999999999999996;4.2000000000000002;49.479999999999997;6;1;20;7;6;3;4;17;7;10;5;72;1165
6;40801;Azinhoso;152;155;150;154;55;22;50;18;5;4;9.0909999999999993;18.181999999999999;21;15;32;2;2;3;2;10;4.9000000000000004;5;56.539999999999999;6;14;71;27;34;9;8;59;40;39;5;73;1166
6;40806;Castanheira;42;35;41;35;22;8;22;8;0;0;0;0;18;1;11;0;0;0;0;5.4000000000000004;2.8999999999999999;2.5;57.25;1;2;22;9;8;1;2;17;5;10;5;73;1171
6;40812;Penas Roias;181;201;177;194;78;51;70;42;8;9;10.256;17.646999999999998;42;28;42;2;5;6;4;11.5;5.4000000000000004;6;52.640000000000001;16;10;92;29;34;16;13;95;39;38;5;73;1177
6;40813;Peredo da Bemposta;100;88;98;87;40;25;38;20;2;5;5;20;22;9;27;1;0;1;5;10.4;5.5;4.9000000000000004;57.399999999999999;5;6;43;22;24;3;3;43;24;15;5;73;1178
6;40817;São Martinho do Peso;180;175;180;171;62;23;58;22;4;1;6.452;4.3479999999999999;43;11;26;0;1;4;0;6.7999999999999998;3.5;3.3999999999999999;54.939999999999998;8;19;87;38;28;9;12;72;43;39;5;73;1182
6;40823;Vale de Porco;60;73;58;71;29;18;26;16;3;2;10.345000000000001;11.111000000000001;18;8;16;0;1;3;1;8.4000000000000004;3.7999999999999998;4.5999999999999996;53.170000000000002;2;6;28;16;8;7;7;29;18;12;5;73;1188
6;41110;Santulhão;213;210;212;206;35;22;32;21;3;1;8.5709999999999997;4.5449999999999999;10;11;32;1;1;2;0;8.5999999999999996;4.2999999999999998;4.2999999999999998;56.649999999999999;14;12;91;53;43;10;13;88;57;42;5;76;1239
6;41209;Fresulfe;36;47;36;44;7;5;7;5;0;0;0;0;4;4;4;0;0;0;0;4.5;2;2.5;53.939999999999998;6;1;11;13;5;4;2;20;7;14;5;77;1252
6;41221;Santalha;129;125;124;122;38;10;36;9;2;1;5.2629999999999999;10;22;11;12;1;1;1;0;8.8000000000000007;4.4000000000000004;4.2999999999999998;58.579999999999998;4;9;62;27;27;7;4;45;28;41;5;77;1264
6;41222;São Jomil;22;16;22;16;6;2;4;2;2;0;33.332999999999998;0;4;0;2;0;0;2;0;4.4000000000000004;2.5;1.8999999999999999;66.390000000000001;;;7;8;7;;1;6;4;5;5;77;1265
6;170207;Codessoso;59;73;58;73;24;14;24;14;0;0;0;0;14;12;12;0;0;0;0;15.300000000000001;6.7999999999999998;8.4000000000000004;47.700000000000003;11;1;25;13;9;7;6;37;18;5;19;270;3646
6;170208;Covas do Barroso;119;143;115;138;51;20;49;18;2;2;3.9220000000000002;10;26;17;24;0;1;2;1;8.9000000000000004;4;4.7999999999999998;55.289999999999999;9;9;60;16;25;11;6;58;19;49;19;270;3647
6;170216;Vilar;99;95;98;94;46;29;43;28;3;1;6.5220000000000002;3.448;19;24;28;0;1;3;0;16.100000000000001;8.1999999999999993;7.9000000000000004;52.469999999999999;7;8;55;12;17;5;7;47;13;23;19;270;3655
6;170301;Águas Frias;361;385;351;372;151;77;130;60;21;17;13.907;22.077999999999999;25;58;107;5;4;16;13;25.899999999999999;12.6;13.4;49.390000000000001;35;39;183;56;48;34;35;184;65;67;19;271;3656
6;170302;Anelhe;235;241;230;233;97;48;80;34;17;14;17.526;29.167000000000002;19;50;45;2;5;15;9;38.100000000000001;18.800000000000001;19.300000000000001;41.539999999999999;40;31;110;35;19;42;20;127;30;22;19;271;3657
6;170311;Eiras;266;274;244;259;128;88;110;68;18;20;14.063000000000001;22.727;14;30;134;2;1;16;19;114.8;56.5;58.200000000000003;47.450000000000003;31;28;139;38;30;26;29;140;41;38;19;271;3665
6;170317;Moreiras;136;137;135;138;42;29;37;24;5;5;11.904999999999999;17.241;12;18;31;0;2;5;3;29.600000000000001;14.699999999999999;14.800000000000001;47.850000000000001;25;12;60;23;16;14;5;69;29;20;19;271;3672
6;170327;Sanfins;105;131;105;137;32;12;27;5;5;7;15.625;58.332999999999998;12;9;11;2;5;3;2;13.300000000000001;5.9000000000000004;7.4000000000000004;52.75;8;9;51;15;22;13;9;55;32;22;19;271;3682
6;40524;Peredo;132;126;128;127;46;25;43;23;3;2;6.5220000000000002;8;14;15;37;0;1;3;1;11.699999999999999;6;5.7000000000000002;51.030000000000001;14;14;54;25;25;9;16;49;26;26;5;70;1097
6;40530;Talhas;151;165;147;159;51;20;50;19;1;1;1.9609999999999999;5;36;7;26;0;1;1;0;7.2000000000000002;3.5;3.7999999999999998;56.689999999999998;6;15;75;26;29;9;11;67;32;46;5;70;1103
6;40612;Póvoa;106;102;108;102;33;30;30;25;3;5;9.0909999999999993;16.667000000000002;13;3;39;1;2;2;3;9.1999999999999993;4.7000000000000002;4.5;54.420000000000002;11;2;48;26;19;5;9;46;24;18;5;71;1124
6;40713;Cobro;92;113;87;105;40;19;37;13;3;6;7.5;31.579000000000001;24;10;16;2;1;1;5;16.699999999999999;7.5;9.1999999999999993;46.799999999999997;8;11;54;14;5;10;12;55;20;16;5;72;1141
6;40714;Fradizela;120;114;111;112;37;14;29;9;8;5;21.622;35.713999999999999;18;8;12;2;1;6;4;16.600000000000001;8.5;8.0999999999999996;57.700000000000003;7;11;45;29;28;7;8;37;40;22;5;72;1142
6;40807;Castelo Branco;210;239;208;240;60;44;51;20;9;24;15;54.545000000000002;12;22;37;7;20;2;4;8.3000000000000007;3.8999999999999999;4.4000000000000004;57.200000000000003;13;14;94;48;41;13;6;99;58;63;5;73;1172
6;40821;Urrós;151;167;144;162;70;46;62;45;8;1;11.429;2.1739999999999999;27;25;55;1;0;7;1;10;4.7000000000000002;5.2000000000000002;59.090000000000003;4;10;75;33;29;4;12;66;31;54;5;73;1186
6;40825;Ventozelo;75;71;72;69;34;18;29;12;5;6;14.706;33.332999999999998;19;8;14;0;4;5;2;6.0999999999999996;3.1000000000000001;3;54.090000000000003;4;8;34;12;17;5;3;32;14;17;5;73;1190
6;41235;Vinhais;1064;1181;1029;1119;530;461;494;413;36;48;6.7919999999999998;10.412000000000001;36;135;736;9;22;27;26;70.099999999999994;33.200000000000003;36.899999999999999;46.530000000000001;130;85;596;138;115;118;111;631;161;160;5;77;1278
6;170310;Curalha;229;240;215;229;94;71;83;59;11;12;11.702;16.901;12;43;87;6;6;5;6;60;29.300000000000001;30.699999999999999;43.75;31;26;122;26;24;28;27;129;32;24;19;271;3664
6;170324;Redondelo;278;249;284;254;104;63;93;56;11;7;10.577;11.111000000000001;26;46;77;3;5;8;2;28.199999999999999;14.9;13.300000000000001;46.799999999999997;46;21;144;34;33;25;22;125;35;42;19;271;3679
6;170330;Santo António de Monforte;225;229;211;215;94;68;76;48;18;20;19.149000000000001;29.411999999999999;14;40;70;4;10;14;10;38.600000000000001;19.100000000000001;19.5;46.399999999999999;27;33;109;33;23;12;28;125;32;32;19;271;3687
6;170617;Mourilhe;58;59;58;60;23;12;23;11;0;1;0;8.3330000000000002;20;6;8;0;1;0;0;7;3.5;3.5;49.32;5;5;27;8;13;9;4;26;16;4;19;274;3738
6;170621;Padroso;48;59;42;48;18;12;17;11;1;1;5.556;8.3330000000000002;9;5;14;0;1;1;0;8.6999999999999993;3.8999999999999999;4.7999999999999998;54.859999999999999;4;5;23;8;8;3;3;26;14;13;19;274;3742
6;170622;Paradela;66;79;61;73;21;15;19;12;2;3;9.5240000000000009;20;4;10;17;0;2;2;1;11.4;5.2000000000000002;6.2000000000000002;48.789999999999999;5;9;34;9;9;5;11;39;17;7;19;274;3743
6;171218;Sanfins;99;114;134;133;26;19;23;15;3;4;11.538;21.053000000000001;3;12;23;0;1;3;3;38.799999999999997;18;20.800000000000001;50.310000000000002;8;3;56;18;14;11;12;52;18;21;19;280;3827
6;171307;Parada de Monteiros;30;42;30;42;3;2;3;1;0;1;0;50;1;0;3;0;0;0;1;3.1000000000000001;1.3;1.8;58.079999999999998;1;1;11;9;8;5;3;12;10;12;19;281;3848
6;10108;Espinhel;1204;1278;1149;1219;650;573;618;506;32;67;4.923;11.693;16;673;435;1;15;31;52;200.40000000000001;97.200000000000003;103.2;43.600000000000001;158;147;672;136;91;142;154;721;125;136;1;1;9
6;10208;Valmaior;1000;1040;946;995;519;403;460;346;59;57;11.368;14.144;17;367;422;7;11;52;46;115.40000000000001;56.600000000000001;58.799999999999997;43.219999999999999;134;109;577;98;82;153;94;564;117;112;1;2;28
6;10304;Avelãs de Caminho;631;621;621;606;312;273;277;248;35;25;11.218;9.1579999999999995;10;242;273;3;6;32;19;194.19999999999999;97.900000000000006;96.299999999999997;44.100000000000001;111;64;330;64;62;69;56;335;70;91;1;3;33
6;10308;Óis do Bairro;233;258;229;247;128;119;118;105;10;14;7.8129999999999997;11.765000000000001;9;81;133;2;1;8;13;174.5;82.799999999999997;91.700000000000003;44.710000000000001;24;23;143;22;21;30;19;141;27;41;1;3;37
6;10507;Nariz;677;741;640;716;372;319;334;285;38;34;10.215;10.657999999999999;16;288;315;2;5;36;29;152.09999999999999;72.599999999999994;79.5;41.740000000000002;103;81;386;55;52;103;83;417;70;68;1;5;70
6;11107;Vacariça;942;1003;889;985;474;428;439;402;35;26;7.3840000000000003;6.0750000000000002;22;350;469;4;5;31;21;104.2;50.5;53.700000000000003;45.18;131;113;501;106;91;108;69;554;126;146;1;10;109
6;11202;Monte;687;772;633;744;340;291;297;251;43;40;12.647;13.746;21;208;319;10;9;33;31;638.29999999999995;300.60000000000002;337.80000000000001;41.759999999999998;126;81;354;63;63;122;78;391;76;105;1;11;112
6;11404;Oliveira do Bairro;2951;3299;2798;3170;1634;1602;1496;1405;138;197;8.4459999999999997;12.297000000000001;23;1288;1590;23;36;115;161;277.10000000000002;130.90000000000001;146.30000000000001;40.43;476;340;1679;236;220;499;345;1825;318;312;1;13;137
6;60404;Condeixa-a-Nova;2262;2874;2138;2802;1243;1349;1143;1209;100;140;8.0449999999999999;10.378;9;379;1964;16;25;84;115;1478.5999999999999;651.20000000000005;827.39999999999998;39.369999999999997;479;196;1313;153;121;433;209;1698;242;292;7;92;1510
6;60505;Ferreira-a-Nova;716;772;645;746;353;285;327;250;26;35;7.3650000000000002;12.281000000000001;29;244;304;7;10;19;25;116.5;56;60.399999999999999;45.020000000000003;102;69;391;96;58;72;69;432;124;75;7;93;1523
6;61311;Travanca do Mondego;199;222;184;214;99;84;92;69;7;15;7.0709999999999997;17.856999999999999;6;54;101;1;3;6;12;36.5;17.199999999999999;19.199999999999999;44.710000000000001;31;14;110;23;21;27;22;123;25;25;7;101;1610
6;61504;Figueiró do Campo;718;789;678;775;337;296;300;270;37;26;10.978999999999999;8.7840000000000007;5;125;440;9;7;28;19;133.69999999999999;63.700000000000003;70;47.5;82;58;403;97;78;81;60;407;107;134;7;103;1620
6;100404;Golpilheira;733;795;710;757;373;363;347;342;26;21;6.9710000000000001;5.7850000000000001;22;261;406;4;3;22;18;301.80000000000001;144.80000000000001;157;42.310000000000002;113;98;398;69;55;110;88;431;87;79;11;152;2192
6;100918;Ortigosa;944;1027;874;981;514;450;485;409;29;41;5.6420000000000003;9.1110000000000007;24;317;553;7;4;22;37;153.19999999999999;73.400000000000006;79.799999999999997;39.490000000000002;163;110;534;78;59;168;119;566;84;90;11;157;2245
6;100922;Santa Catarina da Serra;2006;2092;1863;1991;1105;925;1057;857;48;68;4.3440000000000003;7.351;23;845;1046;13;21;35;47;114.5;56.100000000000001;58.5;41.32;310;315;1070;166;145;295;268;1110;188;231;11;157;2249
6;101607;Mendiga;464;466;452;452;245;191;234;174;11;17;4.4900000000000002;8.9009999999999998;8;175;225;1;5;10;12;46.100000000000001;23;23.100000000000001;42.710000000000001;80;54;244;42;44;63;52;223;65;63;11;164;2299
6;60105;Celavisa;83;99;83;93;34;20;28;18;6;2;17.646999999999998;10;1;24;21;1;0;5;2;11.9;5.4000000000000004;6.5;55.200000000000003;7;3;37;22;14;6;5;39;28;21;7;89;1443
6;60705;Vilarinho;1421;1472;1370;1434;720;711;661;620;59;91;8.1940000000000008;12.798999999999999;41;342;898;12;17;47;74;114.3;56.200000000000003;58.200000000000003;39.420000000000002;263;141;800;137;80;238;139;830;133;132;7;95;1545
6;61101;Aldeia das Dez;245;286;238;280;100;73;90;61;10;12;10;16.437999999999999;14;57;80;0;0;10;12;28.399999999999999;13.1;15.300000000000001;53;16;25;121;32;51;26;25;112;38;85;7;99;1569
6;61111;Nogueira do Cravo;1120;1189;1045;1155;561;460;527;399;34;61;6.0609999999999999;13.260999999999999;24;404;498;5;12;29;49;154.09999999999999;74.799999999999997;79.400000000000006;43.450000000000003;160;127;618;120;95;151;104;648;155;131;7;99;1579
6;61117;São Sebastião da Feira;84;113;77;109;40;40;36;35;4;5;10;12.5;2;29;40;0;1;4;4;74.400000000000006;31.699999999999999;42.700000000000003;47.57;4;13;43;17;7;16;7;49;18;23;7;99;1585
6;61208;Portela do Fojo;174;207;171;201;49;39;40;36;9;3;18.367000000000001;7.6920000000000002;6;11;59;1;0;8;3;10.1;4.5999999999999996;5.5;58.789999999999999;8;13;71;40;42;9;15;74;49;60;7;100;1597
6;61210;Vidual;36;48;36;48;12;12;12;9;0;3;0;25;0;2;19;0;0;0;3;6.0999999999999996;2.6000000000000001;3.5;57.789999999999999;3;1;15;10;7;2;2;19;13;12;7;100;1599
6;61615;Vila Nova de Oliveirinha;138;155;125;153;65;56;65;52;0;4;0;7.1429999999999998;4;58;55;0;0;0;4;65.200000000000003;30.699999999999999;34.5;46.619999999999997;18;14;73;20;13;20;8;85;23;19;7;104;1643
6;160149;Vale;366;410;354;412;133;111;119;99;14;12;10.526;10.811;23;87;108;0;1;14;11;51.299999999999997;24.199999999999999;27.100000000000001;50.329999999999998;54;29;166;66;51;36;31;180;71;92;18;259;3379
6;160207;Caminha (Matriz);564;782;544;766;283;285;237;233;46;52;16.254000000000001;18.245999999999999;22;83;365;13;8;33;44;654.39999999999998;274.19999999999999;380.19999999999999;50.789999999999999;55;62;310;59;78;57;52;360;114;199;18;260;3388
6;160417;Monção;1132;1337;1122;1343;575;551;492;486;83;65;14.435;11.797000000000001;15;208;755;13;17;70;48;831.20000000000005;381.10000000000002;450.10000000000002;45.310000000000002;155;116;616;110;135;145;113;690;165;224;18;262;3437
6;160430;Troviscoso;516;550;507;542;211;198;188;178;23;20;10.9;10.101000000000001;11;114;241;4;6;19;14;186.80000000000001;90.400000000000006;96.400000000000006;45.840000000000003;62;63;281;62;48;58;51;297;70;74;18;262;3450
6;160604;Britelo;233;252;212;236;105;61;93;47;12;14;11.429;22.951000000000001;5;74;61;4;6;8;8;37.600000000000001;18.100000000000001;19.5;50.859999999999999;15;30;121;38;29;13;29;124;40;46;18;264;3477
6;160609;Germil;22;27;20;25;6;6;6;6;0;0;0;0;7;2;3;0;0;0;0;3.7999999999999998;1.7;2.1000000000000001;60.759999999999998;;3;9;5;5;;1;12;7;7;18;264;3482
6;160625;Vila Nova de Muía;497;537;479;522;227;189;197;163;30;26;13.215999999999999;13.757;16;141;203;6;4;24;22;193.80000000000001;93.200000000000003;100.7;43.840000000000003;73;58;262;49;55;72;43;278;74;70;18;264;3498
6;160704;Arcozelo;1786;1948;1704;1878;959;758;850;634;109;124;11.366;16.359000000000002;27;606;851;19;25;90;99;309.19999999999999;147.90000000000001;161.30000000000001;40.630000000000003;310;240;995;135;106;264;225;1071;176;212;18;265;3502
6;160714;Calvelo;324;361;300;343;166;130;146;102;20;28;12.048;21.538;33;111;104;3;6;17;22;130.09999999999999;61.600000000000001;68.599999999999994;43.799999999999997;44;43;164;43;30;47;46;183;42;43;18;265;3512
6;160718;Facha;720;809;692;803;392;291;350;254;42;37;10.714;12.715;13;400;191;2;3;40;34;99.900000000000006;47;52.899999999999999;38.409999999999997;144;90;397;47;42;149;87;420;80;73;18;265;3516
6;160730;Labrujó;64;63;60;64;35;19;32;12;3;7;8.5709999999999997;36.841999999999999;5;20;19;0;0;3;7;29.199999999999999;14.699999999999999;14.5;46.240000000000002;9;9;34;2;10;3;13;28;2;17;18;265;3528
6;160734;Poiares;365;410;317;387;181;163;167;149;14;14;7.7350000000000003;8.5890000000000004;37;148;131;4;4;10;10;104.2;49.100000000000001;55.100000000000001;40.340000000000003;62;63;172;42;26;70;50;198;57;35;18;265;3532
6;160746;Serdedelo;216;248;202;244;94;50;79;43;15;7;15.957000000000001;14;10;81;31;0;4;15;3;71.299999999999997;33.200000000000003;38.100000000000001;42.450000000000003;41;26;115;20;14;28;35;128;22;35;18;265;3545
6;161002;Candemil;112;120;108;118;51;42;45;38;6;4;11.765000000000001;9.5240000000000009;2;42;39;1;0;5;4;32.299999999999997;15.6;16.699999999999999;50.549999999999997;15;10;56;16;15;7;9;57;20;27;18;268;3607
6;161008;Lovelhe;218;225;202;202;108;89;92;88;16;1;14.815;1.1240000000000001;5;51;124;5;0;11;1;131.59999999999999;64.799999999999997;66.799999999999997;45.5;27;31;121;17;22;19;20;124;21;41;18;268;3613
6;30210;Areias;502;512;458;495;277;252;244;193;33;59;11.913;23.413;1;221;215;7;11;26;48;403.80000000000001;199.90000000000001;203.90000000000001;38.829999999999998;91;63;288;34;26;78;59;304;34;37;4;54;501
6;30216;Cambeses;643;657;607;644;326;283;294;241;32;42;9.8160000000000007;14.840999999999999;14;236;285;4;4;28;38;392.5;194.19999999999999;198.40000000000001;39.560000000000002;114;88;362;42;37;105;62;378;56;56;4;54;508
6;30250;Minhotães;357;418;347;404;206;190;179;164;27;26;13.106999999999999;13.683999999999999;20;201;122;10;4;17;22;216.80000000000001;99.900000000000006;116.90000000000001;40.969999999999999;57;48;209;25;18;50;52;231;44;41;4;54;544
6;30274;Alvito (São Pedro);317;322;287;310;175;139;164;119;11;20;6.2859999999999996;14.388;12;150;121;0;5;11;15;111.90000000000001;55.5;56.399999999999999;38.090000000000003;62;40;181;20;14;63;27;175;30;27;4;54;498
6;30305;Cabreiros;736;775;696;756;393;343;346;296;47;47;11.959;13.702999999999999;8;287;347;6;9;41;38;540.5;263.30000000000001;277.19999999999999;40.869999999999997;112;100;420;52;52;117;79;426;74;79;4;55;602
6;30313;Esporões;839;870;806;865;459;407;409;354;50;53;10.893000000000001;13.022;11;331;421;6;14;44;39;360.5;177;183.5;38.68;131;135;483;47;43;129;109;502;62;68;4;55;619
6;30317;Frossos;880;926;835;900;513;460;460;389;53;71;10.331;15.435;5;246;598;11;6;42;65;1391.2;677.89999999999998;713.29999999999995;36.670000000000002;167;109;520;55;29;174;113;534;62;43;4;55;628
6;30338;Ruilhe;517;625;503;629;253;249;230;222;23;27;9.0909999999999993;10.843;7;140;305;3;7;20;20;518.29999999999995;234.59999999999999;283.60000000000002;41.32;84;65;287;38;43;108;76;315;50;76;4;55;681
6;30343;Passos (São Julião);309;345;293;342;163;156;146;132;17;24;10.429;15.385;5;113;160;0;7;17;17;327.80000000000001;154.90000000000001;172.90000000000001;40.939999999999998;45;37;178;21;28;48;61;169;30;37;4;55;666
6;30607;Fonte Boa;639;687;619;659;347;312;320;284;27;28;7.7809999999999997;8.9740000000000002;113;284;207;3;12;24;16;216.90000000000001;104.5;112.40000000000001;40.020000000000003;128;83;345;40;43;85;91;375;61;75;4;58;754
6;30613;Palmeira de Faro;1129;1274;1056;1231;621;559;558;472;63;87;10.145;15.564;18;529;483;12;10;51;77;355.60000000000002;167.09999999999999;188.5;37.270000000000003;209;169;628;77;46;241;171;694;86;82;4;58;760
6;31002;Brufe;24;26;23;25;12;6;12;5;0;1;0;16.667000000000002;4;4;9;0;1;0;0;7.7000000000000002;3.7000000000000002;4;48.840000000000003;5;3;10;3;3;2;4;10;4;6;4;61;829
6;31312;Covas;182;214;179;205;73;51;59;46;14;5;19.178000000000001;9.8040000000000003;4;50;51;1;1;13;4;113;51.899999999999999;61.100000000000001;46.289999999999999;21;22;101;15;23;22;28;96;32;36;4;64;928
6;31329;Nevogilde;158;166;152;163;79;56;72;51;7;5;8.8610000000000007;8.9290000000000003;1;63;59;2;2;5;3;156.19999999999999;76.200000000000003;80;39.909999999999997;24;22;86;14;12;25;29;79;21;12;4;64;947
6;30712;Fornelos;643;731;605;702;356;331;293;256;63;75;17.696999999999999;22.658999999999999;10;282;257;9;10;54;65;561.60000000000002;262.80000000000001;298.80000000000001;40.700000000000003;91;73;399;46;34;109;91;392;65;74;4;59;776
6;30714;Golães;1026;1109;1003;1093;525;485;460;411;65;74;12.381;15.257999999999999;5;538;328;10;13;55;61;454.30000000000001;218.30000000000001;236;39.229999999999997;182;131;582;74;57;156;151;616;101;85;4;59;778
6;30829;Mascotelos;799;832;770;815;459;470;400;396;59;74;12.853999999999999;15.744999999999999;2;337;457;7;10;52;64;1298.2;636;662.20000000000005;36.579999999999998;155;89;483;47;25;132;94;529;46;31;4;55;649
6;30849;Sande (São Clemente);824;871;795;846;443;396;398;347;45;49;10.157999999999999;12.374000000000001;11;377;357;12;6;33;43;348.19999999999999;169.30000000000001;178.90000000000001;39.289999999999999;128;136;458;62;40;127;102;497;82;63;4;55;682
6;30868;Silvares;1124;1158;1096;1141;584;562;499;479;85;83;14.555;14.769;9;492;477;11;12;74;71;508.39999999999998;250.40000000000001;258;39.119999999999997;198;130;637;98;61;172;155;655;114;62;4;55;696
6;30869;Tabuadelo;762;793;738;785;415;401;350;338;65;63;15.663;15.711;4;374;310;12;11;53;52;502.80000000000001;246.40000000000001;256.39999999999998;37.659999999999997;127;99;454;49;33;144;103;461;52;33;4;55;700
6;30901;Águas Santas;199;221;193;219;91;79;80;67;11;12;12.087999999999999;15.19;4;54;89;1;4;10;8;153.59999999999999;72.799999999999997;80.799999999999997;41.039999999999999;35;26;108;14;16;33;27;115;21;25;4;60;799
6;30921;Rendufinho;363;373;357;378;180;115;160;101;20;14;11.111000000000001;12.173999999999999;12;102;147;1;1;19;13;88.799999999999997;43.799999999999997;45;38.850000000000001;70;49;194;20;30;74;37;196;30;36;4;60;819
6;130412;Baguim do Monte (Rio Tinto);6762;7340;6396;7064;3747;3519;3193;2890;554;629;14.785;17.873999999999999;23;1395;4665;91;112;463;517;2584.3000000000002;1239.2;1345.0999999999999;39.649999999999999;1116;759;4019;570;298;1119;760;4381;620;460;15;210;2765
6;131305;Balazar;1194;1349;1130;1319;638;594;584;517;54;77;8.4640000000000004;12.962999999999999;123;472;506;5;9;49;68;219.09999999999999;102.90000000000001;116.2;37.909999999999997;234;159;681;72;48;232;166;730;115;106;15;219;2957
6;10605;Raiva;1154;1158;1090;1137;592;455;505;322;87;133;14.696;29.231000000000002;27;430;370;8;23;79;110;150.80000000000001;75.299999999999997;75.5;40.090000000000003;192;156;654;83;69;162;148;650;96;102;1;6;82
6;10609;Sobrado;1353;1431;1249;1408;716;572;643;488;73;84;10.196;14.685;20;378;733;17;26;56;58;511.10000000000002;248.40000000000001;262.69999999999999;40.700000000000003;225;168;775;106;79;210;160;797;126;138;1;6;86
6;30412;Passos;93;128;86;125;41;32;37;27;4;5;9.7560000000000002;15.625;8;28;28;1;3;3;2;48.200000000000003;20.300000000000001;27.899999999999999;44.32;15;8;49;10;11;19;15;56;14;24;4;56;720
6;30415;Rio Douro;456;486;445;473;198;116;184;90;14;26;7.0709999999999997;22.414000000000001;51;84;139;3;9;11;17;21.899999999999999;10.6;11.300000000000001;45.950000000000003;51;59;230;51;65;70;48;218;73;77;4;56;723
6;130129;Salvador do Monte;529;537;478;512;269;195;247;160;22;35;8.1780000000000008;17.949000000000002;25;150;232;1;7;21;28;142.5;70.700000000000003;71.799999999999997;42.259999999999998;94;74;278;49;34;65;47;309;67;49;15;207;2705
6;130213;Santa Cruz do Douro;680;773;610;756;343;258;280;182;63;76;18.367000000000001;29.457000000000001;17;197;248;6;28;57;48;157.59999999999999;73.799999999999997;83.900000000000006;44.299999999999997;82;95;374;53;76;103;87;382;88;113;15;208;2725
6;130310;Macieira da Lixa;955;1006;896;980;490;433;430;388;60;45;12.244999999999999;10.393000000000001;23;454;341;9;9;51;36;364.69999999999999;177.59999999999999;187.09999999999999;40.200000000000003;145;146;525;83;56;126;132;583;88;77;15;209;2742
6;130715;Penha Longa;974;955;787;918;530;276;448;208;82;68;15.472;24.638000000000002;9;418;229;12;24;70;44;178.90000000000001;90.299999999999997;88.599999999999994;37.850000000000001;188;130;544;61;51;161;124;528;57;85;15;213;2833
6;130722;Soalhães;1789;1893;1640;1836;924;574;808;415;116;159;12.554;27.699999999999999;26;582;615;24;46;92;113;153;74.400000000000006;78.700000000000003;38.619999999999997;328;274;957;124;106;307;251;1002;171;162;15;213;2840
6;130728;Várzea do Douro;1055;1043;923;1007;583;375;515;306;68;69;11.664;18.399999999999999;4;499;318;5;19;63;50;438.60000000000002;220.5;218;35.770000000000003;198;188;578;59;32;186;163;566;75;53;15;213;2847
6;130913;Penamaior;1870;1949;1826;1921;1075;884;934;777;141;107;13.116;12.103999999999999;13;958;740;16;17;125;90;568.5;278.39999999999998;290.10000000000002;36.899999999999999;354;272;1045;120;79;351;268;1069;135;126;15;215;2872
6;131106;Capela;510;537;498;534;273;184;248;167;25;17;9.1579999999999995;9.2390000000000008;8;197;210;6;5;19;12;78.400000000000006;38.200000000000003;40.200000000000003;37.789999999999999;84;75;300;26;25;89;91;276;46;35;15;217;2905
6;131114;Guilhufe;1407;1437;1559;1619;785;703;719;640;66;63;8.4079999999999995;8.9619999999999997;21;733;605;6;14;60;49;569.10000000000002;281.60000000000002;287.60000000000002;38.020000000000003;237;202;816;96;56;230;182;854;87;84;15;217;2913
6;170502;Bilhó;253;293;242;276;82;69;78;56;4;13;4.8780000000000001;18.841000000000001;42;25;67;0;7;4;6;20.600000000000001;9.5;11;46.530000000000001;42;25;116;36;34;33;34;139;39;48;19;273;3715
6;111002;Barcarena;6749;7112;6411;6919;3670;3728;3322;3395;348;333;9.4819999999999993;8.9320000000000004;19;1063;5635;81;60;267;273;1537.9000000000001;748.79999999999995;789.10000000000002;39.140000000000001;1299;718;3882;551;299;1144;590;4241;607;530;12;176;2468
6;111010;Queijas;4972;5405;4726;5212;2527;2589;2289;2354;238;235;9.4179999999999993;9.077;12;564;4067;54;57;184;178;4512.5;2162.0999999999999;2350.4000000000001;42.149999999999999;923;433;2719;566;331;796;402;3070;640;497;12;176;2476
6;111112;Sintra (São Pedro de Penaferrim);7024;6977;6797;6794;3590;3408;3240;3068;350;340;9.7490000000000006;9.9770000000000003;36;1286;4986;69;86;281;254;519.10000000000002;260.39999999999998;258.69999999999999;38.090000000000003;1295;801;4165;470;293;1257;756;3926;534;504;12;177;2495
6;111117;Monte Abraão;9798;11011;9196;10591;5242;5567;4445;4828;797;739;15.204000000000001;13.275;16;1542;7715;132;146;665;593;16551.900000000001;7793.5;8758.3999999999996;38.420000000000002;1838;1230;5561;754;415;1665;1272;6444;962;668;12;177;2486
6;111118;Agualva;17015;18809;16037;18010;9187;9562;7691;8249;1496;1313;16.283999999999999;13.731;29;2941;12970;313;278;1183;1035;7423;3525.6999999999998;3897.4000000000001;39.399999999999999;2847;2286;9783;1324;775;2745;2242;10999;1530;1293;12;177;2477
6;111304;Carvoeira;734;849;709;825;357;335;321;307;36;28;10.084;8.3580000000000005;30;167;431;5;4;31;24;111.2;51.600000000000001;59.700000000000003;44.920000000000002;106;67;390;95;76;122;73;427;124;103;12;179;2503
6;111405;Castanheira do Ribatejo;3623;3877;3466;3794;1982;1904;1719;1634;263;270;13.269;14.180999999999999;53;848;2452;27;36;236;234;443.60000000000002;214.30000000000001;229.30000000000001;39.109999999999999;668;407;2096;271;181;626;396;2231;318;306;12;180;2524
6;111408;Vialonga;10192;10841;9680;10492;5863;5787;5171;5118;692;669;11.803000000000001;11.56;26;2134;8129;93;110;599;559;1173.0999999999999;568.5;604.70000000000005;35.619999999999997;2101;1066;6046;649;330;2142;1094;6483;649;473;12;180;2530
6;111501;Alfragide;4708;5196;4487;5044;2533;2661;2332;2435;201;226;7.9350000000000005;8.4930000000000003;13;578;4176;60;53;141;173;7420.8000000000002;3527.5999999999999;3893.1999999999998;38.159999999999997;972;543;2656;337;200;945;525;3029;400;297;12;166;2323
6;111606;Póvoa de Santo Adrião;6117;6944;5722;6649;3194;3349;2700;2923;494;426;15.465999999999999;12.720000000000001;9;919;4695;81;82;413;344;10573.4;4952;5621.5;42.590000000000003;882;713;3406;758;358;847;733;3969;892;503;12;175;2465
6;120306;Figueira e Barros;147;162;139;158;64;59;52;41;12;18;18.75;30.507999999999999;39;19;35;0;3;12;15;4.4000000000000004;2.1000000000000001;2.2999999999999998;48.490000000000002;23;9;68;24;23;20;16;65;24;37;14;194;2599
6;120702;Alcáçova;1048;1099;998;1083;490;410;380;318;110;92;22.449000000000002;22.439;43;137;518;13;17;97;75;217.40000000000001;106.09999999999999;111.3;43.469999999999999;153;124;517;101;153;170;130;531;135;133;14;198;2616
6;120905;Margem;400;411;384;404;162;97;122;72;40;25;24.690999999999999;25.773;28;63;103;6;5;34;20;14.300000000000001;7;7.2000000000000002;54.219999999999999;26;33;196;59;86;24;31;165;75;116;14;200;2633
6;121002;Santa Maria de Marvão;225;261;298;357;84;73;70;66;14;7;16.667000000000002;9.5890000000000004;11;22;103;0;2;14;5;20.800000000000001;9.5999999999999996;11.199999999999999;57.859999999999999;14;17;105;30;59;15;13;109;33;91;14;201;2635
6;121201;Alpalhão;605;633;588;617;262;219;220;178;42;41;16.030999999999999;18.721;20;115;263;5;10;37;31;36.200000000000003;17.699999999999999;18.5;50.310000000000002;55;51;323;82;94;71;46;280;105;131;14;203;2642
6;121408;São Lourenço;2334;2653;2631;2623;1028;1054;905;933;123;121;11.965;11.48;52;206;1580;35;36;88;85;403.19999999999999;188.69999999999999;214.5;47.119999999999997;325;246;1200;259;304;285;232;1336;345;455;14;205;2666
6;130125;Olo;167;204;172;200;93;75;84;51;9;24;9.6769999999999996;32;11;30;94;2;12;7;12;56.299999999999997;25.300000000000001;30.899999999999999;41.649999999999999;26;27;89;11;14;23;38;93;23;27;15;207;2701
6;130330;Varziela;879;958;844;928;478;442;418;402;60;40;12.552;9.0500000000000007;11;465;344;11;9;49;31;643.79999999999995;308;335.69999999999999;39.149999999999999;137;163;472;59;48;139;147;512;79;81;15;209;2760
6;130507;Covas;353;373;345;365;195;171;175;153;20;18;10.256;10.526;5;187;136;2;2;18;16;485.10000000000002;235.80000000000001;249.19999999999999;37.229999999999997;64;58;192;24;15;61;57;207;33;15;15;211;2784
6;130601;Águas Santas;13110;14360;12514;13989;7215;7281;6172;6152;1043;1129;14.456;15.506;41;2858;9425;169;185;874;944;3339.5;1593.8;1745.7;38.520000000000003;2428;1433;7734;956;559;2402;1374;8645;1008;931;15;212;2802
6;130603;Folgosa;1833;1871;1805;1845;977;838;869;689;108;149;11.054;17.780000000000001;43;538;977;26;27;82;122;361.19999999999999;178.69999999999999;182.5;39.840000000000003;316;249;1019;140;109;282;196;1085;159;149;15;212;2806
6;130707;Folhada;280;322;261;313;142;97;104;63;38;34;26.760999999999999;35.052;11;74;82;5;16;33;18;68;31.600000000000001;36.399999999999999;41.280000000000001;42;46;148;21;23;48;44;160;32;38;15;213;2825
6;130714;Paredes de Viadores;654;635;599;627;346;148;302;120;44;28;12.717000000000001;18.919;18;223;181;6;10;38;18;146.59999999999999;74.400000000000006;72.200000000000003;37.560000000000002;118;119;349;29;39;107;80;338;55;55;15;213;2832
6;130719;Santo Isidoro;722;773;646;754;424;321;387;250;37;71;8.7259999999999991;22.117999999999999;12;328;297;8;14;29;57;403.80000000000001;195;208.80000000000001;41.880000000000003;93;92;433;61;43;100;92;457;62;62;15;213;2837
6;131007;Castelões de Cepeda;4139;4616;3950;4466;2299;2350;2074;2015;225;335;9.7870000000000008;14.255000000000001;29;1030;3030;43;75;182;260;2672.4000000000001;1263.4000000000001;1409;36.770000000000003;822;461;2468;237;151;776;502;2758;280;300;15;216;2882
6;131008;Cete;1498;1615;1406;1580;854;755;727;621;127;134;14.871;17.748000000000001;9;565;774;23;24;104;110;665.79999999999995;320.39999999999998;345.39999999999998;37.090000000000003;271;190;881;102;54;294;172;953;103;93;15;216;2883
6;131023;Vila Cova de Carros;334;332;323;328;182;124;163;97;19;27;10.44;21.774000000000001;10;122;128;1;6;18;21;225.19999999999999;112.90000000000001;112.2;36.329999999999998;64;59;178;17;16;66;38;181;19;28;15;216;2898
6;131133;Recezinhos (São Martinho);880;911;809;897;470;365;429;319;41;46;8.7230000000000008;12.603;19;425;304;2;14;39;32;342;168;174;38.030000000000001;166;127;487;51;49;145;113;517;62;74;15;217;2929
6;131208;Miragaia;953;1114;1655;1357;474;463;353;373;121;90;25.527000000000001;19.437999999999999;2;106;618;20;18;101;72;4846.6000000000004;2234.5;2612;48.109999999999999;87;97;571;97;101;88;103;585;134;204;15;218;2945
6;131209;Nevogilde;2296;2722;2145;2603;1193;1137;1098;1030;95;107;7.9630000000000001;9.4109999999999996;13;318;1797;21;22;74;85;2724.3000000000002;1246.5;1477.8;43.140000000000001;367;289;1208;253;179;412;254;1442;287;327;15;218;2946
6;131306;Beiriz;1760;1923;1842;1904;939;852;820;731;119;121;12.673;14.202;41;555;955;17;21;102;100;756.79999999999995;361.60000000000002;395.10000000000002;39.170000000000002;332;216;1006;129;77;331;208;1067;178;139;15;219;2958
6;131412;Lamelas;435;487;415;478;250;209;221;167;29;42;11.6;20.096;6;149;233;3;6;26;36;209.09999999999999;98.700000000000003;110.5;42.689999999999998;55;43;269;42;26;70;43;274;47;53;15;220;2976
6;131601;Arcos;393;426;381;426;216;189;202;160;14;29;6.4809999999999999;15.343999999999999;71;149;142;2;4;12;25;140.90000000000001;67.599999999999994;73.299999999999997;40.25;70;54;200;42;27;67;51;231;36;41;15;223;3002
6;131613;Labruge;1372;1434;1281;1386;780;694;693;577;87;117;11.154;16.859000000000002;63;404;803;10;17;77;100;553.39999999999998;270.60000000000002;282.80000000000001;41.280000000000001;219;139;819;100;95;190;144;836;115;149;15;223;3014
6;131614;Macieira da Maia;1138;1183;1067;1140;632;594;554;468;78;126;12.342000000000001;21.212;37;440;545;9;17;69;109;391.60000000000002;192;199.59999999999999;36.57;241;141;646;70;40;220;117;693;82;71;15;223;3015
6;131716;Vila Nova de Gaia (Santa Marinha);14054;16092;13408;15638;7582;7830;6213;6344;1369;1486;18.056000000000001;18.978000000000002;23;2117;10417;212;247;1157;1239;5094.1999999999998;2374.9000000000001;2719.3000000000002;41.729999999999997;2165;1579;8172;1278;860;1983;1584;9375;1533;1617;15;224;3053
6;131805;Coronado (São Romão);2341;2486;2226;2434;1366;1191;1190;908;176;283;12.884;23.762;31;897;1170;27;37;149;246;1372.4000000000001;665.60000000000002;706.79999999999995;37.359999999999999;434;272;1382;163;90;439;282;1437;172;156;15;221;2993
6;131808;Muro;918;1004;887;970;524;469;450;381;74;88;14.122;18.763000000000002;17;390;424;13;12;61;76;407.30000000000001;194.59999999999999;212.80000000000001;40.890000000000001;143;110;540;81;44;141;116;581;83;83;15;221;2996
6;140110;São Facundo;471;456;458;450;215;144;175;115;40;29;18.605;20.138999999999999;28;108;154;3;4;37;25;11.5;5.9000000000000004;5.7000000000000002;52.579999999999998;44;39;240;69;79;37;22;190;82;125;16;225;3070
6;140803;Santa Margarida da Coutada;853;935;910;926;429;366;372;313;57;53;13.287000000000001;14.481;16;196;473;11;13;46;40;30.5;14.5;15.9;44.509999999999998;116;73;469;108;87;146;79;473;113;124;16;232;3111
6;141107;Igreja Nova do Sobral;312;350;285;330;119;86;112;75;7;11;5.8819999999999997;12.791;16;69;102;0;2;7;9;50.399999999999999;23.699999999999999;26.600000000000001;51.350000000000001;35;48;139;56;34;26;27;138;64;95;16;235;3128
6;141304;Carvoeiro;303;317;282;306;121;71;114;64;7;7;5.7850000000000001;9.859;7;80;91;0;0;7;7;12.699999999999999;6.2000000000000002;6.5;52.689999999999998;34;24;139;47;59;32;21;121;56;87;16;237;3136
6;141305;Envendos;468;516;453;500;172;119;152;111;20;8;11.628;6.7229999999999999;9;110;144;2;1;18;7;10.699999999999999;5.0999999999999996;5.5999999999999996;57.759999999999998;29;37;209;74;119;25;36;181;101;173;16;237;3137
6;141405;Fráguas;429;476;407;458;211;174;185;143;26;31;12.321999999999999;17.815999999999999;32;132;164;2;2;24;29;56.100000000000001;26.600000000000001;29.5;44.689999999999998;56;50;230;51;42;59;48;247;60;62;16;239;3165
6;141406;Marmeleira;210;227;205;228;103;80;94;60;9;20;8.7379999999999995;25;9;38;107;1;3;8;17;49.399999999999999;23.699999999999999;25.600000000000001;43.219999999999999;34;18;115;18;25;38;21;112;27;29;16;239;3167
6;141503;Muge;598;672;587;663;310;292;263;236;47;56;15.161;19.178000000000001;50;160;289;4;7;43;49;25.600000000000001;12.1;13.6;46.100000000000001;77;55;322;84;60;82;56;344;90;100;16;240;3177
6;141608;Arneiro das Milhariças;399;436;374;424;178;148;172;130;6;18;3.371;12.162000000000001;3;125;174;2;2;4;16;69.5;33.200000000000003;36.299999999999997;49.409999999999997;46;39;206;48;60;45;30;196;68;97;16;241;3186
6;141625;Vale de Santarém;1403;1517;1348;1490;651;637;572;575;79;62;12.135;9.7330000000000005;51;202;894;14;13;65;49;286.39999999999998;137.59999999999999;148.80000000000001;43.93;236;132;755;167;113;191;143;798;196;189;16;241;3204
6;141902;Assentiz;1390;1531;1348;1490;684;516;641;456;43;60;6.2869999999999999;11.628;17;380;700;10;13;33;47;89;42.399999999999999;46.600000000000001;46.369999999999997;182;148;744;189;127;167;151;745;228;240;16;244;3228
6;141910;Riachos;2496;2751;2396;2684;1210;1164;1113;1071;97;93;8.0169999999999995;7.9900000000000002;62;471;1651;17;12;80;81;360.10000000000002;171.30000000000001;188.80000000000001;44.280000000000001;383;249;1382;283;199;367;221;1453;343;367;16;244;3237
6;150408;Coina;826;896;799;871;415;376;353;302;62;74;14.94;19.681000000000001;4;195;456;11;11;51;63;258.19999999999999;123.90000000000001;134.40000000000001;42.759999999999998;121;84;459;93;69;137;89;475;110;85;17;249;3271
6;150502;Grândola;5163;5494;4922;5323;2502;2248;2270;1955;232;293;9.2729999999999997;13.034000000000001;297;804;3124;34;44;198;249;29.300000000000001;14.199999999999999;15.1;45.119999999999997;745;513;2697;607;601;698;460;2805;716;815;17;250;3279
6;150606;Vale da Amoreira;4695;5169;4400;4966;2299;2216;1585;1684;714;532;31.056999999999999;24.007000000000001;14;738;2517;160;127;554;405;4082.8000000000002;1943.3;2139.5;37.600000000000001;842;809;2536;340;168;865;819;2796;409;280;17;251;3287
6;150707;Atalaia;1087;1152;1050;1118;617;562;560;514;57;48;9.2379999999999995;8.5410000000000004;34;201;839;8;6;49;42;852.20000000000005;413.69999999999999;438.5;37.149999999999999;221;95;651;74;46;247;80;657;86;82;17;252;3290
6;151202;Setúbal (Santa Maria da Graça);3528;4092;3345;3925;1786;1868;1488;1525;298;343;16.684999999999999;18.361999999999998;27;669;2317;37;56;261;287;2780.0999999999999;1287.2;1493;44.689999999999998;512;359;1926;446;285;421;413;2221;532;505;17;257;3326
6;151206;São Simão;3494;3745;3381;3669;1761;1680;1605;1479;156;201;8.859;11.964;40;697;2347;29;37;127;164;328;158.30000000000001;169.69999999999999;39.719999999999999;704;340;1908;337;205;696;358;2053;360;278;17;257;3324
6;151208;Sado;2915;2868;2807;2799;1565;1304;1363;1088;202;216;12.907;16.564;108;884;1459;40;47;162;169;88.299999999999997;44.5;43.799999999999997;42.060000000000002;457;338;1639;315;166;398;282;1633;333;222;17;257;3322
6;160127;Portela;117;143;111;139;29;20;28;16;1;4;3.448;20;3;19;22;0;1;1;3;35.5;16;19.600000000000001;58.75;5;7;54;16;35;6;11;51;39;36;18;259;3362
6;160146;Soajo;409;577;399;568;84;68;71;60;13;8;15.475999999999999;11.765000000000001;27;38;66;0;1;13;7;16.699999999999999;6.9000000000000004;9.8000000000000007;56.630000000000003;33;28;179;95;74;43;19;235;122;158;18;259;3374
6;160216;Venade;390;427;373;427;182;141;169;128;13;13;7.1429999999999998;9.2200000000000006;12;83;202;4;3;9;10;138.19999999999999;66;72.200000000000003;44.200000000000003;65;40;212;42;31;57;36;220;47;67;18;260;3397
6;160219;Vilarelho;532;593;496;574;264;278;235;239;29;39;10.984999999999999;14.029;16;83;375;6;5;23;34;240.40000000000001;113.7;126.7;42.829999999999998;90;61;292;48;41;65;60;341;52;75;18;260;3400
6;160401;Abedim;85;120;82;116;34;39;33;38;1;1;2.9409999999999998;2.5640000000000001;21;26;24;0;1;1;0;26.600000000000001;11;15.5;52.210000000000001;8;4;45;17;11;9;7;61;20;23;18;262;3420
6;160403;Badim;70;108;72;102;24;19;22;16;2;3;8.3330000000000002;15.789;5;9;24;0;1;2;2;31.699999999999999;12.5;19.199999999999999;52.200000000000003;6;8;28;15;13;9;12;37;29;21;18;262;3422
6;160408;Ceivães;237;255;220;250;104;55;92;46;12;9;11.538;16.364000000000001;3;35;100;1;4;11;5;148;71.299999999999997;76.700000000000003;52.090000000000003;18;27;125;36;31;17;15;118;53;52;18;262;3427
6;160516;Paredes de Coura;764;817;713;773;388;360;347;327;41;33;10.567;9.1669999999999998;9;151;514;13;9;28;24;572.89999999999998;276.89999999999998;296.10000000000002;41.700000000000003;130;108;416;57;53;104;81;436;75;121;18;263;3468
6;160602;Boivães;141;148;135;146;54;32;39;27;15;5;27.777999999999999;15.625;8;31;27;2;1;13;4;81.900000000000006;39.899999999999999;41.899999999999999;45.710000000000001;21;21;63;19;17;14;15;71;30;18;18;264;3475
6;160607;Entre Ambos-os-Rios;227;275;205;260;86;71;71;59;15;12;17.442;16.901;14;46;70;1;4;14;8;34.399999999999999;15.6;18.899999999999999;50.670000000000002;23;20;113;40;31;17;27;121;44;66;18;264;3480
6;160703;Arcos;282;358;274;356;139;125;128;101;11;24;7.9139999999999997;19.199999999999999;15;89;125;0;5;11;19;42.5;18.699999999999999;23.800000000000001;44.600000000000001;41;28;150;37;26;53;37;170;42;56;18;265;3501
6;160716;Correlhã;1405;1531;1314;1476;738;585;664;493;74;92;10.026999999999999;15.725999999999999;55;467;635;16;25;58;67;339.19999999999999;162.30000000000001;176.90000000000001;40.640000000000001;248;176;783;105;93;218;162;833;141;177;18;265;3514
6;160739;Ribeira;889;1013;853;983;455;402;418;360;37;42;8.1319999999999997;10.448;19;260;499;8;6;29;36;216.80000000000001;101.40000000000001;115.5;41.899999999999999;148;99;481;78;83;149;102;537;103;122;18;265;3539
6;160740;Sá;193;230;190;223;102;81;91;70;11;11;10.784000000000001;13.58;15;57;89;3;5;8;6;151.19999999999999;69;82.200000000000003;41.25;33;22;106;21;11;38;26;114;24;28;18;265;3540
6;160814;Taião;69;84;70;87;24;25;23;25;1;0;4.1669999999999998;0;0;26;22;0;0;1;0;18.199999999999999;8.1999999999999993;10;48.770000000000003;7;7;37;9;9;9;6;44;11;14;18;266;3563
6;160905;Areosa;2267;2586;2133;2489;1155;1193;1034;1060;121;133;10.475999999999999;11.148;17;496;1581;26;33;95;100;343.89999999999998;160.69999999999999;183.30000000000001;42.600000000000001;332;262;1303;211;159;333;260;1463;247;283;18;267;3570
6;160912;Deão;434;517;411;504;208;216;191;189;17;27;8.173;12.5;12;155;213;3;8;14;19;282;128.69999999999999;153.30000000000001;43.880000000000003;68;40;243;46;37;65;43;276;70;63;18;267;3578
6;160937;Vila Mou;239;327;220;309;110;110;101;92;9;18;8.1820000000000004;16.364000000000001;12;68;113;2;6;7;12;196.30000000000001;82.900000000000006;113.40000000000001;47.350000000000001;32;21;126;30;30;33;34;160;48;52;18;267;3604
6;161011;Reboreda;352;404;352;429;167;151;153;143;14;8;8.3829999999999991;5.298;6;121;169;4;3;10;5;113.09999999999999;52.700000000000003;60.399999999999999;44.270000000000003;49;39;203;36;25;56;34;205;39;70;18;268;3616
6;170114;São Mamede de Ribatua;353;375;351;375;152;97;137;76;15;21;9.8680000000000003;21.649000000000001;81;30;102;3;14;12;7;36.200000000000003;17.600000000000001;18.699999999999999;50.130000000000003;31;35;189;46;52;38;31;182;55;69;19;269;3634
6;170116;Vila Chã;267;266;266;265;105;76;91;60;14;16;13.333;21.053000000000001;24;33;94;2;4;12;12;26.399999999999999;13.199999999999999;13.199999999999999;51.119999999999997;27;29;122;43;46;21;22;121;48;54;19;269;3636
6;170205;Boticas;611;669;598;651;281;280;259;267;22;13;7.8289999999999997;4.6429999999999998;18;138;370;4;4;18;9;92;43.899999999999999;48.100000000000001;45.780000000000001;64;61;339;73;74;82;71;343;61;112;19;270;3644
6;170322;Paradela;130;132;125;128;51;22;45;19;6;3;11.765000000000001;13.635999999999999;14;16;34;2;2;4;1;31.899999999999999;15.800000000000001;16.100000000000001;49.43;14;12;66;23;15;12;14;62;24;20;19;271;3677
6;170323;Póvoa de Agrações;97;89;97;90;13;4;8;3;5;1;38.462000000000003;25;2;4;5;0;0;5;1;25.699999999999999;13.4;12.300000000000001;53.920000000000002;8;4;51;16;18;7;6;38;26;12;19;271;3678
6;170335;Seara Velha;81;84;81;84;44;16;41;12;3;4;6.8179999999999996;25;28;6;19;0;0;3;4;17.800000000000001;8.8000000000000007;9.0999999999999996;52.25;8;6;44;13;10;5;4;42;12;21;19;271;3692
6;170338;Soutelo;172;178;156;171;72;47;70;39;2;8;2.778;17.021000000000001;11;37;61;0;3;2;5;39.5;19.399999999999999;20.100000000000001;49.280000000000001;19;21;84;31;17;11;23;82;26;36;19;271;3695
6;170609;Ferral;188;209;182;205;64;43;55;33;9;10;14.063000000000001;23.256;11;21;56;4;4;5;6;26;12.300000000000001;13.699999999999999;50.859999999999999;18;16;95;28;31;19;22;101;31;36;19;274;3730
6;170626;Salto;691;738;696;728;272;180;242;156;30;24;11.029;13.333;73;96;229;9;10;21;14;18.199999999999999;8.8000000000000007;9.4000000000000004;49.729999999999997;71;71;339;91;119;66;74;333;119;146;19;274;3747
6;170630;Sezelhe;63;79;58;75;23;21;23;18;0;3;0;14.286;14;7;20;0;0;0;3;11;4.9000000000000004;6.0999999999999996;51.409999999999997;5;4;29;10;15;11;6;28;13;21;19;274;3750
6;170631;Solveira;73;81;73;82;24;11;23;11;1;0;4.1669999999999998;0;8;11;15;1;0;0;0;12.5;5.9000000000000004;6.5999999999999996;53.600000000000001;6;5;31;17;14;7;8;33;20;13;19;274;3751
6;170702;Carva;129;140;122;135;43;25;36;24;7;1;16.279;4;8;24;28;1;0;6;1;17.699999999999999;8.5;9.1999999999999993;46.299999999999997;17;10;71;16;15;19;12;73;20;16;19;275;3758
6;170804;Godim;2190;2477;2095;2430;1175;983;981;839;194;144;16.510999999999999;14.649000000000001;100;369;1351;38;41;156;103;1083.4000000000001;508.39999999999998;575;41.600000000000001;326;262;1301;176;125;317;302;1370;259;229;19;276;3770
6;171001;Celeirós;116;106;114;109;56;38;50;33;6;5;10.714;13.157999999999999;14;24;45;1;4;5;1;42.299999999999997;22.100000000000001;20.199999999999999;41.960000000000001;27;10;57;12;10;15;6;54;15;16;19;278;3785
6;171003;Gouvães do Douro;66;76;61;72;31;22;24;18;7;4;22.581;18.181999999999999;22;10;10;1;0;6;4;22.100000000000001;10.300000000000001;11.800000000000001;49.240000000000002;7;7;31;14;7;7;8;37;12;12;19;278;3787
6;171101;Alvações do Corgo;220;257;210;245;111;92;97;73;14;19;12.613;20.652000000000001;50;39;81;3;4;11;15;109.8;50.700000000000003;59.200000000000003;47.939999999999998;21;28;124;25;22;23;22;135;36;41;19;279;3800
6;10102;Aguada de Baixo;643;730;611;711;371;323;327;288;44;35;11.859999999999999;10.836;14;317;284;9;7;35;28;373.80000000000001;175.09999999999999;198.69999999999999;45.450000000000003;64;86;361;79;53;84;78;385;86;97;1;1;2
6;10405;Cabreiros;57;69;52;67;26;15;24;14;2;1;7.6920000000000002;6.6669999999999998;10;15;13;0;0;2;1;6.5;3;3.6000000000000001;52.710000000000001;7;3;29;3;15;7;4;29;13;16;1;4;48
6;10412;Janarde;59;60;60;59;31;12;31;12;0;0;0;0;9;22;12;0;0;0;0;6.7000000000000002;3.2999999999999998;3.3999999999999999;47.130000000000003;7;6;28;8;10;6;6;30;9;9;1;4;55
6;10701;Anta;4934;5429;4786;5356;2490;2366;2057;1911;433;455;17.390000000000001;19.231000000000002;24;1224;2720;91;89;342;366;1722;819.89999999999998;902.10000000000002;42.549999999999997;749;577;2818;473;317;651;577;3145;561;495;1;7;87
6;11707;Silva Escura;757;835;708;804;372;317;359;276;13;41;3.4950000000000001;12.933999999999999;17;335;283;1;11;12;30;105.09999999999999;50;55.100000000000001;44.590000000000003;118;85;386;100;68;105;92;410;125;103;1;17;187
6;11808;Vagos;2196;2410;2063;2306;1153;1136;1052;1000;101;136;8.7599999999999998;11.972;48;615;1389;20;30;81;106;214.09999999999999;102.09999999999999;112;40.740000000000002;386;250;1207;214;139;317;264;1369;226;234;1;18;199
6;11906;Macieira de Cambra;2291;2461;2202;2428;1197;999;1115;881;82;118;6.8499999999999996;11.811999999999999;31;1024;941;12;32;70;86;260.60000000000002;125.59999999999999;135;43.859999999999999;325;259;1264;228;215;302;228;1330;292;309;1;19;204
6;11908;Vila Chã;1939;1973;1849;1947;1060;948;1002;856;58;92;5.4719999999999995;9.7050000000000001;13;951;894;10;14;48;78;687.20000000000005;340.60000000000002;346.60000000000002;41.780000000000001;290;240;1103;158;148;253;183;1166;185;186;1;19;207
6;20603;Entradas;310;339;290;322;147;110;135;92;12;18;8.1630000000000003;16.364000000000001;27;63;137;0;3;12;15;8.5;4.0999999999999996;4.5;49.869999999999997;29;31;158;42;50;31;32;146;53;77;3;44;401
6;21001;Amareleja;1261;1303;1192;1260;576;389;469;259;107;130;18.576000000000001;33.418999999999997;155;151;422;12;26;95;104;23.600000000000001;11.6;12;44.060000000000002;197;144;637;128;155;192;145;588;156;222;3;48;423
6;21116;Boavista dos Pinheiros;822;811;799;793;409;394;373;344;36;50;8.8019999999999996;12.69;124;108;485;1;6;35;44;43.200000000000003;21.699999999999999;21.399999999999999;40.82;162;75;430;61;94;120;89;429;90;83;3;49;432
6;151101;Sesimbra (Castelo);9429;9624;8881;9291;4950;4379;4405;3843;545;536;11.01;12.24;324;1784;6140;101;98;444;438;106.3;52.600000000000001;53.700000000000003;40.579999999999998;1626;997;5301;909;596;1524;927;5474;900;799;17;256;3319
6;151204;São Lourenço;5656;5982;5393;5877;3051;2782;2676;2435;375;347;12.291;12.473000000000001;56;1124;3931;68;61;307;286;246.40000000000001;119.7;126.59999999999999;39.950000000000003;1081;578;3143;486;368;1032;520;3367;526;537;17;257;3323
6;21101;Colos;497;508;481;496;247;157;214;136;33;21;13.359999999999999;13.375999999999999;47;112;191;3;4;30;17;9.6999999999999993;4.7999999999999998;4.9000000000000004;49.600000000000001;40;51;274;60;72;51;45;228;82;102;3;49;433
6;21115;Luzianes-Gare;242;187;231;177;79;37;77;36;2;1;2.532;2.7029999999999998;37;17;59;0;0;2;1;4.5999999999999996;2.6000000000000001;2;52.149999999999999;25;18;113;43;43;17;11;86;33;40;3;49;435
6;150102;Santa Susana;180;173;172;167;69;46;64;41;5;5;7.2460000000000004;10.869999999999999;46;13;46;1;3;4;2;2.1000000000000001;1.1000000000000001;1;56.049999999999997;10;10;86;30;44;10;10;79;42;32;17;246;3252
6;150103;Alcácer do Sal (Santiago);2206;2426;2115;2362;1130;987;1026;886;104;101;9.2040000000000006;10.233000000000001;236;347;1329;28;22;76;79;16.199999999999999;7.7000000000000002;8.5;45.340000000000003;337;201;1197;247;224;312;201;1214;314;385;17;246;3250
6;150505;Carvalhal;1060;570;1082;584;287;258;258;224;29;34;10.105;13.178000000000001;54;98;330;3;4;26;30;19.899999999999999;12.9;7;42.009999999999998;78;77;789;64;52;76;55;314;67;58;17;250;3278
6;70704;Pavia;476;456;468;456;230;177;215;141;15;36;6.5220000000000002;20.338999999999999;64;86;206;1;1;14;35;5;2.6000000000000001;2.5;49.619999999999997;47;38;258;55;78;43;36;228;67;82;8;112;1710
6;120201;Assunção;926;1044;896;1045;429;402;372;352;57;50;13.287000000000001;12.438000000000001;73;91;560;14;11;43;39;9.5999999999999996;4.5;5.0999999999999996;48.409999999999997;122;102;454;107;141;100;82;488;152;222;14;193;2591
6;120305;Ervedal;272;288;259;273;128;97;114;80;14;17;10.938000000000001;17.526;47;32;115;1;4;13;13;14.699999999999999;7.0999999999999996;7.5999999999999996;48.899999999999999;28;27;129;42;46;32;32;126;42;56;14;194;2598
6;120401;Nossa Senhora da Expectação;1898;2076;1798;2004;907;841;799;721;108;120;11.907;14.269;96;456;968;33;31;75;89;37.799999999999997;18.100000000000001;19.800000000000001;41.640000000000001;326;213;996;181;182;332;220;1020;236;268;14;195;2602
6;120501;Nossa Senhora da Graça de Póvoa e Meadas;294;312;280;303;99;101;85;86;14;15;14.141;14.850999999999999;19;25;127;0;3;14;12;8.1999999999999993;4;4.2000000000000002;56.219999999999999;32;18;125;45;74;20;16;114;60;102;14;196;2605
6;120602;Crato e Mártires;773;901;761;909;340;336;308;305;32;31;9.4120000000000008;9.2260000000000009;36;71;506;5;9;27;22;9.4000000000000004;4.2999999999999998;5;47.100000000000001;105;72;397;106;93;102;76;436;129;158;14;197;2610
6;120605;Monte da Pedra;137;143;138;144;51;33;45;26;6;7;11.765000000000001;21.212;14;18;39;0;0;6;7;4.7000000000000002;2.2999999999999998;2.3999999999999999;56.060000000000002;7;8;66;25;31;13;4;61;29;36;14;197;2613
6;120707;São Brás e São Lourenço;827;857;790;820;399;363;350;310;49;53;12.281000000000001;14.600999999999999;75;75;510;8;10;41;43;35.399999999999999;17.399999999999999;18;42.960000000000001;121;103;433;92;78;126;90;451;93;97;14;198;2621
6;120710;Vila Boim;594;630;577;603;296;240;254;195;42;45;14.189;18.75;63;68;318;9;11;33;34;48;23.300000000000001;24.699999999999999;45.829999999999998;70;63;328;51;82;84;64;298;58;126;14;198;2624
6;120802;Fronteira;993;1076;944;1040;490;429;430;366;60;63;12.244999999999999;14.685;106;128;562;10;10;50;53;14.6;7;7.5999999999999996;46.509999999999998;136;118;513;110;116;115;98;528;127;208;14;199;2627
6;121203;Arez;131;125;131;124;49;30;41;25;8;5;16.327000000000002;16.667000000000002;6;13;47;0;2;8;3;4.5999999999999996;2.3999999999999999;2.2000000000000002;56.43;9;5;64;19;34;10;9;42;23;41;14;203;2644
6;121404;Fortios;965;1053;927;1024;484;457;438;403;46;54;9.5039999999999996;11.816000000000001;35;144;662;11;10;35;44;30.600000000000001;14.699999999999999;16;43.770000000000003;142;96;536;72;119;166;95;536;99;157;14;205;2662
6;70405;Santa Vitória do Ameixial;180;182;166;167;91;70;87;59;4;11;4.3959999999999999;15.714;47;33;66;0;2;4;9;6.5;3.2000000000000002;3.2999999999999998;49.439999999999998;15;24;89;23;29;14;17;85;32;34;8;109;1670
6;70413;Veiros;489;547;466;531;231;187;216;159;15;28;6.4939999999999998;14.973000000000001;70;91;214;2;8;13;20;26.100000000000001;12.300000000000001;13.800000000000001;51.18;52;37;242;53;105;40;55;230;85;137;8;109;1677
6;70507;Évora (São Mamede);695;1029;714;1051;337;391;291;347;46;44;13.65;11.253;18;77;543;3;10;43;34;7420.8999999999996;2991.5999999999999;4429.3000000000002;49.850000000000001;62;67;377;85;104;76;98;476;152;227;8;110;1681
6;70607;Ciborro;354;360;347;355;178;135;172;120;6;15;3.371;11.111000000000001;50;111;131;1;0;5;15;12.9;6.4000000000000004;6.5;51.979999999999997;27;28;175;47;77;34;26;157;67;76;8;111;1698
6;70801;Granja;304;301;304;303;130;84;104;60;26;24;20;28.571000000000002;32;32;100;3;3;23;21;6.5;3.2999999999999998;3.2999999999999998;48.729999999999997;35;33;148;40;48;34;30;127;55;55;8;113;1711
6;70802;Luz;153;137;152;137;84;61;71;48;13;13;15.475999999999999;21.311;20;30;69;5;1;8;12;5.7000000000000002;3;2.7000000000000002;47.460000000000001;14;24;79;13;23;13;10;67;14;33;8;113;1712
6;121502;Casa Branca;574;658;552;633;275;237;238;198;37;39;13.455;16.456;112;87;237;5;3;32;36;12.199999999999999;5.7000000000000002;6.5;48.32;86;56;279;71;82;50;64;304;106;134;14;206;2670
6;20101;Aljustrel;2540;2597;2435;2509;1247;1085;1120;912;127;173;10.183999999999999;15.945;103;618;1311;22;33;105;140;26.800000000000001;13.300000000000001;13.6;43.909999999999997;337;287;1481;247;188;328;235;1397;311;326;3;39;365
6;20104;São João de Negrilhos;736;746;698;716;353;248;298;191;55;57;15.581;22.984000000000002;93;144;252;4;7;51;50;19.199999999999999;9.5999999999999996;9.6999999999999993;48.490000000000002;75;71;400;103;87;71;73;346;114;142;3;39;369
6;20105;Rio de Moinhos;378;363;346;341;193;106;176;80;17;26;8.8079999999999998;24.527999999999999;24;122;110;2;2;15;24;19.800000000000001;10.1;9.6999999999999993;46.859999999999999;42;39;217;36;44;42;32;177;55;57;3;39;368
6;20504;Cabeça Gorda;691;695;659;671;335;250;286;204;49;46;14.627000000000001;18.399999999999999;72;72;346;10;6;39;40;17.699999999999999;8.8000000000000007;8.9000000000000004;45.07;95;72;382;75;67;89;56;342;106;102;3;43;388
6;20507;Quintos;126;129;124;128;63;39;54;33;9;6;14.286;15.385;20;18;49;0;1;9;5;1.8;0.90000000000000002;0.90000000000000002;50.159999999999997;12;11;69;14;20;15;9;55;19;31;3;43;391
6;20602;Castro Verde;2402;2496;2247;2406;1278;1106;1187;972;91;134;7.1210000000000004;12.116;128;612;1419;20;30;71;104;17;8.3000000000000007;8.5999999999999996;42.240000000000002;351;287;1346;222;196;373;258;1316;254;295;3;44;400
6;20701;Cuba;1616;1690;1587;1663;824;693;724;603;100;90;12.135999999999999;12.987;109;210;1008;22;24;78;66;47.200000000000003;23.100000000000001;24.100000000000001;42.960000000000001;249;173;896;138;160;224;193;836;200;237;3;45;404
6;20806;Canhestros;221;223;215;216;99;59;93;50;6;9;6.0609999999999999;15.254;38;43;62;1;1;5;8;6.2000000000000002;3.1000000000000001;3.1000000000000001;51.840000000000003;18;19;115;31;38;16;18;98;46;45;3;46;409
6;20907;São Miguel do Pinheiro;298;298;287;292;134;68;129;59;5;9;3.7309999999999999;13.234999999999999;33;70;85;2;1;3;8;4.2999999999999998;2.1000000000000001;2.1000000000000001;57.810000000000002;11;25;149;46;67;15;14;112;61;96;3;47;420
6;21201;Conceição;44;42;44;41;19;9;17;7;2;2;10.526;22.222000000000001;5;4;15;0;0;2;2;2.6000000000000001;1.3;1.3;56.57;4;4;20;8;8;1;1;16;10;14;3;50;448
6;21303;Pias;1399;1453;1349;1424;694;498;554;336;140;162;20.172999999999998;32.530000000000001;234;140;516;10;13;130;149;17.399999999999999;8.5;8.9000000000000004;46.579999999999998;171;135;756;156;181;176;152;649;223;253;3;51;456
6;21305;Serpa (Santa Maria);902;966;871;919;461;393;387;325;74;68;16.052;17.303000000000001;105;108;499;12;23;62;45;12.1;5.7999999999999998;6.2999999999999998;44.810000000000002;143;88;489;97;85;107;118;455;130;156;3;51;458
6;140303;Fazendas de Almeirim;3328;3621;3154;3521;1672;1456;1457;1264;215;192;12.859;13.186999999999999;396;702;1623;31;22;184;170;119.2;57.100000000000001;62.100000000000001;43.909999999999997;491;305;1833;405;294;530;291;1881;459;460;16;227;3087
6;140605;Valada;417;404;420;409;193;135;174;116;19;19;9.8450000000000006;14.074;69;63;158;4;3;15;16;19.5;9.9000000000000004;9.5999999999999996;47.899999999999999;54;35;226;61;41;38;35;196;63;72;16;230;3098
6;140606;Vale da Pinta;660;635;610;617;331;274;287;238;44;36;13.292999999999999;13.138999999999999;17;152;356;6;5;38;31;141.19999999999999;71.900000000000006;69.200000000000003;45.450000000000003;77;65;374;84;60;66;62;354;78;75;16;230;3100
6;140701;Chamusca;1603;1757;1538;1710;807;738;706;664;101;74;12.515000000000001;10.026999999999999;99;277;994;11;13;90;61;95.299999999999997;45.399999999999999;49.799999999999997;45.390000000000001;220;177;874;184;148;191;153;911;229;273;16;231;3103
6;141611;Casével;424;440;404;427;213;163;193;143;20;20;9.3900000000000006;12.27;39;101;196;4;4;16;16;26;12.800000000000001;13.199999999999999;48.399999999999999;45;36;232;58;53;41;38;220;68;73;16;241;3189
6;141612;Santarém (Marvila);4016;5028;3951;5095;1867;2066;1596;1843;271;223;14.515000000000001;10.794;143;415;2881;55;48;216;175;635.79999999999995;282.30000000000001;353.5;45.75;564;445;2103;507;397;549;525;2506;701;747;16;241;3198
6;141613;Moçarria;549;587;527;578;281;236;262;216;19;20;6.7620000000000005;8.4749999999999996;23;138;317;5;4;14;16;93.700000000000003;45.299999999999997;48.399999999999999;45.270000000000003;79;56;299;70;45;74;51;295;86;81;16;241;3191
6;141617;Póvoa de Santarém;342;366;330;359;166;120;141;112;25;8;15.06;6.6669999999999998;15;66;172;0;0;25;8;87.400000000000006;42.200000000000003;45.200000000000003;45.25;58;30;175;40;39;50;34;169;47;66;16;241;3195
6;141621;Santarém (São Salvador);4993;5520;4758;5411;2667;2864;2371;2581;296;283;11.099;9.8810000000000002;112;763;4077;53;64;243;219;885.89999999999998;420.69999999999999;465.10000000000002;38.890000000000001;936;585;2841;360;271;880;533;3199;448;460;16;241;3200
6;80501;Conceição;2267;2257;2189;2176;1229;1064;1022;922;207;142;16.843;13.346;216;397;1331;35;31;172;111;207.40000000000001;104;103.5;41.520000000000003;363;244;1290;206;164;336;247;1232;203;239;9;124;1766
6;80505;Faro (Sé);13796;15746;13374;15587;7299;7997;6220;7015;1079;982;14.782999999999999;12.279999999999999;317;1456;11462;191;196;888;786;482.10000000000002;225.09999999999999;257;41.909999999999997;2055;1516;7948;1268;1009;1982;1568;9144;1507;1545;9;124;1769
6;80606;Parchal;1983;2036;1823;1921;1111;1033;942;865;169;168;15.212;16.263000000000002;28;254;1525;17;22;152;146;1040.4000000000001;513.29999999999995;527.10000000000002;38.090000000000003;354;251;1150;137;91;366;220;1169;144;137;9;125;1776
6;80701;Barão de São João;448;447;457;452;214;157;173;130;41;27;19.158999999999999;17.196999999999999;15;68;220;6;4;35;23;17.300000000000001;8.5999999999999996;8.5999999999999996;45.100000000000001;59;40;262;40;47;59;44;248;52;44;9;126;1778
6;81103;Portimão;21842;23589;21805;23408;11641;11354;9594;9372;2047;1982;17.584;17.456;160;3041;15765;249;240;1798;1742;600.5;288.69999999999999;311.80000000000001;40.689999999999998;3677;2479;12207;2003;1476;3542;2303;13256;2159;2329;9;130;1804
6;81402;Conceição;718;720;713;718;379;275;320;224;59;51;15.567;18.545000000000002;54;113;377;2;4;57;47;23.199999999999999;11.6;11.6;48.18;66;72;397;90;93;65;55;390;95;115;9;121;1747
6;81405;Tavira (Santa Maria);4266;4570;4497;4822;2192;2035;1860;1778;332;257;15.146000000000001;12.629;148;557;2933;38;51;294;206;69.900000000000006;33.700000000000003;36.100000000000001;41.469999999999999;694;422;2350;439;361;696;450;2467;460;497;9;121;1755
6;81504;Sagres;943;966;1075;1087;501;435;464;398;37;37;7.3849999999999998;8.5060000000000002;99;69;694;6;4;31;33;55.5;27.399999999999999;28.100000000000001;44.859999999999999;121;88;525;123;86;114;99;509;131;113;9;133;1817
6;81601;Vila Nova de Cacela;1877;2025;2111;2216;935;824;775;664;160;160;17.111999999999998;19.417000000000002;95;265;1079;18;22;142;138;84.799999999999997;40.799999999999997;44;44.759999999999998;247;164;1045;225;196;271;188;1072;216;278;9;134;1820
6;61703;Poiares (Santo André);2062;2244;1918;2202;1085;1025;1002;915;83;110;7.6500000000000004;10.731999999999999;28;485;1404;13;18;70;92;149.5;71.599999999999994;77.900000000000006;40.729999999999997;367;235;1156;168;136;343;208;1205;215;273;7;105;1646
6;100701;Castanheira de Pêra;1467;1624;1409;1592;604;530;533;442;71;88;11.755000000000001;16.603999999999999;33;359;583;9;6;62;82;61.299999999999997;29.100000000000001;32.200000000000003;48.990000000000002;163;161;744;217;182;168;124;766;262;304;11;155;2216
6;90110;Pinheiro;113;119;108;116;48;37;43;29;5;8;10.417;21.622;6;18;48;1;0;4;8;14.6;7.0999999999999996;7.5;49.060000000000002;13;11;53;22;14;11;9;51;32;16;10;135;1831
6;180611;Mesquitela;436;443;399;418;224;173;207;143;17;30;7.5890000000000004;17.341000000000001;6;142;202;3;2;14;28;130;64.5;65.5;41.530000000000001;72;58;229;37;40;69;50;226;46;52;20;288;3988
6;180903;Nelas;2264;2438;2242;2444;1111;1029;1015;892;96;137;8.641;13.314;35;658;1214;23;29;73;108;217.40000000000001;104.7;112.7;41.07;431;231;1213;217;172;371;235;1303;248;281;20;291;4031
6;181407;Treixedo;471;516;444;502;202;179;172;156;30;23;14.850999999999999;12.849;12;151;165;4;5;26;18;81.700000000000003;39;42.700000000000003;45.329999999999998;79;52;225;59;56;67;41;271;66;71;20;296;4091
6;181709;São Miguel de Vila Boa;651;683;614;667;338;246;307;177;31;69;9.1720000000000006;28.048999999999999;22;222;240;5;29;26;40;103.5;50.5;53;41.789999999999999;99;88;350;59;55;104;87;345;82;65;20;299;4134
6;182112;Mosteirinho;108;109;98;102;61;25;59;22;2;3;3.2789999999999999;12;22;35;24;0;0;2;3;12.4;6.2000000000000002;6.2000000000000002;47.609999999999999;11;11;57;14;15;14;9;49;22;15;20;303;4193
6;182204;Queiriga;266;309;254;297;100;71;92;64;8;7;8;9.859;4;51;101;2;0;6;7;18;8.3000000000000007;9.6999999999999993;53.5;27;31;109;53;46;23;20;118;66;82;20;304;4211
6;182328;Viseu (São José);2459;2936;2349;2953;1288;1382;1115;1180;173;202;13.432;14.616;13;386;1896;31;34;142;168;1310.5;597.29999999999995;713.20000000000005;41.939999999999998;347;303;1359;252;198;383;330;1616;289;318;20;305;4248
6;51003;Vila de Rei;1192;1418;1160;1397;496;455;446;425;50;30;10.081;6.593;33;247;591;8;3;42;27;18.399999999999999;8.4000000000000004;10;50.969999999999999;150;104;575;148;215;151;110;580;188;389;6;87;1434
6;141302;Amêndoa;251;264;236;247;96;76;87;68;9;8;9.375;10.526;4;59;92;0;2;9;6;13.699999999999999;6.7000000000000002;7;56.810000000000002;14;23;128;41;45;7;15;105;43;94;16;237;3134
6;90616;Gouveia (São Julião);767;855;787;900;326;342;290;298;36;44;11.042999999999999;12.865;10;78;500;10;11;26;33;204.69999999999999;96.799999999999997;107.90000000000001;46.259999999999998;102;88;383;110;84;86;80;446;134;109;10;140;1925
6;91213;Santa Comba;392;442;371;421;194;148;172;128;22;20;11.34;13.513999999999999;7;101;192;2;4;20;16;70.5;33.200000000000003;37.399999999999999;45.869999999999997;49;53;212;44;34;55;42;211;63;71;10;146;2096
6;90203;Almeida;613;701;585;672;318;266;295;248;23;18;7.2329999999999997;6.7670000000000003;37;76;430;3;2;20;16;25.100000000000001;11.699999999999999;13.4;48.789999999999999;52;60;349;83;69;65;66;347;89;134;10;136;1837
6;90204;Amoreira;81;97;81;91;36;25;35;18;1;7;2.778;28;1;21;31;0;0;1;7;13.199999999999999;6;7.2000000000000002;53.869999999999997;3;7;41;14;16;7;9;40;21;20;10;136;1838
6;90226;Vale de Coelha;22;21;19;21;10;5;10;5;0;0;0;0;4;6;5;0;0;0;0;7.5;3.8999999999999999;3.7000000000000002;50.979999999999997;3;2;11;4;2;2;;11;4;4;10;136;1861
6;90408;Figueira de Castelo Rodrigo;1095;1116;1041;1068;560;471;488;382;72;89;12.856999999999999;18.896000000000001;46;160;664;16;28;56;61;79.299999999999997;39.299999999999997;40;41.960000000000001;155;147;606;105;82;152;121;610;115;118;10;138;1893
6;90709;Benespera;137;160;131;153;63;44;56;37;7;7;11.111000000000001;15.909000000000001;13;39;41;2;1;5;6;16.399999999999999;7.5999999999999996;8.9000000000000004;52.350000000000001;16;8;72;19;22;10;7;75;28;40;10;141;1949
6;90721;Gonçalo Bocas;109;118;102;110;60;52;56;43;4;9;6.6669999999999998;17.308;0;29;70;1;2;3;7;35.200000000000003;16.899999999999999;18.300000000000001;44.420000000000002;18;7;64;12;8;16;10;57;17;18;10;141;1960
6;90726;Mizarela;66;69;65;66;23;18;20;15;3;3;13.042999999999999;16.667000000000002;2;7;26;0;1;3;2;24.399999999999999;12;12.5;55.810000000000002;4;2;34;13;13;4;3;33;19;10;10;141;1970
6;90728;Panoias de Cima;305;303;285;294;128;125;109;108;19;17;14.843999999999999;13.6;9;56;152;5;3;14;14;53.399999999999999;26.800000000000001;26.600000000000001;45.329999999999998;54;29;152;41;29;29;27;149;44;54;10;141;1972
6;90902;Barreira;77;100;76;96;17;11;16;10;1;1;5.8819999999999997;9.0909999999999993;7;3;16;0;0;1;1;6.9000000000000004;3;3.8999999999999999;62.68;;4;26;24;23;6;4;28;27;35;10;143;2001
6;91002;Atalaia;51;48;51;48;13;3;12;3;1;0;7.6920000000000002;0;5;1;9;0;0;1;0;4;2.1000000000000001;2;64.790000000000006;;2;20;10;19;;2;11;22;13;10;144;2017
6;91011;Gouveia;155;159;157;162;73;44;59;31;14;13;19.178000000000001;29.545000000000002;6;22;62;0;1;14;12;11.199999999999999;5.5999999999999996;5.7000000000000002;48.880000000000003;21;7;87;24;16;11;13;77;25;33;10;144;2026
6;91013;Lameiras;136;154;131;146;60;29;58;29;2;0;3.3330000000000002;0;6;44;37;0;0;2;0;16.300000000000001;7.7000000000000002;8.6999999999999993;51.149999999999999;6;18;75;20;17;10;13;73;29;29;10;144;2028
6;91111;Bismula;86;107;83;107;34;24;27;20;7;4;20.588000000000001;16.667000000000002;8;16;23;2;3;5;1;10.1;4.5;5.5999999999999996;55.549999999999997;7;6;37;13;23;7;14;31;15;40;10;145;2053
6;91112;Casteleiro;167;198;166;200;54;24;51;23;3;1;5.556;4.1669999999999998;21;18;35;0;0;3;1;8.1999999999999993;3.7999999999999998;4.5;62.530000000000001;6;8;69;35;49;5;8;56;49;80;10;145;2054
6;91118;Malcata;149;183;146;178;50;32;45;28;5;4;10;12.5;3;18;52;0;1;5;3;15.6;7;8.5999999999999996;59.530000000000001;11;3;62;29;44;12;7;63;43;58;10;145;2060
6;91133;Sortelha;211;233;207;221;90;70;82;66;8;4;8.8889999999999993;5.7140000000000004;17;49;82;1;1;7;3;11.199999999999999;5.2999999999999998;5.9000000000000004;55.140000000000001;14;14;109;25;49;9;23;93;43;65;10;145;2075
6;91137;Vale Longo;23;24;27;28;10;3;10;2;0;1;0;33.332999999999998;1;4;7;0;0;0;1;7.5;3.7000000000000002;3.7999999999999998;56.549999999999997;;2;14;4;3;;3;7;5;9;10;145;2079
6;50203;Benquerenças;357;363;341;351;131;105;122;95;9;10;6.8700000000000001;9.5240000000000009;4;51;162;0;1;9;9;11.800000000000001;5.9000000000000004;6;52.670000000000002;30;20;173;74;60;36;19;162;65;81;6;79;1286
6;50217;Ninho do Açor;194;186;200;192;83;56;78;46;5;10;6.024;17.856999999999999;9;55;60;0;1;5;9;32.200000000000003;16.399999999999999;15.800000000000001;51.170000000000002;20;17;94;38;25;11;11;94;35;35;6;79;1300
6;50224;Sobral do Campo;174;192;168;185;75;45;58;37;17;8;22.667000000000002;17.777999999999999;10;38;47;4;2;13;6;11.699999999999999;5.5999999999999996;6.2000000000000002;53.520000000000003;16;11;88;25;34;10;20;78;33;51;6;79;1307
6;50318;São Jorge da Beira;304;329;286;313;104;81;96;62;8;19;7.6920000000000002;23.457000000000001;0;75;83;1;2;7;17;27.5;13.199999999999999;14.300000000000001;55.049999999999997;22;21;154;65;42;21;20;133;81;74;6;80;1330
6;50321;Sarzedo;59;71;58;69;17;13;10;9;7;4;41.176000000000002;30.768999999999998;0;11;8;0;0;7;4;11.800000000000001;5.2999999999999998;6.4000000000000004;60.390000000000001;3;2;32;6;16;2;4;20;16;29;6;80;1331
6;50418;Janeiro de Cima;140;166;136;163;44;43;44;37;0;6;0;13.952999999999999;2;37;42;0;1;0;5;25.699999999999999;11.699999999999999;13.9;52.200000000000003;16;7;64;25;28;19;13;66;37;31;6;81;1358
6;50431;Enxames;265;255;248;243;107;81;95;59;12;22;11.215;27.16;7;63;84;1;3;11;19;23.100000000000001;11.800000000000001;11.300000000000001;49.289999999999999;34;30;120;38;43;14;31;119;34;57;6;81;1354
6;100113;Aljubarrota (São Vicente);1180;1224;1124;1197;582;533;539;463;43;70;7.3879999999999999;13.132999999999999;23;472;507;6;9;37;61;115;56.399999999999999;58.600000000000001;41.170000000000002;213;148;626;111;82;179;134;657;133;121;11;149;2161
6;100501;Bombarral;2665;2999;2502;2896;1360;1290;1220;1101;140;189;10.294;14.651;106;509;1706;26;40;114;149;308.69999999999999;145.19999999999999;163.5;42.710000000000001;414;307;1458;250;236;421;292;1574;335;377;11;153;2195
6;101201;A dos Negros;732;757;683;732;369;298;331;265;38;33;10.298;11.074;56;154;386;5;8;33;25;85.099999999999994;41.799999999999997;43.299999999999997;45.840000000000003;103;69;395;94;71;84;70;406;102;95;11;160;2258
6;110405;Lamas;1478;1594;1414;1548;695;552;625;487;70;65;10.071999999999999;11.775;81;265;766;5;7;65;58;81.599999999999994;39.299999999999997;42.399999999999999;47.189999999999998;203;132;765;175;203;183;142;761;232;276;12;169;2350
6;110809;Marteleira;873;888;827;859;430;357;395;313;35;44;8.1400000000000006;12.324999999999999;72;226;410;8;13;27;31;243;120.40000000000001;122.5;43.25;150;99;455;100;69;105;105;446;110;122;12;173;2434
6;111203;Sobral de Monte Agraço;1626;1780;1562;1708;860;815;792;746;68;69;7.907;8.4659999999999993;36;340;1162;18;13;50;56;391.60000000000002;187;204.69999999999999;41.75;277;184;897;139;129;251;165;978;167;219;12;178;2499
6;140210;Vila Moreira;468;506;448;478;244;209;221;185;23;24;9.4260000000000002;11.483000000000001;2;219;185;2;4;21;20;192;92.299999999999997;99.799999999999997;43.140000000000001;75;51;257;52;33;76;42;259;67;62;16;226;3084
6;141104;Chãos;278;319;275;318;95;73;89;66;6;7;6.3159999999999998;9.5890000000000004;8;55;92;3;3;3;4;25.600000000000001;11.9;13.699999999999999;50.270000000000003;36;19;129;38;56;35;19;146;63;56;16;235;3125
6;141813;São Pedro de Tomar;1470;1557;1427;1520;666;555;559;458;107;97;16.065999999999999;17.477;43;322;652;8;10;99;87;82.599999999999994;40.100000000000001;42.5;45.390000000000001;220;162;784;160;144;194;122;802;185;254;16;243;3224
6;142001;Atalaia;833;864;792;836;397;315;368;280;29;35;7.3049999999999997;11.111000000000001;3;114;531;5;5;24;30;117.90000000000001;57.899999999999999;60;44.939999999999998;110;91;442;115;75;117;71;461;116;99;16;245;3244
6;110614;Coração de Jesus;1698;1991;2617;2738;950;977;861;880;89;97;9.3680000000000003;9.9280000000000008;10;125;1606;14;17;75;80;6607.3999999999996;3041.3000000000002;3566.0999999999999;45.630000000000003;199;157;990;186;166;169;144;1087;245;346;12;171;2375
6;110615;Encarnação;1060;1192;1068;1232;592;546;528;484;64;62;10.811;11.355;8;63;941;12;13;52;49;11920.700000000001;5611;6309.6999999999998;45.659999999999997;121;87;638;102;112;102;118;607;160;205;12;171;2376
6;110626;Prazeres;3679;4417;3497;4163;1934;1942;1718;1754;216;188;11.169;9.6810000000000009;17;288;3167;40;36;176;152;5166.8999999999996;2348;2819;43.460000000000001;605;350;2066;343;315;591;380;2293;495;658;12;171;2387
6;110705;Fanhões;1403;1398;1378;1357;737;672;655;612;82;60;11.125999999999999;8.9290000000000003;11;278;978;15;13;67;47;241;120.7;120.3;42.07;230;155;790;136;92;198;138;747;156;159;12;172;2419
6;110722;Bobadela;4228;4611;4060;4504;2165;2214;1924;2006;241;208;11.132;9.3949999999999996;6;643;3281;44;33;197;175;2476.5;1184.5999999999999;1291.9000000000001;43.490000000000002;598;398;2412;512;308;556;374;2679;547;455;12;172;2416
6;110723;Prior Velho;3570;3566;3454;3497;1951;1844;1640;1638;311;206;15.941000000000001;11.170999999999999;7;587;2684;55;46;256;160;5406.6000000000004;2704.8000000000002;2701.8000000000002;37.390000000000001;696;431;2104;212;127;632;383;2044;267;240;12;172;2425
6;110901;Azueira;1536;1628;1493;1599;813;681;758;627;55;54;6.7649999999999997;7.9299999999999997;102;359;924;7;11;48;43;208.40000000000001;101.2;107.3;42.509999999999998;247;145;841;163;140;257;143;853;194;181;12;174;2443
6;110908;Igreja Nova;1522;1515;1468;1482;828;733;756;662;72;71;8.6959999999999997;9.6859999999999999;25;377;1016;7;21;65;50;118.90000000000001;59.600000000000001;59.299999999999997;39.590000000000003;274;155;861;139;93;258;129;893;133;102;12;174;2450
6;111008;Linda-a-Velha;9194;10805;8721;10392;4705;5215;4202;4708;503;507;10.691000000000001;9.7219999999999995;13;1008;7889;94;85;409;422;8741.2000000000007;4018.5;4722.6999999999998;44.369999999999997;1288;955;5072;1161;718;1289;880;6132;1333;1171;12;176;2472
6;111111;Sintra (São Martinho);2972;3254;2889;3189;1550;1418;1374;1269;176;149;11.355;10.507999999999999;28;529;2086;23;25;153;124;255.69999999999999;122.09999999999999;133.59999999999999;43.189999999999998;456;365;1621;287;243;433;345;1692;365;419;12;177;2494
6;111507;Reboleira;6558;7786;6177;7482;3483;3832;2849;3254;634;578;18.202999999999999;15.084;6;804;5293;90;115;544;463;18902.200000000001;8642;10260.200000000001;43.600000000000001;883;728;3767;729;451;795;787;4488;962;754;12;166;2329
6;150202;Samouco;1535;1608;1444;1569;815;806;702;709;113;97;13.865;12.035;14;294;1103;19;18;94;79;660.10000000000002;322.39999999999998;337.69999999999999;38.869999999999997;283;161;876;137;78;293;147;904;129;135;17;247;3256
6;150305;Trafaria;2774;2922;2630;2846;1235;1123;958;922;277;201;22.428999999999998;17.898;109;344;1427;32;41;245;160;993.39999999999998;483.80000000000001;509.60000000000002;42.700000000000003;484;362;1411;289;228;411;347;1423;351;390;17;248;3268
6;150306;Cacilhas;2684;3333;2534;3195;1226;1295;1059;1130;167;165;13.622;12.741;7;288;1894;33;36;134;129;5523.1999999999998;2463.6999999999998;3059.5;49.32;290;232;1352;410;400;286;289;1599;549;610;17;248;3259
6;150308;Sobreda;7287;7879;6922;7704;3778;3796;3333;3332;445;464;11.779;12.223000000000001;13;1040;5612;91;92;354;372;2459.8000000000002;1181.9000000000001;1277.9000000000001;41.039999999999999;1236;779;4132;686;454;1193;735;4517;700;734;17;248;3267
6;150803;Pinhal Novo;12035;12968;11354;12611;6509;6331;5681;5401;828;930;12.721;14.69;222;2656;8204;156;171;672;759;459.10000000000002;221;238.09999999999999;38.549999999999997;2303;1234;6903;895;700;2217;1341;7318;1094;998;17;253;3298
6;21114;Zambujeira do Mar;452;460;455;452;231;193;205;170;26;23;11.255000000000001;11.917;119;35;221;2;3;24;20;22.300000000000001;11;11.199999999999999;47.079999999999998;43;44;249;64;52;43;47;239;71;60;3;49;447
6;150910;São Francisco da Serra;411;398;397;381;186;131;167;120;19;11;10.215;8.3970000000000002;25;72;190;2;5;17;6;15.800000000000001;8;7.7999999999999998;51.009999999999998;32;31;208;61;79;39;31;172;76;80;17;254;3310
6;70701;Brotas;219;232;209;227;98;72;96;68;2;4;2.0409999999999999;5.556;27;32;105;0;0;2;4;5.4000000000000004;2.6000000000000001;2.7999999999999998;56.409999999999997;14;13;99;32;61;20;7;90;40;75;8;112;1707
6;70702;Cabeção;489;584;482;578;207;177;171;146;36;31;17.390999999999998;17.513999999999999;42;61;214;4;2;32;29;22.600000000000001;10.300000000000001;12.300000000000001;53.93;48;32;233;74;102;44;42;242;96;160;8;112;1708
6;120502;Santa Maria da Devesa;742;836;711;823;317;322;291;296;26;26;8.202;8.0749999999999993;21;108;458;3;8;23;18;28;13.199999999999999;14.800000000000001;46.630000000000003;96;79;392;87;88;85;88;409;121;133;14;196;2606
6;120603;Flor da Rosa;129;134;127;133;70;51;58;43;12;8;17.143000000000001;15.686;10;19;72;1;2;11;6;26.5;13;13.5;47.490000000000002;12;12;73;20;12;11;14;74;20;15;14;197;2611
6;121302;Montargil;1125;1191;1064;1151;508;406;443;325;65;81;12.795;19.951000000000001;136;165;467;8;12;57;69;7.7999999999999998;3.7999999999999998;4;50.659999999999997;108;110;563;148;196;109;89;548;203;242;14;204;2655
6;71201;Vendas Novas;5351;5772;5078;5559;2555;2344;2358;2128;197;216;7.71;9.2149999999999999;278;1223;2985;33;33;164;183;70.5;33.899999999999999;36.600000000000001;44.68;806;504;2788;683;570;781;489;2952;760;790;8;117;1730
6;121501;Cano;602;664;576;637;276;230;242;193;34;37;12.319000000000001;16.087;101;83;251;2;6;32;31;25.600000000000001;12.199999999999999;13.4;49.810000000000002;62;53;302;88;97;70;51;285;123;135;14;206;2669
6;20517;Trindade;134;140;125;134;66;47;63;44;3;3;4.5449999999999999;6.383;42;10;55;0;1;3;2;2.7999999999999998;1.3999999999999999;1.3999999999999999;47.149999999999999;11;13;74;24;12;22;13;64;18;23;3;43;398
6;20518;Trigaches;232;232;216;230;109;86;99;68;10;18;9.1739999999999995;20.93;17;45;105;1;4;9;14;27.899999999999999;14;14;46.590000000000003;33;19;122;32;26;31;17;112;36;36;3;43;397
6;20803;Figueira dos Cavaleiros;675;671;638;651;347;243;288;188;59;55;17.003;22.634;156;97;223;5;10;54;45;8.6999999999999993;4.4000000000000004;4.4000000000000004;47.359999999999999;78;52;363;93;89;77;62;335;100;97;3;46;411
6;21007;Moura (São João Baptista);1967;2108;1881;2043;993;805;822;649;171;156;17.221;19.379000000000001;159;324;988;32;23;139;133;43.700000000000003;21.100000000000001;22.600000000000001;43.240000000000002;339;230;1030;195;173;318;183;1010;273;324;3;48;425
6;21205;Santa Luzia;165;187;162;185;84;70;77;50;7;20;8.3330000000000002;28.571000000000002;19;46;62;1;8;6;12;10.1;4.7000000000000002;5.4000000000000004;49.689999999999998;18;10;96;20;21;22;10;83;27;45;3;50;452
6;110305;Manique do Intendente;592;624;563;594;240;208;213;180;27;28;11.25;13.462;22;76;295;3;4;24;24;34.100000000000001;16.600000000000001;17.5;50.509999999999998;70;36;314;91;81;47;42;301;113;121;12;168;2342
6;140304;Raposa;260;288;253;280;138;116;126;84;12;32;8.6959999999999997;27.585999999999999;22;73;115;2;8;10;24;8.4000000000000004;4;4.4000000000000004;47.630000000000003;24;26;146;33;31;23;29;157;36;43;16;227;3088
6;140901;Coruche;4165;4748;3893;4575;2021;1888;1809;1615;212;273;10.49;14.460000000000001;343;850;2231;25;49;187;224;36.700000000000003;17.199999999999999;19.600000000000001;46;572;413;2189;518;473;603;422;2349;655;719;16;233;3114
6;141606;Almoster;852;966;783;955;414;345;362;305;52;40;12.56;11.593999999999999;42;198;427;8;8;44;32;44.5;20.899999999999999;23.699999999999999;46.880000000000003;110;67;467;107;101;134;80;442;124;186;16;241;3184
6;80401;Azinhal;252;270;242;261;87;77;76;65;11;12;12.644;15.584;7;27;107;1;3;10;9;7.7000000000000002;3.7000000000000002;4;54.659999999999997;17;15;113;48;59;24;16;117;39;74;9;123;1763
6;80603;Lagoa;3513;3753;3463;3715;1864;1771;1532;1486;332;285;17.811;16.093;39;481;2498;42;38;290;247;264.5;127.90000000000001;136.59999999999999;40.259999999999998;655;356;1980;292;230;602;403;2026;333;389;9;125;1775
6;181302;Barrô;365;379;361;380;153;68;147;58;6;10;3.9220000000000002;14.706;82;36;87;2;3;4;7;74.099999999999994;36.399999999999999;37.799999999999997;47.710000000000001;37;55;184;55;34;31;33;192;61;62;20;295;4070
6;181306;Freigil;218;213;212;210;94;43;78;31;16;12;17.021000000000001;27.907;6;61;42;1;1;15;11;94;47.5;46.399999999999999;40.68;42;26;106;23;21;31;25;107;24;26;20;295;4074
6;10902;Arrifana;3184;3367;3065;3259;1705;1537;1575;1366;130;171;7.625;11.125999999999999;6;1491;1444;15;26;115;145;1237.3;601.39999999999998;635.89999999999998;42.43;476;332;1797;329;250;458;323;1892;386;308;1;15;149
6;10918;São Paio de Oleiros;1940;2129;1872;2094;1069;985;923;810;146;175;13.657999999999999;17.765999999999998;22;800;911;22;22;124;153;1041.9000000000001;496.80000000000001;545.20000000000005;41.740000000000002;296;238;1141;160;105;270;231;1216;218;194;1;15;174
6;10931;Vila Maior;737;774;707;749;388;306;332;246;56;60;14.433;19.608000000000001;10;269;299;9;8;47;52;302.10000000000002;147.30000000000001;154.69999999999999;39.390000000000001;137;79;421;67;33;119;90;439;66;60;1;15;178
6;11304;Loureiro;1716;1815;1654;1769;962;758;884;670;78;88;8.1080000000000005;11.609;77;800;677;19;15;59;73;205.09999999999999;99.700000000000003;105.40000000000001;42.18;262;209;929;167;149;249;204;964;208;190;1;12;118
6;11902;São Pedro de Castelões;3523;3731;3406;3678;1847;1594;1711;1427;136;167;7.3629999999999995;10.477;35;1681;1422;29;36;107;131;343.5;166.80000000000001;176.69999999999999;42.219999999999999;499;430;2010;343;241;474;424;2073;406;354;1;19;206
6;11909;Vila Cova de Perrinho;182;227;184;223;106;87;102;80;4;7;3.774;8.0459999999999994;2;119;61;2;1;2;6;92.099999999999994;41;51.100000000000001;45.799999999999997;13;22;108;20;19;28;28;107;34;30;1;19;208
6;40307;Lavandeira;80;82;78;81;33;24;24;19;9;5;27.273;20.832999999999998;9;18;16;1;0;8;5;11.6;5.7000000000000002;5.9000000000000004;53.140000000000001;5;5;43;14;13;9;2;42;13;16;5;68;1055
6;40912;Maçores;76;93;70;85;24;27;22;23;2;4;8.3330000000000002;14.815;15;7;23;0;0;2;4;10.699999999999999;4.7999999999999998;5.9000000000000004;59.840000000000003;2;5;30;19;20;2;12;31;22;26;5;74;1205
6;40917;Urros;124;141;116;129;33;29;32;25;1;4;3.0299999999999998;13.792999999999999;15;5;37;0;0;1;4;4.7000000000000002;2.2000000000000002;2.5;56.25;11;5;55;26;27;10;11;56;30;34;5;74;1210
6;91417;Vila Nova de Foz Côa;1505;1692;1443;1617;744;667;685;577;59;90;7.9299999999999997;13.493;137;227;898;18;27;41;63;51.600000000000001;24.300000000000001;27.300000000000001;43.259999999999998;220;179;828;137;141;238;167;872;188;227;10;148;2157
6;170103;Carlão;347;372;335;356;132;98;112;79;20;19;15.151999999999999;19.388000000000002;75;24;92;2;4;18;15;27.100000000000001;13.1;14;54.130000000000003;29;26;153;81;58;22;26;151;79;94;19;269;3623
6;170404;Mesão Frio (Santa Cristina);384;424;358;415;198;179;178;140;20;39;10.101000000000001;21.788;57;74;187;6;20;14;19;156.90000000000001;74.599999999999994;82.299999999999997;40.539999999999999;58;54;213;37;22;56;63;228;43;34;19;272;3709
6;170406;Vila Jusã;319;316;303;307;180;141;152;99;28;42;15.556000000000001;29.786999999999999;26;67;158;8;14;20;28;348.60000000000002;175.09999999999999;173.5;37.509999999999998;58;41;194;21;5;43;42;182;27;22;19;272;3712
6;170811;Vinhós;240;259;223;245;119;61;116;48;3;13;2.5209999999999999;21.311;96;35;33;0;5;3;8;54.100000000000001;26;28.100000000000001;46.549999999999997;31;31;130;22;26;22;28;134;36;39;19;276;3777
6;171105;Louredo;205;223;186;213;100;63;86;38;14;25;14;39.683;27;39;58;3;6;11;19;58.899999999999999;28.199999999999999;30.699999999999999;48.240000000000002;18;28;107;29;23;21;18;114;32;38;19;279;3806
6;171108;Lobrigos (São João Baptista);582;688;537;653;294;225;265;186;29;39;9.8640000000000008;17.332999999999998;108;93;250;6;12;23;27;194.30000000000001;89;105.3;45.479999999999997;82;64;325;55;56;72;72;347;79;118;19;279;3804
6;171424;Vila Real (São Pedro);2188;2578;2774;3388;1134;1255;984;1103;150;152;13.228;12.112;27;257;1803;25;33;125;119;2154;988.89999999999998;1165.0999999999999;42.43;331;208;1296;189;164;318;231;1456;274;299;19;282;3887
6;171425;São Tomé do Castelo;442;508;430;516;204;157;178;125;26;32;12.744999999999999;20.382000000000001;14;102;187;4;6;22;26;28.899999999999999;13.4;15.4;46.829999999999998;57;42;235;47;61;62;45;242;68;91;19;282;3880
6;180114;São Cosmado;272;326;269;323;130;111;121;106;9;5;6.923;4.5049999999999999;63;27;137;4;1;5;4;42.899999999999999;19.5;23.399999999999999;49.770000000000003;27;40;131;43;31;30;28;158;45;65;20;283;3902
6;180502;Avões;309;310;285;301;173;146;143;108;30;38;17.341000000000001;26.027000000000001;11;104;136;10;13;20;25;127.09999999999999;63.399999999999999;63.600000000000001;41.579999999999998;44;43;175;22;25;35;37;177;36;25;20;287;3954
6;180701;Aldeia de Nacomba;52;55;51;54;22;13;19;12;3;1;13.635999999999999;7.6920000000000002;6;6;19;1;0;2;1;24.800000000000001;12.1;12.800000000000001;46.990000000000002;8;7;23;5;9;7;7;23;4;14;20;289;3996
6;180706;Cabaços;129;151;123;143;61;43;57;39;4;4;6.5570000000000004;9.3019999999999996;23;30;43;0;2;4;2;25;11.5;13.5;48.210000000000001;14;16;68;17;14;13;19;70;23;26;20;289;4001
6;180720;Vilar;182;200;169;192;68;40;63;34;5;6;7.3529999999999998;15;18;17;62;0;1;5;5;44.700000000000003;21.300000000000001;23.399999999999999;46.520000000000003;29;23;89;27;14;19;23;97;36;25;20;289;4015
6;181503;Espinhosa;74;82;67;75;25;14;25;11;0;3;0;21.428999999999998;20;4;12;0;3;0;0;21;10;11;52.539999999999999;9;8;31;11;15;3;12;26;23;18;20;297;4095
6;181811;Lamosa;86;93;81;89;35;22;27;19;8;3;22.856999999999999;13.635999999999999;6;11;29;2;0;6;3;13.5;6.5;7;55.390000000000001;4;4;44;16;18;5;8;41;12;27;20;300;4148
6;181910;Pereiro;68;70;63;70;35;12;33;7;2;5;5.7140000000000004;41.667000000000002;17;9;14;1;2;1;3;27.399999999999999;13.5;13.9;43.619999999999997;10;9;30;7;12;15;5;30;7;13;20;301;4164
6;181916;Vale de Figueira;75;71;63;64;37;28;32;27;5;1;13.513999999999999;3.5709999999999997;13;15;31;1;0;4;1;31.300000000000001;16.100000000000001;15.199999999999999;41.880000000000003;10;12;37;8;8;9;8;38;13;3;20;301;4170
6;40120;Vilares de Vilariça;110;106;102;104;47;15;44;10;3;5;6.383;33.332999999999998;18;14;22;1;2;2;3;14.5;7.4000000000000004;7.0999999999999996;54.640000000000001;5;9;55;18;23;10;7;38;25;26;5;66;999
6;40218;Gostei;213;212;206;207;103;86;93;75;10;11;9.7089999999999996;12.791;18;34;116;0;1;10;10;21.800000000000001;10.9;10.9;48.810000000000002;22;15;115;40;21;25;14;106;35;32;5;67;1019
6;40238;Rio de Onor;35;41;35;39;4;0;4;0;0;0;0;0;1;2;1;0;0;0;0;1.7;0.80000000000000004;0.90000000000000002;69.260000000000005;1;;7;10;17;;1;10;14;16;5;67;1038
6;40244;São Pedro de Sarracenos;164;202;158;197;85;71;77;63;8;8;9.4120000000000008;11.268000000000001;8;27;105;1;2;7;6;23;10.300000000000001;12.699999999999999;45.140000000000001;23;12;97;14;18;25;25;100;23;29;5;67;1044
6;40503;Arcas;131;131;122;117;53;19;49;17;4;2;7.5469999999999997;10.526;20;23;23;0;2;4;0;11.4;5.7000000000000002;5.7000000000000002;54.100000000000001;11;12;68;20;20;2;14;60;30;25;5;70;1076
6;40504;Bagueixe;82;74;81;74;28;15;24;13;4;2;14.286;13.333;8;9;20;1;0;3;2;16;8.4000000000000004;7.5999999999999996;55.759999999999998;6;3;43;12;18;5;5;28;18;18;5;70;1077
6;40505;Bornes;174;216;173;205;66;47;59;43;7;4;10.606;8.5109999999999992;25;20;57;1;2;6;2;20.699999999999999;9.1999999999999993;11.5;51.460000000000001;10;19;87;32;26;16;26;99;31;44;5;70;1078
6;40511;Corujas;86;82;84;77;34;16;32;13;2;3;5.8819999999999997;18.75;17;9;19;0;3;2;0;17;8.6999999999999993;8.3000000000000007;50.200000000000003;13;8;37;12;16;9;2;38;17;16;5;70;1084
6;40513;Espadanedo;100;88;100;86;26;13;18;9;8;4;30.768999999999998;30.768999999999998;6;11;10;0;2;8;2;10.1;5.4000000000000004;4.7000000000000002;44.5;18;14;38;16;14;13;10;39;11;15;5;70;1086
6;40517;Lamalonga;199;203;200;201;71;33;66;27;5;6;7.0419999999999998;18.181999999999999;32;16;45;0;4;5;2;23.699999999999999;11.699999999999999;12;49.840000000000003;24;20;101;30;24;21;17;81;46;38;5;70;1090
6;171304;Bragado;251;293;245;275;114;60;84;39;30;21;26.315999999999999;35;17;50;56;2;6;28;15;20.800000000000001;9.5999999999999996;11.199999999999999;51.020000000000003;18;21;138;41;33;32;24;140;46;51;19;281;3844
6;171315;Vreia de Bornes;321;331;315;324;143;65;117;46;26;19;18.181999999999999;29.231000000000002;19;85;59;6;4;20;15;36.799999999999997;18.100000000000001;18.699999999999999;46.880000000000003;29;42;180;38;32;40;35;159;54;43;19;281;3857
6;10109;Fermentelos;1599;1659;1542;1606;828;706;746;625;82;81;9.9030000000000005;11.473000000000001;6;633;732;12;16;70;65;379.60000000000002;186.30000000000001;193.30000000000001;42.390000000000001;267;163;872;150;147;240;145;890;179;205;1;1;10
6;10110;Lamas do Vouga;352;377;327;364;180;184;156;158;24;26;13.333;14.130000000000001;3;157;154;1;3;23;23;169.59999999999999;81.900000000000006;87.700000000000003;42.340000000000003;52;50;197;22;31;53;33;212;35;44;1;1;11
6;10113;Óis da Ribeira;347;369;335;356;168;135;160;129;8;6;4.7620000000000005;4.444;12;164;113;1;0;7;6;212;102.8;109.3;44.649999999999999;45;36;191;42;33;48;37;185;59;40;1;1;14
6;10114;Préstimo;350;374;341;369;183;159;173;146;10;13;5.4640000000000004;8.1760000000000002;23;145;151;0;5;10;8;21.300000000000001;10.300000000000001;11;46.909999999999997;35;47;195;33;40;37;26;201;53;57;1;1;15
6;10120;Borralha;1067;1163;1025;1125;601;564;563;495;38;69;6.3230000000000004;12.234;2;522;534;7;9;31;60;256.19999999999999;122.59999999999999;133.59999999999999;41.799999999999997;157;136;601;102;71;148;133;674;109;99;1;1;7
6;10201;Albergaria-a-Velha;4093;4435;3793;4253;2213;2166;2031;1896;182;270;8.2240000000000002;12.465;22;1526;2379;28;46;154;224;290.89999999999998;139.59999999999999;151.30000000000001;38.5;764;464;2337;308;220;715;461;2539;363;357;1;2;21
6;10204;Branca;2753;2868;2658;2798;1512;1209;1411;1037;101;172;6.6799999999999997;14.227;42;1149;1257;4;35;97;137;185.59999999999999;90.900000000000006;94.700000000000003;40.990000000000002;474;283;1586;253;157;422;282;1610;297;257;1;2;24
6;10206;Ribeira de Fráguas;832;881;779;854;441;297;409;266;32;31;7.2560000000000002;10.438000000000001;28;350;297;5;10;27;21;64.099999999999994;31.100000000000001;32.899999999999999;45.409999999999997;91;99;460;102;80;95;96;452;109;129;1;2;26
6;10510;São Bernardo;2352;2608;2206;2509;1308;1333;1195;1206;113;127;8.6389999999999993;9.5269999999999992;26;631;1744;14;26;99;101;1260.3;597.60000000000002;662.70000000000005;39.799999999999997;411;244;1377;188;132;388;243;1547;208;222;1;5;75
6;10512;Vera Cruz;4370;5287;4158;5113;2467;2736;2240;2453;227;283;9.2010000000000005;10.343999999999999;25;829;3839;43;58;184;225;251;113.59999999999999;137.40000000000001;41.409999999999997;647;449;2567;350;357;678;482;3097;451;579;1;5;77
6;10801;Avanca;2984;3205;2867;3101;1599;1371;1487;1218;112;153;7.0039999999999996;11.16;70;1215;1420;17;19;95;134;293.80000000000001;141.59999999999999;152.09999999999999;42.18;429;365;1695;278;217;429;340;1754;349;333;1;8;92
6;11101;Antes;435;498;411;480;217;195;195;178;22;17;10.138;8.718;16;139;218;5;5;17;12;215.69999999999999;100.59999999999999;115.2;45.630000000000003;57;58;225;44;51;60;44;264;46;84;1;10;103
6;11102;Barcouço;1052;1100;999;1069;544;489;494;447;50;42;9.1910000000000007;8.5890000000000004;31;221;689;6;8;44;34;101;49.399999999999999;51.600000000000001;43.100000000000001;155;120;582;109;86;149;111;583;121;136;1;10;104
6;11403;Oiã;3680;4042;3518;3976;1922;1858;1759;1651;163;207;8.4809999999999999;11.141;70;1458;1882;39;44;124;163;293.39999999999998;139.80000000000001;153.59999999999999;40.109999999999999;689;387;1998;338;268;658;381;2224;361;418;1;13;136
6;11406;Troviscal;1126;1245;1078;1195;550;471;506;416;44;55;8;11.677;68;341;513;6;16;38;39;206;97.799999999999997;108.2;46.140000000000001;168;114;567;145;132;152;100;610;172;211;1;13;139
6;11702;Couto de Esteves;430;460;399;426;193;139;170;120;23;19;11.917;13.669;35;122;133;3;4;20;15;54.200000000000003;26.199999999999999;28;50.049999999999997;44;41;220;65;60;41;46;212;76;85;1;17;181
6;11703;Paradela;352;368;329;350;184;157;170;129;14;28;7.609;17.834;13;147;139;2;8;12;20;79.900000000000006;39.100000000000001;40.799999999999997;42.490000000000002;54;36;200;40;22;54;39;188;41;46;1;17;183
6;60202;Bolho;397;451;378;437;188;159;171;142;17;17;9.0429999999999993;10.692;30;129;154;2;5;15;12;128.09999999999999;60;68.099999999999994;47.939999999999998;41;43;208;55;50;45;39;220;84;63;7;90;1458
6;60207;Febres;1563;1789;1492;1744;763;655;707;595;56;60;7.3390000000000004;9.1600000000000001;51;419;832;7;13;49;47;146.09999999999999;68.099999999999994;78;45.350000000000001;215;180;839;183;146;232;148;883;259;267;7;90;1465
6;60212;Portunhos;558;629;538;611;263;234;246;217;17;17;6.4640000000000004;7.2649999999999997;18;121;324;1;8;16;9;77.200000000000003;36.299999999999997;40.899999999999999;47.890000000000001;71;54;290;57;86;81;41;294;74;139;7;90;1470
6;60216;Corticeiro de Cima;329;392;311;373;172;150;159;139;13;11;7.5579999999999998;7.3330000000000002;19;103;176;2;0;11;11;133.90000000000001;61.100000000000001;72.799999999999997;46.140000000000001;45;28;189;34;33;36;47;182;54;73;7;90;1463
6;60304;Antanhol;1259;1297;1183;1245;673;628;608;553;65;75;9.6579999999999995;11.943;1;245;915;13;13;52;62;261.19999999999999;128.69999999999999;132.5;42.359999999999999;190;138;722;127;82;172;123;765;109;128;7;91;1478
6;60311;Ceira;1792;1909;1702;1841;897;849;767;793;130;56;14.493;6.5960000000000001;48;261;1251;33;12;97;44;297.89999999999998;144.19999999999999;153.59999999999999;46.590000000000003;190;176;1016;243;167;171;185;1054;255;244;7;91;1485
6;60325;Coimbra (Sé Nova);3133;3608;4317;5553;1529;1636;1327;1479;202;157;13.211;9.5969999999999995;12;255;2539;50;43;152;114;4217.5;1960.2;2257.4000000000001;45.909999999999997;310;311;1976;270;266;298;361;1886;456;607;7;91;1490
6;60401;Anobra;645;671;612;646;323;304;299;280;24;24;7.4299999999999997;7.8949999999999996;5;160;414;5;6;19;18;80.299999999999997;39.399999999999999;41;42.990000000000002;102;66;352;63;62;81;61;377;77;75;7;92;1507
6;60407;Furadouro;96;110;92;108;42;33;35;30;7;3;16.667000000000002;9.0909999999999993;3;18;44;1;2;6;1;14.300000000000001;6.7000000000000002;7.5999999999999996;49.859999999999999;12;9;50;15;10;7;11;52;15;25;7;92;1513
6;60409;Vila Seca;396;480;375;475;190;184;177;167;13;17;6.8419999999999996;9.2390000000000008;2;81;261;1;3;12;14;70.099999999999994;31.699999999999999;38.399999999999999;47.340000000000003;40;41;210;56;49;63;39;228;68;82;7;92;1515
6;60503;Brenha;425;487;405;482;230;209;199;169;31;40;13.478;19.138999999999999;2;117;249;4;3;27;37;153.30000000000001;71.5;81.900000000000006;43.530000000000001;54;47;248;50;26;62;49;269;56;51;7;93;1521
6;61003;Carapinheira;1370;1528;1267;1490;671;607;617;541;54;66;8.048;10.872999999999999;44;286;828;9;20;45;46;182.30000000000001;86.200000000000003;96.099999999999994;45.57;171;137;774;150;138;160;148;822;187;211;7;98;1557
6;61007;Montemor-o-Velho;1501;1653;1420;1628;764;741;699;647;65;94;8.5079999999999991;12.686;30;287;1029;17;20;48;74;124.09999999999999;59.100000000000001;65.099999999999994;42.100000000000001;230;194;812;145;120;207;200;870;160;216;7;98;1562
6;61012;Verride;275;312;246;299;124;104;108;90;16;14;12.903;13.462;9;53;136;3;2;13;12;106.40000000000001;49.899999999999999;56.600000000000001;50.299999999999997;28;21;143;42;41;33;26;139;50;64;7;98;1567
6;61305;Oliveira do Mondego;304;354;240;327;155;100;138;82;17;18;10.968;18;8;75;137;1;3;16;15;59.600000000000001;27.5;32.100000000000001;46.200000000000003;39;24;172;42;27;43;33;167;61;50;7;101;1604
6;61308;São Paio de Mondego;92;119;89;113;41;39;39;37;2;2;4.8780000000000001;5.1280000000000001;7;15;54;1;1;1;1;21.600000000000001;9.4000000000000004;12.199999999999999;51.619999999999997;4;10;50;10;18;6;18;62;7;26;7;101;1607
6;61511;Vila Nova de Anços;525;588;501;562;230;187;209;161;21;26;9.1300000000000008;13.904;7;67;296;7;1;14;25;54.100000000000001;25.5;28.600000000000001;48.740000000000002;68;57;260;71;69;54;44;278;93;119;7;103;1627
6;100903;Azoia;1094;1182;1051;1141;603;542;550;484;53;58;8.7889999999999997;10.701000000000001;30;400;604;10;13;43;45;199.5;95.900000000000006;103.59999999999999;42.159999999999997;149;151;607;102;85;154;161;641;108;118;11;157;2225
6;100930;Carreira;563;603;521;577;272;222;246;203;26;19;9.5589999999999993;8.5589999999999993;15;202;232;6;5;20;14;210.59999999999999;101.7;108.90000000000001;44.399999999999999;74;70;310;53;56;88;58;308;77;72;11;157;2232
6;101509;Pombal;8195;8992;7697;8703;4155;3948;3802;3491;353;457;8.4960000000000004;11.574999999999999;98;2402;4793;68;134;285;323;177.69999999999999;84.799999999999997;93;40.82;1433;948;4437;775;602;1332;971;4906;868;915;11;163;2287
6;60102;Arganil;1883;2119;1779;2059;904;924;832;827;72;97;7.9649999999999999;10.497999999999999;29;576;1054;18;23;54;74;117.3;55.200000000000003;62.100000000000001;43.32;287;222;1007;203;164;285;219;1082;222;311;7;89;1440
6;60103;Barril de Alva;149;132;152;132;59;39;52;35;7;4;11.864000000000001;10.256;8;36;43;3;1;4;3;84;44.600000000000001;39.5;50.079999999999998;12;15;77;26;19;14;8;66;19;25;7;89;1441
6;60106;Cepos;62;73;62;71;15;13;12;11;3;2;20;15.385;0;8;15;0;0;3;2;9.5999999999999996;4.4000000000000004;5.2000000000000002;60.509999999999998;;6;25;19;12;3;4;24;22;20;7;89;1444
6;60107;Cerdeira;156;168;145;170;64;45;52;40;12;5;18.75;11.111000000000001;3;41;48;4;2;8;3;58.899999999999999;28.399999999999999;30.5;52.149999999999999;15;15;78;22;26;16;6;75;31;40;7;89;1445
6;60112;Pomares;248;265;255;269;83;53;70;47;13;6;15.663;11.321;5;79;33;4;2;9;4;16.300000000000001;7.9000000000000004;8.4000000000000004;53.549999999999997;30;11;111;46;50;23;16;106;58;62;7;89;1450
6;60701;Casal de Ermio;187;189;187;186;81;63;73;54;8;9;9.8770000000000007;14.286;8;26;93;1;2;7;7;89.799999999999997;44.700000000000003;45.100000000000001;43.710000000000001;29;24;102;20;12;24;22;93;17;33;7;95;1540
6;60704;Serpins;864;938;814;915;435;405;403;370;32;35;7.3559999999999999;8.6419999999999995;30;289;454;6;11;26;24;49.899999999999999;23.899999999999999;26;42.119999999999997;134;75;506;94;55;147;79;522;90;100;7;95;1544
6;61120;Vila Pouca da Beira;165;190;155;180;74;65;69;51;5;14;6.7569999999999997;21.538;5;56;59;0;5;5;9;82.799999999999997;38.5;44.299999999999997;47.329999999999998;16;16;87;23;23;20;22;93;20;35;7;99;1589
6;61402;Espinhal;357;418;337;410;152;132;136;112;16;20;10.526;15.151999999999999;3;73;172;2;2;14;18;26.399999999999999;12.199999999999999;14.199999999999999;47.68;48;26;185;51;47;59;27;191;56;85;7;102;1612
6;61602;Candosa;330;359;319;349;149;115;126;108;23;7;15.436;6.0869999999999997;10;93;131;6;0;17;7;60.5;29;31.5;46.530000000000001;42;33;177;45;33;48;31;170;50;60;7;104;1630
6;61604;Covas;529;556;499;544;238;170;215;150;23;20;9.6639999999999997;11.765000000000001;16;182;167;4;3;19;17;62.5;30.5;32;45.380000000000003;58;73;281;67;50;72;56;272;82;74;7;104;1632
6;61608;Midões;832;893;791;869;394;331;339;276;55;55;13.959;16.616;36;261;318;5;15;50;40;86;41.5;44.5;46.630000000000003;99;97;434;107;95;91;89;442;124;147;7;104;1636
6;100201;Almoster;309;365;295;351;117;77;105;69;12;8;10.256;10.390000000000001;9;60;105;3;1;9;7;26.100000000000001;12;14.1;52.649999999999999;32;33;140;54;50;24;31;149;78;83;11;150;2176
6;100206;Pussos;520;619;495;598;251;225;222;203;29;22;11.554;9.7780000000000005;25;120;280;7;6;22;16;47.600000000000001;21.800000000000001;25.899999999999999;47.479999999999997;65;56;274;61;64;73;59;294;70;123;11;150;2181
6;100303;Avelar;1028;1141;980;1104;510;495;457;412;53;83;10.391999999999999;16.768000000000001;6;310;553;11;11;42;72;255.30000000000001;121;134.30000000000001;43.420000000000002;166;116;530;128;88;161;104;574;148;154;11;151;2185
6;100304;Chão de Couce;921;1071;883;1092;429;372;393;315;36;57;8.3919999999999995;15.323;13;300;395;7;12;29;45;83.700000000000003;38.700000000000003;45;47.479999999999997;122;85;476;123;115;111;113;487;164;196;11;151;2186
6;100306;Pousaflores;439;511;418;498;194;148;173;125;21;23;10.824999999999999;15.541;8;124;166;4;5;17;18;37.600000000000001;17.399999999999999;20.199999999999999;51.25;41;50;214;67;67;45;32;240;93;101;11;151;2188
6;90101;Aguiar da Beira;702;771;675;752;314;317;291;278;23;39;7.3250000000000002;12.303000000000001;32;102;435;4;6;19;33;41.200000000000003;19.699999999999999;21.600000000000001;43.789999999999999;117;79;356;71;79;101;74;412;69;115;10;135;1822
6;90106;Eirado;106;124;100;117;41;25;40;17;1;8;2.4390000000000001;32;11;20;26;1;3;0;5;24.899999999999999;11.5;13.4;46.799999999999997;9;16;51;16;14;13;15;64;17;15;10;135;1827
6;180206;Parada;387;419;367;400;151;101;132;90;19;11;12.583;10.891;11;105;106;5;3;14;8;69.099999999999994;33.200000000000003;35.899999999999999;47.630000000000003;47;48;189;58;45;51;39;200;53;76;20;284;3913
6;180305;Cujó;136;163;131;157;50;28;49;25;1;3;2;10.714;4;29;41;1;2;0;1;35.299999999999997;16.100000000000001;19.300000000000001;51.82;7;16;72;18;23;16;17;68;28;34;20;285;3919
6;180314;Monteiras;239;242;222;228;117;52;105;40;12;12;10.256;23.077000000000002;13;57;75;1;2;11;10;22.800000000000001;11.300000000000001;11.5;45.170000000000002;30;30;125;24;30;27;33;110;37;35;20;285;3928
6;180601;Abrunhosa-a-Velha;266;297;260;290;132;74;118;62;14;12;10.606;16.216000000000001;19;81;80;0;3;14;9;32.5;15.4;17.199999999999999;48.439999999999998;34;32;135;31;34;23;18;156;45;55;20;288;3978
6;180610;Mangualde;4534;4855;4165;4665;2362;2109;2099;1746;263;363;11.135;17.212;47;1226;2572;47;63;216;300;266.30000000000001;128.59999999999999;137.69999999999999;42.240000000000002;713;534;2516;432;339;662;500;2622;510;561;20;288;3987
6;180616;São João da Fresta;99;109;106;121;42;24;36;21;6;3;14.286;12.5;8;20;29;1;0;5;3;28.100000000000001;13.4;14.699999999999999;52.520000000000003;7;8;46;21;17;13;6;41;24;25;20;288;3993
6;180805;Marmeleira;233;270;222;262;86;61;79;60;7;1;8.1400000000000006;1.639;9;58;72;0;0;7;1;27.199999999999999;12.6;14.6;51.530000000000001;23;22;112;44;32;23;19;126;46;56;20;290;4020
6;180806;Mortágua;1333;1460;1233;1389;650;577;599;516;51;61;7.8460000000000001;10.571999999999999;77;300;738;7;17;44;44;107.7;51.399999999999999;56.299999999999997;45.119999999999997;172;160;689;172;140;164;142;764;176;214;20;290;4021
6;180808;Sobral;1117;1194;1072;1165;558;429;509;385;49;44;8.7810000000000006;10.256;60;374;460;9;10;40;34;36;17.399999999999999;18.600000000000001;46.549999999999997;131;109;597;158;122;123;101;620;182;168;20;290;4023
6;180809;Trezói;188;189;174;182;86;51;82;39;4;12;4.6509999999999998;23.529;9;50;62;0;3;4;9;21.5;10.699999999999999;10.800000000000001;50.659999999999997;20;28;91;22;27;6;12;100;38;33;20;290;4024
6;180909;Moreira;274;321;259;313;120;74;106;59;14;15;11.667;20.27;14;76;75;2;4;12;11;153.09999999999999;70.5;82.599999999999994;51.090000000000003;22;25;137;46;44;29;25;144;61;62;20;291;4030
6;181002;Arcozelo das Maias;659;705;621;695;328;267;313;241;15;26;4.5730000000000004;9.7379999999999995;63;288;203;1;9;14;17;62.600000000000001;30.199999999999999;32.299999999999997;44.979999999999997;85;78;344;76;76;94;67;347;93;104;20;292;4036
6;181005;Pinheiro;609;668;576;646;318;281;291;259;27;22;8.4909999999999997;7.8289999999999997;42;270;238;7;5;20;17;59.100000000000001;28.199999999999999;30.899999999999999;42.619999999999997;91;79;320;58;61;86;95;328;71;88;20;292;4039
6;181007;Ribeiradio;470;541;450;526;233;189;219;171;14;18;6.0090000000000003;9.5240000000000009;32;179;179;1;9;13;9;64.5;30;34.5;44.399999999999999;67;57;249;48;49;61;69;267;65;79;20;292;4041
6;181008;São João da Serra;236;288;215;272;118;64;106;59;12;5;10.169;7.8129999999999997;31;61;73;0;3;12;2;42.200000000000003;19;23.199999999999999;48.719999999999999;24;19;134;28;31;31;29;133;42;53;20;292;4042
6;181010;Sejães;103;97;96;86;59;46;57;45;2;1;3.3900000000000001;2.1739999999999999;8;40;54;1;0;1;1;34.600000000000001;17.800000000000001;16.800000000000001;42.590000000000003;19;11;57;3;13;8;13;50;13;13;20;292;4044
6;181108;Matela;93;96;85;92;36;19;33;18;3;1;8.3330000000000002;5.2629999999999999;10;12;29;1;0;2;1;23.899999999999999;11.699999999999999;12.1;52.899999999999999;10;10;39;15;19;8;7;35;18;28;20;293;4054
6;181109;Pindo;949;967;889;925;446;294;416;241;30;53;6.726;18.027000000000001;59;318;280;6;16;24;37;114.3;56.600000000000001;57.700000000000003;43.640000000000001;152;126;483;106;82;122;100;498;126;121;20;293;4055
6;181111;Sezures;345;381;334;372;128;70;115;51;13;19;10.156000000000001;27.143000000000001;33;62;71;5;14;8;5;34.5;16.399999999999999;18.100000000000001;46.579999999999998;47;42;161;57;38;47;41;177;50;66;20;293;4057
6;181406;São João de Areias;915;1024;857;999;377;302;334;252;43;50;11.406000000000001;16.556000000000001;18;254;314;8;13;35;37;90.099999999999994;42.5;47.600000000000001;47.439999999999998;116;103;452;140;104;118;93;504;131;178;20;296;4090
6;181615;Serrazes;463;538;446;538;209;169;194;155;15;14;7.1769999999999996;8.2840000000000007;21;136;192;1;4;14;10;75.700000000000003;35;40.700000000000003;46.82;48;49;242;65;59;75;49;244;86;84;20;298;4121
6;181705;Forles;35;30;32;30;11;4;9;3;2;1;18.181999999999999;25;0;3;9;2;0;0;1;8.9000000000000004;4.7999999999999998;4.0999999999999996;54.579999999999998;3;5;15;9;3;;1;14;10;5;20;299;4130
6;182102;Campo de Besteiros;723;751;680;718;334;328;291;290;43;38;12.874000000000001;11.585000000000001;28;251;302;3;9;40;29;186;91.200000000000003;94.799999999999997;43.060000000000002;112;102;358;83;68;102;76;395;95;83;20;303;4183
6;182113;Mosteiro de Fráguas;273;317;259;304;132;107;119;100;13;7;9.8480000000000008;6.5419999999999998;24;81;114;1;2;12;5;57.399999999999999;26.5;30.800000000000001;48.450000000000003;34;28;142;34;35;24;33;152;55;53;20;303;4194
6;182115;Nandufe;294;328;277;308;141;114;121;103;20;11;14.183999999999999;9.6490000000000009;8;91;125;4;4;16;7;141.40000000000001;66.799999999999997;74.599999999999994;47.130000000000003;35;27;164;43;25;30;35;164;55;44;20;303;4196
6;182117;Sabugosa;265;280;251;275;120;75;106;63;14;12;11.667;16;13;56;100;1;2;13;10;76.200000000000003;37;39.100000000000001;49.280000000000001;27;30;127;47;34;25;27;122;61;45;20;303;4198
6;182120;São Miguel do Outeiro;435;478;411;456;198;169;177;143;21;26;10.606;15.385;17;95;208;3;4;18;22;80.200000000000003;38.200000000000003;42;46.460000000000001;61;48;225;58;43;44;44;249;71;70;20;303;4201
6;182123;Tondela;2087;2421;2008;2352;1109;1110;999;1008;110;102;9.9190000000000005;9.1890000000000001;36;554;1417;28;23;82;79;397;183.80000000000001;213.19999999999999;41.840000000000003;341;253;1119;199;175;336;237;1280;252;316;20;303;4204
6;182316;Lordosa;804;987;788;983;324;277;272;234;52;43;16.048999999999999;15.523;10;131;365;3;7;49;36;80.299999999999997;36;44.200000000000003;48.729999999999997;80;90;413;121;100;109;78;469;164;167;20;305;4229
6;182323;Rio de Loba;4526;4822;4229;4607;2467;2278;2206;2029;261;249;10.58;10.931000000000001;32;860;3343;50;47;211;202;526.60000000000002;255;271.69999999999999;38.890000000000001;801;563;2597;353;212;795;566;2761;400;300;20;305;4236
6;182325;Santos Evos;711;858;685;839;365;312;317;256;48;56;13.151;17.949000000000002;19;191;363;6;10;42;46;132.30000000000001;60;72.400000000000006;44.490000000000002;92;64;412;77;66;119;85;449;109;96;20;305;4237
6;182407;Fornelo do Monte;137;151;137;151;46;31;43;26;3;5;6.5220000000000002;16.129000000000001;5;31;33;0;0;3;5;19.100000000000001;9.0999999999999996;10;50.340000000000003;26;8;54;16;33;18;10;57;29;37;20;306;4255
6;50803;Peral;337;337;303;321;143;95;124;74;19;21;13.287000000000001;22.105;16;83;99;1;4;18;17;24.600000000000001;12.300000000000001;12.300000000000001;49.520000000000003;28;37;181;44;47;25;38;162;45;67;6;85;1414
6;90509;Maceira;112;117;109;107;43;32;37;27;6;5;13.952999999999999;15.625;3;22;39;0;3;6;2;28.399999999999999;13.9;14.5;53.100000000000001;11;9;51;20;21;9;7;56;19;26;10;139;1911
6;90511;Muxagata;114;127;109;122;48;27;41;23;7;4;14.583;14.815;2;27;35;1;0;6;4;24.199999999999999;11.5;12.800000000000001;48.140000000000001;14;11;57;12;20;20;10;52;15;30;10;139;1913
6;90601;Aldeias;145;183;132;165;55;45;52;44;3;1;5.4550000000000001;2.222;6;21;69;0;0;3;1;16.100000000000001;7.0999999999999996;9;52.030000000000001;17;10;76;20;22;15;20;63;32;53;10;140;1919
6;91202;Cabeça;80;98;75;91;28;22;27;20;1;2;3.5709999999999997;9.0909999999999993;2;13;32;0;0;1;2;21;9.4000000000000004;11.5;55.350000000000001;6;5;43;12;14;6;4;49;14;25;10;146;2084
6;91210;Sabugueiro;247;231;232;226;120;104;96;95;24;9;20;8.6539999999999999;5;58;128;2;0;22;9;11.9;6.2000000000000002;5.7999999999999998;46.109999999999999;28;30;142;20;27;21;18;134;24;34;10;146;2093
6;91223;Tourais;678;762;642;730;303;241;276;205;27;36;8.9109999999999996;14.938000000000001;16;179;286;4;6;23;30;67.200000000000003;31.600000000000001;35.600000000000001;46.899999999999999;97;61;349;111;60;75;74;376;119;118;10;146;2106
6;90207;Castelo Bom;93;123;90;123;37;23;34;21;3;2;8.1080000000000005;8.6959999999999997;3;11;41;1;1;2;1;8.5999999999999996;3.7000000000000002;4.9000000000000004;59.100000000000001;5;8;40;13;27;9;9;31;23;51;10;136;1841
6;90211;Junça;65;59;62;56;23;18;21;14;2;4;8.6959999999999997;22.222000000000001;7;9;19;2;1;0;3;6.7000000000000002;3.5;3.2000000000000002;53.729999999999997;4;7;31;13;10;5;3;30;8;13;10;136;1845
6;90214;Malpartida;87;85;87;87;32;15;27;14;5;1;15.625;6.6669999999999998;10;7;24;0;0;5;1;7.4000000000000004;3.7000000000000002;3.7000000000000002;55.810000000000002;8;4;42;14;19;7;4;34;12;28;10;136;1848
6;90224;São Pedro de Rio Seco;80;101;78;99;23;14;23;10;0;4;0;28.571000000000002;5;10;18;0;4;0;0;8;3.5;4.5;55.659999999999997;6;5;39;12;18;11;10;28;18;34;10;136;1858
6;90312;Prados;86;94;85;89;29;21;22;20;7;1;24.138000000000002;4.7620000000000005;6;14;22;0;0;7;1;12.699999999999999;6;6.5999999999999996;56.920000000000002;7;6;38;13;22;6;8;30;19;31;10;137;1878
6;90313;Rapa;77;85;81;85;31;30;27;29;4;1;12.903;3.3330000000000002;2;19;35;2;1;2;0;21.199999999999999;10.1;11.1;52.18;9;7;36;9;16;4;7;37;14;23;10;137;1879
6;90318;Vale de Azares;191;209;182;203;83;67;76;58;7;9;8.4339999999999993;13.433;8;46;80;2;4;5;5;44.200000000000003;21.100000000000001;23.100000000000001;51.43;24;13;86;35;33;20;16;93;35;45;10;137;1882
6;90319;Velosa;53;61;53;61;23;18;20;14;3;4;13.042999999999999;22.222000000000001;2;9;23;0;0;3;4;10.5;4.9000000000000004;5.5999999999999996;45.299999999999997;4;9;24;11;5;10;8;29;5;9;10;137;1883
6;90320;Vide entre Vinhas;77;88;68;82;30;18;26;17;4;1;13.333;5.556;4;6;33;1;0;3;1;19.600000000000001;9.1999999999999993;10.5;55.530000000000001;7;7;31;17;15;6;4;33;17;28;10;137;1884
6;90322;Casas do Soeiro;256;243;243;234;124;105;117;101;7;4;5.6449999999999996;3.8100000000000001;5;42;171;2;0;5;4;83.200000000000003;42.700000000000003;40.5;42.920000000000002;33;38;134;35;16;38;22;137;29;17;10;137;1868
6;90402;Almofala;80;101;79;99;33;12;31;11;2;1;6.0609999999999999;8.3330000000000002;12;9;21;0;0;2;1;6;2.7000000000000002;3.3999999999999999;59.539999999999999;2;2;42;14;20;5;6;37;20;33;10;138;1887
6;90702;Albardo;71;72;64;69;34;20;28;14;6;6;17.646999999999998;30;2;21;19;1;1;5;5;35.299999999999997;17.5;17.800000000000001;52.310000000000002;4;10;38;9;10;5;5;30;14;18;10;141;1942
6;90708;Avelãs da Ribeira;96;100;94;103;41;31;34;24;7;7;17.073;22.581;9;10;39;0;1;7;6;17.300000000000001;8.5;8.9000000000000004;48.649999999999999;8;11;46;14;17;15;6;47;18;14;10;141;1947
6;90713;Cavadoude;172;152;168;146;67;55;55;42;12;13;17.91;23.635999999999999;3;36;58;1;4;11;9;48.700000000000003;25.899999999999999;22.899999999999999;42.240000000000002;24;43;75;20;10;13;14;80;23;22;10;141;1953
6;90718;Fernão Joanes;123;146;119;142;55;57;40;44;15;13;27.273;22.806999999999999;7;35;42;3;2;12;11;10.699999999999999;4.9000000000000004;5.7999999999999998;52.759999999999998;8;13;65;12;25;8;19;59;18;42;10;141;1958
6;90734;Ramela;105;113;102;109;47;31;42;24;5;7;10.638;22.581;4;23;39;1;0;4;7;21.5;10.300000000000001;11.1;53.310000000000002;10;8;52;18;17;4;8;47;25;29;10;141;1978
6;90742;Guarda (Sé);3345;3613;3331;3562;1698;1787;1546;1611;152;176;8.952;9.8490000000000002;27;424;2706;32;31;120;145;419.69999999999999;201.80000000000001;217.90000000000001;41.579999999999998;478;428;1981;255;203;465;413;2074;295;366;10;141;1963
6;90749;Videmonte;214;264;200;249;102;85;85;70;17;15;16.667000000000002;17.646999999999998;22;59;74;1;3;16;12;8.9000000000000004;4;4.9000000000000004;49.850000000000001;21;19;118;22;34;29;28;98;50;59;10;141;1990
6;90750;Vila Cortês do Mondego;141;157;137;154;74;63;64;56;10;7;13.513999999999999;11.111000000000001;5;34;81;2;0;8;7;68;32.200000000000003;35.799999999999997;44.939999999999998;19;24;70;13;15;18;11;78;18;32;10;141;1991
6;90802;Manteigas (Santa Maria);680;738;640;704;329;296;294;238;35;58;10.638;19.594999999999999;29;130;373;8;9;27;49;63.600000000000001;30.5;33.100000000000001;45.140000000000001;81;87;379;84;49;82;72;396;101;87;10;142;1996
6;90908;Marialva;121;134;110;128;53;36;50;34;3;2;5.6600000000000001;5.556;17;21;46;1;0;2;2;13.300000000000001;6.2999999999999998;7;59.969999999999999;3;8;53;26;31;4;8;49;32;41;10;143;2007
6;90911;Pai Penela;27;40;24;37;9;8;8;6;1;2;11.111000000000001;25;9;1;4;0;2;1;0;11;4.4000000000000004;6.5999999999999996;58.329999999999998;;2;10;7;8;2;5;15;7;11;10;143;2010
6;90916;Vale Flor;74;76;74;76;14;11;13;10;1;1;7.1429999999999998;9.0909999999999993;7;4;12;0;0;1;1;9;4.5;4.5999999999999996;58.009999999999998;12;5;24;17;16;1;2;27;18;28;10;143;2015
6;91001;Alverca da Beira;212;251;204;242;81;66;78;56;3;10;3.7039999999999997;15.151999999999999;15;49;70;0;1;3;9;57.299999999999997;26.199999999999999;31.100000000000001;52.600000000000001;18;18;98;41;37;24;21;99;49;58;10;144;2016
6;91003;Azevo;89;106;88;105;19;14;17;13;2;1;10.526;7.1429999999999998;4;8;18;1;0;1;1;7;3.2000000000000002;3.7999999999999998;64.989999999999995;4;2;29;19;35;3;4;27;27;45;10;144;2018
6;91005;Bouça Cova;53;51;45;49;16;8;16;7;0;1;0;12.5;2;8;13;0;0;0;1;8.9000000000000004;4.5999999999999996;4.4000000000000004;53.729999999999997;5;5;27;7;9;4;3;20;7;17;10;144;2020
6;91025;Valbom;103;111;96;108;38;23;34;18;4;5;10.526;21.739000000000001;4;13;35;1;0;3;5;14.1;6.7999999999999998;7.2999999999999998;57.170000000000002;3;8;50;24;18;3;8;50;23;27;10;144;2040
6;91105;Aldeia de Santo António;384;414;363;401;189;174;169;160;20;14;10.582000000000001;8.0459999999999994;19;78;232;2;0;18;14;30.300000000000001;14.6;15.699999999999999;43;56;42;218;40;28;63;42;218;51;40;10;145;2046
6;91109;Baraçal;88;102;78;91;42;26;41;25;1;1;2.3810000000000002;3.8460000000000001;7;18;41;0;0;1;1;11.9;5.5;6.4000000000000004;48.609999999999999;9;7;42;15;15;13;12;41;15;21;10;145;2051
6;91126;Rebolosa;110;112;101;114;41;28;35;24;6;4;14.634;14.286;8;26;25;0;0;6;4;24.699999999999999;12.300000000000001;12.5;54.609999999999999;7;16;49;18;20;6;5;41;27;33;10;145;2068
6;91127;Rendo;130;148;119;143;54;46;50;43;4;3;7.407;6.5220000000000002;8;49;36;3;2;1;1;12.9;6;6.9000000000000004;51.770000000000003;11;14;65;16;24;13;10;64;26;35;10;145;2069
6;91136;Vale de Espinho;173;220;172;218;42;38;38;35;4;3;9.5240000000000009;7.8949999999999996;14;17;42;0;0;4;3;12.4;5.5;7;63.310000000000002;6;8;69;32;58;12;9;66;37;96;10;145;2078
6;91304;Cogula;94;101;93;101;37;23;34;19;3;4;8.1080000000000005;17.390999999999998;6;16;31;0;2;3;2;42.100000000000001;20.300000000000001;21.800000000000001;53.240000000000002;8;10;37;19;20;11;8;33;24;25;10;147;2115
6;91306;Feital;31;34;30;34;17;9;14;6;3;3;17.646999999999998;33.332999999999998;6;3;11;2;0;1;3;12.199999999999999;5.7999999999999998;6.4000000000000004;47.630000000000003;3;5;14;5;4;3;6;13;6;6;10;147;2117
6;91307;Fiães;135;138;134;138;55;38;45;36;10;2;18.181999999999999;5.2629999999999999;11;22;48;2;1;8;1;28.399999999999999;14;14.300000000000001;47.68;13;18;72;13;19;5;20;70;19;24;10;147;2118
6;91313;Palhais;90;106;77;94;42;29;39;27;3;2;7.1429999999999998;6.8970000000000002;8;20;38;0;2;3;0;45.299999999999997;20.800000000000001;24.5;43.890000000000001;11;5;56;10;8;17;10;59;13;7;10;147;2124
6;91315;Reboleiro;146;178;123;166;61;40;60;40;1;0;1.639;0;10;28;62;0;0;1;0;72.099999999999994;32.5;39.600000000000001;57.460000000000001;6;18;70;20;32;11;12;64;18;73;10;147;2126
6;50220;Salgueiro do Campo;411;480;397;467;179;142;155;125;24;17;13.407999999999999;11.972;4;84;192;3;1;21;16;29.399999999999999;13.6;15.800000000000001;53.509999999999998;34;35;205;62;75;42;23;202;68;145;6;79;1303
6;50505;Ladoeiro;622;668;614;677;268;206;234;165;34;41;12.686999999999999;19.902999999999999;80;100;219;2;3;32;38;20.399999999999999;9.8000000000000007;10.6;50.100000000000001;65;67;292;96;102;63;63;288;123;131;6;82;1375
6;50703;Aldeia de João Pires;97;98;89;95;25;16;24;14;1;2;4;12.5;6;8;24;0;0;1;2;17.600000000000001;8.6999999999999993;8.8000000000000007;63.789999999999999;3;4;34;21;35;2;4;27;28;37;6;84;1401
6;50102;Caria;937;984;890;952;464;389;397;318;67;71;14.44;18.251999999999999;60;239;416;21;15;46;56;49.200000000000003;24;25.199999999999999;47.219999999999999;92;105;496;119;125;105;95;488;130;166;6;78;1280
6;50310;Erada;342;367;325;347;135;118;128;101;7;17;5.1849999999999996;14.407;7;113;109;2;2;5;15;16.300000000000001;7.9000000000000004;8.5;49.189999999999998;43;28;183;44;44;27;34;185;49;72;6;80;1323
6;50404;Aldeia de Joanes;645;688;607;656;352;326;306;285;46;41;13.068;12.577;12;154;425;8;9;38;32;164.80000000000001;79.799999999999997;85.099999999999994;40.890000000000001;108;64;377;55;41;105;67;381;61;74;6;81;1343
6;50407;Atalaia do Campo;271;275;264;259;102;66;83;56;19;10;18.626999999999999;15.151999999999999;28;46;65;2;2;17;8;47.5;23.600000000000001;23.899999999999999;54.350000000000001;26;22;126;38;59;16;21;108;56;74;6;81;1346
6;50430;Mata da Rainha;67;82;67;81;10;11;10;11;0;0;0;0;5;5;11;0;0;0;0;8.0999999999999996;3.7000000000000002;4.5;62.659999999999997;3;1;15;27;21;4;4;21;33;20;6;81;1360
6;100603;Caldas da Rainha (Nossa Senhora do Pópulo);7418;8696;6987;8355;3747;4035;3244;3474;503;561;13.423999999999999;13.903;99;1119;5500;94;96;409;465;1342.9000000000001;618.20000000000005;724.70000000000005;42.659999999999997;1146;889;4009;708;666;1107;933;4656;936;1064;11;154;2202
6;100616;Caldas da Rainha (Santo Onofre);5233;5990;4898;5796;2829;3045;2382;2524;447;521;15.801;17.109999999999999;70;996;3840;96;70;351;451;1218.2;568;650.20000000000005;39.210000000000001;908;640;2930;449;306;895;670;3441;534;450;11;154;2203
6;101103;Valado dos Frades;1494;1615;1415;1564;750;694;680;600;70;94;9.3330000000000002;13.545;179;437;664;6;14;64;80;168;80.700000000000003;87.200000000000003;42.700000000000003;227;155;862;144;106;216;169;890;174;166;11;159;2257
6;101208;Gaeiras;1127;1204;1062;1160;588;547;529;488;59;59;10.034000000000001;10.786;22;229;766;10;8;49;51;226;109.3;116.8;40.609999999999999;198;116;635;112;66;173;131;694;112;94;11;160;2260
6;101403;Peniche (Conceição);2230;2413;2116;2346;1160;1155;1003;961;157;194;13.534000000000001;16.797000000000001;122;502;1340;18;25;139;169;6614.3999999999996;3176.8000000000002;3437.5;42.5;350;225;1267;228;160;301;260;1351;270;231;11;162;2273
6;110103;Aldeia Gavinha;546;596;525;592;281;231;252;208;29;23;10.32;9.9570000000000007;37;117;306;6;7;23;16;138.40000000000001;66.200000000000003;72.200000000000003;45.770000000000003;69;57;285;71;64;68;61;307;77;83;12;165;2308
6;110106;Carnota;820;858;794;835;399;327;374;294;25;33;6.266;10.092000000000001;35;206;427;5;6;20;27;92.799999999999997;45.299999999999997;47.399999999999999;44.990000000000002;123;74;454;95;74;104;73;462;108;111;12;165;2313
6;110109;Ota;645;644;1238;831;353;309;328;264;25;45;7.0819999999999999;14.563000000000001;20;146;426;4;5;21;40;27.800000000000001;13.9;13.9;41;108;61;377;63;36;88;57;368;72;59;12;165;2317
6;110110;Pereiro de Palhacana;296;281;286;271;144;118;137;104;7;14;4.8609999999999998;11.864000000000001;21;71;149;1;1;6;13;62.600000000000001;32.100000000000001;30.5;43.640000000000001;49;29;160;37;21;37;26;153;31;34;12;165;2318
6;110112;Alenquer (Triana);2016;2118;1917;2056;1113;1021;1017;901;96;120;8.625;11.753;31;456;1431;14;18;82;102;121.5;59.299999999999997;62.299999999999997;39.390000000000001;366;211;1150;169;120;360;204;1183;211;160;12;165;2310
6;110402;Cadaval;1459;1654;1382;1595;750;745;678;670;72;75;9.5999999999999996;10.067;45;263;1040;12;16;60;59;244.19999999999999;114.5;129.80000000000001;40.289999999999999;265;142;813;145;94;272;154;897;154;177;12;169;2347
6;110801;Lourinhã;4703;5194;4458;4973;2476;2298;2189;2028;287;270;11.590999999999999;11.749000000000001;300;905;3012;57;47;230;223;253.59999999999999;120.5;133.09999999999999;41.280000000000001;764;541;2608;450;340;796;508;2878;504;508;12;173;2433
6;110810;Ribamar;1081;1060;995;1031;566;434;523;381;43;53;7.5969999999999995;12.212;247;192;465;7;11;36;42;350.39999999999998;176.90000000000001;173.5;38.719999999999999;186;129;626;97;43;181;121;599;104;55;12;173;2439
6;111305;Dois Portos;1012;1112;948;1047;498;417;456;386;42;31;8.4339999999999993;7.4340000000000002;53;205;584;9;5;33;26;58.100000000000001;27.699999999999999;30.399999999999999;46.439999999999998;135;102;526;134;115;145;96;536;149;186;12;179;2504
6;111313;Torres Vedras (Santa Maria do Castelo e São Miguel);3180;3485;3033;3411;1758;1725;1584;1547;174;178;9.8979999999999997;10.319000000000001;61;663;2407;25;30;149;148;377.5;180.09999999999999;197.40000000000001;40.549999999999997;548;335;1821;273;203;512;299;2012;323;339;12;179;2516
6;140119;Carvalhal;350;372;333;367;168;102;139;69;29;33;17.262;32.353000000000002;10;87;111;6;7;23;26;41.200000000000003;20;21.199999999999999;52.68;18;32;207;32;61;19;29;167;67;90;16;225;3062
6;140204;Louriceira;294;289;281;278;140;105;124;93;16;12;11.429;11.429;6;112;99;3;1;13;11;45.399999999999999;22.899999999999999;22.5;46.789999999999999;35;39;152;33;35;29;28;143;36;53;16;226;3078
6;140207;Moitas Venda;408;458;388;438;201;173;187;159;14;14;6.9649999999999999;8.0920000000000005;1;155;190;1;2;13;12;128.30000000000001;60.399999999999999;67.799999999999997;46.409999999999997;51;33;223;55;46;53;50;222;62;71;16;226;3081
6;140209;Serra de Santo António;341;384;359;406;180;143;173;135;7;8;3.8890000000000002;5.5940000000000003;34;129;145;0;0;7;8;49.600000000000001;23.300000000000001;26.300000000000001;47.579999999999998;46;29;179;38;49;45;30;181;48;80;16;226;3083
6;141101;Águas Belas;520;552;490;533;248;210;234;192;14;18;5.6449999999999996;8.5709999999999997;53;114;259;0;5;14;13;56.600000000000001;27.5;29.100000000000001;45.060000000000002;81;63;263;57;56;67;58;260;83;84;16;235;3122
6;141802;Asseiceira;1417;1528;1332;1469;664;520;580;441;84;79;12.651;15.192;75;323;623;8;14;76;65;101.3;48.700000000000003;52.600000000000001;45.75;191;140;768;160;158;183;131;784;206;224;16;243;3213
6;141804;Carregueiros;558;621;518;593;253;240;222;205;31;35;12.253;14.583;7;87;333;1;7;30;28;95.5;45.200000000000003;50.299999999999997;44.5;79;60;302;64;53;77;63;323;75;83;16;243;3215
6;141809;Paialvo;1227;1372;1156;1355;520;435;454;390;66;45;12.692;10.345000000000001;48;210;586;12;15;54;30;116.5;55;61.5;47.950000000000003;142;142;643;147;153;161;112;640;171;288;16;243;3220
6;141812;Tomar (São João Baptista);2614;2979;2487;2903;1220;1174;1056;1041;164;133;13.443;11.329000000000001;31;375;1691;36;29;128;104;426.60000000000002;199.40000000000001;227.19999999999999;44.479999999999997;375;334;1347;315;243;368;305;1501;396;409;16;243;3226
6;141814;Sabacheira;443;512;430;488;182;143;164;125;18;18;9.8900000000000006;12.587;3;94;192;4;6;14;12;27.899999999999999;12.9;15;50.57;45;40;228;74;56;43;39;234;94;102;16;243;3222
6;141903;Brogueira;530;582;513;570;268;239;250;210;18;29;6.7160000000000002;12.134;19;130;311;3;3;15;26;52.700000000000003;25.100000000000001;27.600000000000001;45.600000000000001;76;59;277;50;68;69;43;303;64;103;16;244;3229
6;142003;Tancos;136;107;125;107;51;35;45;32;6;3;11.765000000000001;8.5709999999999997;1;14;62;1;1;5;2;118.90000000000001;66.599999999999994;52.399999999999999;47.119999999999997;12;14;80;18;12;12;8;52;17;18;16;245;3247
6;142004;Vila Nova da Barquinha;751;837;702;801;375;370;341;328;34;42;9.0670000000000002;11.350999999999999;4;96;569;4;3;30;39;263.39999999999998;124.59999999999999;138.80000000000001;42.82;121;70;419;70;71;120;76;430;86;125;16;245;3248
6;142101;Alburitel;570;609;533;591;264;255;247;225;17;30;6.4390000000000001;11.765000000000001;7;130;335;1;9;16;21;105.3;50.899999999999999;54.399999999999999;47.119999999999997;67;62;294;77;70;57;66;311;72;103;16;238;3141
6;142109;Gondemaria;570;605;536;582;299;219;292;191;7;28;2.3410000000000002;12.785;8;250;225;0;4;7;24;131.69999999999999;63.899999999999999;67.799999999999997;42.399999999999999;83;61;316;57;53;90;77;303;79;56;16;238;3150
6;142114;Urqueira;807;875;756;827;415;317;401;286;14;31;3.3730000000000002;9.7789999999999999;27;312;348;1;8;13;23;54.200000000000003;26;28.199999999999999;47.189999999999998;82;98;436;97;94;86;91;420;120;158;16;238;3158
6;110608;Benfica;16487;20334;15958;19755;7876;8603;6704;7583;1172;1020;14.881;11.856;29;1543;12715;246;230;926;790;4639.5;2077.4000000000001;2562.0999999999999;47;2097;1687;8496;2349;1858;1965;1693;10229;3284;3163;12;171;2369
6;110621;Marvila;17945;20157;17144;19486;8851;8957;7130;7691;1721;1266;19.443999999999999;14.134;18;1967;12836;290;245;1431;1021;5977.6000000000004;2815.3000000000002;3162.3000000000002;42.119999999999997;2647;2215;10251;1742;1090;2610;2233;11021;2279;2014;12;171;2382
6;110622;Mercês;1968;2377;1857;2264;1044;1069;886;933;158;136;15.134;12.722;12;141;1666;21;19;137;117;16203.5;7339.1000000000004;8864.3999999999996;45.350000000000001;261;172;1159;209;167;254;171;1255;283;414;12;171;2383
6;110636;Santo Estêvão;691;820;643;755;375;359;311;314;64;45;17.067;12.535;1;66;558;8;10;56;35;7428.8999999999996;3397.3000000000002;4031.5;48.039999999999999;60;65;417;78;71;47;65;428;110;170;12;171;2397
6;110644;São Jorge de Arroios;8405;10010;9011;10356;4542;4661;3989;4202;553;459;12.175000000000001;9.8480000000000008;23;784;7384;97;88;456;371;15893.6;7254.1999999999998;8639.3999999999996;45.369999999999997;995;848;4910;789;863;1005;802;5229;1154;1820;12;171;2405
6;110646;São Mamede;2358;3062;2572;3252;1246;1339;1122;1227;124;112;9.952;8.3640000000000008;21;195;2133;25;23;99;89;8815.6000000000004;3835.3000000000002;4980.3000000000002;44.75;397;243;1290;213;215;354;258;1543;326;581;12;171;2407
6;110702;Bucelas;2243;2420;2151;2371;1190;1039;1108;926;82;113;6.891;10.875999999999999;44;584;1406;14;18;68;95;137.30000000000001;66;71.200000000000003;44.689999999999998;296;234;1241;280;192;299;243;1293;308;277;12;172;2417
6;110716;São Julião do Tojal;1850;1987;1771;1949;955;863;776;764;179;99;18.742999999999999;11.472;7;378;1155;29;20;150;79;289;139.30000000000001;149.59999999999999;42.049999999999997;271;247;1011;187;134;296;237;1023;198;233;12;172;2430
6;110717;Unhos;4668;4839;4461;4698;2345;2292;1911;1972;434;320;18.507000000000001;13.962;7;879;2997;63;70;371;250;2121.1999999999998;1041.5;1079.7;38.659999999999997;849;629;2572;402;216;788;615;2721;439;276;12;172;2431
6;111109;Sintra (Santa Maria e São Miguel);4410;4954;4202;4826;2281;2294;2033;2061;248;233;10.872;10.157;26;780;3288;52;55;196;178;765.39999999999998;360.5;404.89999999999998;42.32;709;506;2443;441;311;685;490;2694;512;573;12;177;2493
6;111504;Damaia;9734;11160;9219;10770;4802;5056;4048;4440;754;616;15.702;12.183999999999999;9;1244;7235;144;126;610;490;14810.5;6899.8000000000002;7910.6000000000004;43.899999999999999;1424;1012;5276;1214;808;1347;1016;5943;1531;1323;12;166;2326
6;111506;Mina;8445;9532;7992;9141;4216;4395;3384;3751;832;644;19.734000000000002;14.653;6;1209;5920;118;101;714;543;6390.6000000000004;3002.0999999999999;3388.5;42.969999999999999;1332;940;4528;934;711;1144;992;5046;1192;1158;12;166;2328
6;111601;Caneças;5952;6372;5711;6223;3184;3089;2775;2732;409;357;12.845000000000001;11.557;15;1091;4401;70;70;339;287;2069.5;999.5;1070;40.770000000000003;998;712;3376;530;336;942;642;3548;579;661;12;175;2460
6;150303;Costa da Caparica;6384;7034;6228;6908;3391;3303;2905;2858;486;445;14.332000000000001;13.473000000000001;175;786;4802;99;65;387;380;1318.3;627.20000000000005;691.10000000000002;42.469999999999999;959;672;3654;621;478;887;635;3992;793;727;17;248;3262
6;150310;Laranjeiro;9941;11047;9611;10645;4833;4945;3865;4143;968;802;20.029;16.218;23;1273;6712;198;183;770;619;5415.1999999999998;2564.9000000000001;2850.3000000000002;41.740000000000002;1588;1230;5422;1008;693;1506;1251;5988;1278;1024;17;248;3265
6;150403;Palhais;910;959;861;941;505;490;447;438;58;52;11.484999999999999;10.612;2;151;732;7;8;51;44;262.80000000000001;128;134.90000000000001;39.390000000000001;165;78;534;90;43;156;90;559;88;66;17;249;3273
6;150603;Moita;8488;9165;7978;8854;4398;4245;3718;3589;680;656;15.462;15.452999999999999;97;1657;5553;119;102;561;554;983.89999999999998;473.10000000000002;510.80000000000001;40.789999999999999;1444;954;4779;804;507;1366;890;5164;964;781;17;251;3285
6;150701;Canha;819;870;790;855;414;336;369;309;45;27;10.869999999999999;8.0359999999999996;201;96;381;2;1;43;26;8;3.8999999999999999;4.0999999999999996;49.079999999999998;110;54;447;93;115;87;64;416;124;179;17;252;3291
6;150702;Montijo;14259;15649;13569;15151;7763;7721;6704;6673;1059;1048;13.641999999999999;13.573;230;2578;10569;182;209;877;839;1097.5;523.20000000000005;574.20000000000005;39.219999999999999;2527;1538;8249;1118;827;2476;1469;8876;1491;1337;17;252;3292
6;150708;Afonsoeiro;3584;3619;3378;3498;2126;2006;1832;1732;294;274;13.829000000000001;13.659000000000001;41;655;2868;46;49;248;225;1711.5;851.60000000000002;859.89999999999998;35.32;747;315;2190;194;138;638;337;2181;255;208;17;252;3288
6;170333;São Pedro de Agostém;684;735;637;708;325;227;285;180;40;47;12.308;20.704999999999998;32;137;296;7;16;33;31;53.100000000000001;25.600000000000001;27.5;43.509999999999998;91;85;390;65;53;112;62;396;72;93;19;271;3690
6;170334;São Vicente;115;112;125;117;35;15;30;12;5;3;14.286;20;21;9;12;0;2;5;1;7.2999999999999998;3.7000000000000002;3.6000000000000001;59.689999999999998;6;6;53;26;24;1;9;37;32;33;19;271;3691
6;170336;Selhariz;115;129;106;123;52;29;40;22;12;7;23.077000000000002;24.138000000000002;9;22;31;2;2;10;5;42.899999999999999;20.199999999999999;22.699999999999999;49.93;10;13;62;16;14;9;8;59;26;27;19;271;3693
6;170341;Vale de Anta;772;771;743;769;370;350;325;305;45;45;12.162000000000001;12.856999999999999;14;121;495;11;12;34;33;151.59999999999999;75.900000000000006;75.799999999999997;41.899999999999999;133;92;414;63;70;111;66;419;84;91;19;271;3698
6;170345;Vilarelho da Raia;265;293;261;295;74;50;59;45;15;5;20.27;10;16;23;65;6;0;9;5;30.899999999999999;14.699999999999999;16.300000000000001;57.700000000000003;10;22;123;56;54;11;13;119;67;83;19;271;3702
6;170347;Vilas Boas;99;96;96;92;43;14;34;13;9;1;20.93;7.1429999999999998;5;17;25;1;0;8;1;28.399999999999999;14.4;14;46.299999999999997;14;14;51;13;7;10;7;45;14;20;19;271;3704
6;170349;Vilela do Tâmega;202;207;190;200;93;55;80;48;13;7;13.978;12.727;5;35;88;3;2;10;5;42.600000000000001;21;21.600000000000001;45.93;24;23;108;29;18;22;16;112;32;25;19;271;3705
6;170351;Madalena;760;822;742;797;325;288;287;250;38;38;11.692;13.194000000000001;19;88;430;7;8;31;30;260.19999999999999;125;135.19999999999999;45.740000000000002;114;79;380;106;81;95;82;430;108;107;19;271;3670
6;170605;Contim;43;44;40;39;17;8;15;7;2;1;11.765000000000001;12.5;14;3;5;1;0;1;1;7.2000000000000002;3.6000000000000001;3.6000000000000001;53.159999999999997;5;4;18;5;11;1;4;21;10;8;19;274;3726
6;170610;Fervidelas;42;45;41;45;18;6;18;6;0;0;0;0;13;5;6;0;0;0;0;16.5;8;8.5999999999999996;53.130000000000003;4;2;24;3;9;3;3;19;8;12;19;274;3731
6;170613;Meixedo;104;105;102;101;36;22;34;19;2;3;5.556;13.635999999999999;15;7;31;0;1;2;2;10.5;5.2000000000000002;5.2999999999999998;53.990000000000002;9;5;49;22;19;6;11;37;28;23;19;274;3734
6;170627;Santo André;113;105;113;99;40;20;34;19;6;1;15;5;14;19;20;2;1;4;0;11.5;6;5.5;54.060000000000002;6;9;59;17;22;6;8;51;13;27;19;274;3748
6;170632;Tourém;74;77;63;68;30;24;30;21;0;3;0;12.5;28;4;19;0;0;0;3;8.9000000000000004;4.2999999999999998;4.5;53.530000000000001;4;8;31;15;16;5;9;31;12;20;19;274;3752
6;170635;Vila da Ponte;92;86;91;85;34;15;31;15;3;0;8.8239999999999998;0;7;5;34;0;0;3;0;16.699999999999999;8.5999999999999996;8.0999999999999996;55.5;3;6;46;21;16;4;7;37;22;16;19;274;3755
6;170708;Valongo de Milhais;162;167;157;161;71;33;61;27;10;6;14.085000000000001;18.181999999999999;36;13;39;5;3;5;3;14.9;7.2999999999999998;7.5999999999999996;52.420000000000002;11;18;82;24;27;8;18;79;29;33;19;275;3764
6;171203;Algeriz;274;296;265;291;123;34;117;31;6;3;4.8780000000000001;8.8239999999999998;68;28;52;1;2;5;1;27.300000000000001;13.1;14.199999999999999;53.82;17;22;139;45;51;30;24;126;49;67;19;280;3811
6;171211;Fornos do Pinhal;147;173;143;169;47;28;38;20;9;8;19.149000000000001;28.571000000000002;17;6;35;0;4;9;4;30.800000000000001;14.1;16.600000000000001;51.909999999999997;14;17;58;29;29;22;14;63;39;35;19;280;3820
6;171219;Santa Maria de Emeres;189;217;183;210;63;35;56;24;7;11;11.111000000000001;31.428999999999998;25;23;32;5;2;2;9;24.5;11.4;13.1;50.950000000000003;22;22;92;25;28;18;19;96;39;45;19;280;3828
6;171224;Serapicos;121;125;114;121;42;19;38;11;4;8;9.5240000000000009;42.104999999999997;19;13;17;2;3;2;5;34.299999999999997;16.899999999999999;17.399999999999999;49.960000000000001;10;18;60;16;17;10;13;54;23;25;19;280;3833
